id,Date,APPLICATION,OFFERED,ANSWERED,AVG ANS DELAY,AVG ANS DELAY SECONDS,MAX ANS DELAY,ABANDONED,DelayCallsProduct
20140101-ccc_311_calgary_combined,2014/01/01,ccc_311_calgary_combined,2353,1782,0:02:40,160,,571,285120
20140101-ccc_priority_script,2014/01/01,ccc_priority_script,35,35,0:00:15,15,,0,525
20140102-ccc_311_calgary_combined,2014/01/02,ccc_311_calgary_combined,4283,3450,0:02:41,161,,833,555450
20140102-ccc_priority_script,2014/01/02,ccc_priority_script,22,21,0:00:13,13,,1,273
20140102-ccc_tax_script,2014/01/02,ccc_tax_script,17,17,0:02:32,152,,0,2584
20140103-ccc_311_calgary_combined,2014/01/03,ccc_311_calgary_combined,4963,3707,0:03:44,224,,1256,830368
20140103-ccc_priority_script,2014/01/03,ccc_priority_script,72,69,0:00:15,15,,3,1035
20140103-ccc_tax_script,2014/01/03,ccc_tax_script,5,3,0:06:32,392,,2,1176
20140104-ccc_311_calgary_combined,2014/01/04,ccc_311_calgary_combined,2793,1562,0:09:23,563,,1231,879406
20140104-ccc_priority_script,2014/01/04,ccc_priority_script,44,44,0:00:37,37,,0,1628
20140104-ccc_tax_script,2014/01/04,ccc_tax_script,1,0,0:00:00,0,,1,0
20140105-ccc_311_calgary_combined,2014/01/05,ccc_311_calgary_combined,1379,1067,0:03:02,182,,312,194194
20140105-ccc_priority_script,2014/01/05,ccc_priority_script,28,28,0:00:28,28,,0,784
20140106-ccc_311_calgary_combined,2014/01/06,ccc_311_calgary_combined,5177,3600,0:05:49,349,,1577,1256400
20140106-ccc_priority_script,2014/01/06,ccc_priority_script,19,19,0:00:18,18,,0,342
20140106-ccc_tax_script,2014/01/06,ccc_tax_script,29,21,0:08:27,507,,8,10647
20140107-ccc_311_calgary_combined,2014/01/07,ccc_311_calgary_combined,5056,3609,0:04:54,294,,1447,1061046
20140107-ccc_priority_script,2014/01/07,ccc_priority_script,38,37,0:00:20,20,,1,740
20140107-ccc_tax_script,2014/01/07,ccc_tax_script,18,14,0:06:43,403,,4,5642
20140108-ccc_311_calgary_combined,2014/01/08,ccc_311_calgary_combined,4611,3918,0:02:15,135,,693,528930
20140108-ccc_priority_script,2014/01/08,ccc_priority_script,46,45,0:00:11,11,,1,495
20140108-ccc_tax_script,2014/01/08,ccc_tax_script,26,25,0:02:57,177,,1,4425
20140109-ccc_311_calgary_combined,2014/01/09,ccc_311_calgary_combined,4688,3531,0:04:02,242,,1157,854502
20140109-ccc_priority_script,2014/01/09,ccc_priority_script,45,42,0:00:20,20,,3,840
20140109-ccc_tax_script,2014/01/09,ccc_tax_script,29,21,0:04:29,269,,8,5649
20140110-ccc_311_calgary_combined,2014/01/10,ccc_311_calgary_combined,4627,3273,0:04:51,291,,1354,952443
20140110-ccc_priority_script,2014/01/10,ccc_priority_script,39,37,0:00:37,37,,2,1369
20140110-ccc_tax_script,2014/01/10,ccc_tax_script,25,19,0:05:31,331,,6,6289
20140111-ccc_311_calgary_combined,2014/01/11,ccc_311_calgary_combined,2027,1508,0:03:13,193,,519,291044
20140111-ccc_priority_script,2014/01/11,ccc_priority_script,26,24,0:00:31,31,,2,744
20140112-ccc_311_calgary_combined,2014/01/12,ccc_311_calgary_combined,1412,1132,0:02:30,150,,280,169800
20140112-ccc_priority_script,2014/01/12,ccc_priority_script,28,26,0:00:27,27,,2,702
20140112-ccc_tax_script,2014/01/12,ccc_tax_script,1,1,0:02:53,173,,0,173
20140113-ccc_311_calgary_combined,2014/01/13,ccc_311_calgary_combined,5162,3627,0:04:58,298,,1535,1080846
20140113-ccc_priority_script,2014/01/13,ccc_priority_script,57,54,0:00:19,19,,3,1026
20140113-ccc_tax_script,2014/01/13,ccc_tax_script,11,8,0:04:04,244,,3,1952
20140114-ccc_311_calgary_combined,2014/01/14,ccc_311_calgary_combined,5563,3381,0:07:49,469,,2182,1585689
20140114-ccc_priority_script,2014/01/14,ccc_priority_script,50,47,0:00:14,14,,3,658
20140114-ccc_tax_script,2014/01/14,ccc_tax_script,10,5,0:10:29,629,,5,3145
20140115-ccc_311_calgary_combined,2014/01/15,ccc_311_calgary_combined,8418,3150,0:21:15,1275,,5268,4016250
20140115-ccc_priority_script,2014/01/15,ccc_priority_script,42,39,0:00:17,17,,3,663
20140115-ccc_tax_script,2014/01/15,ccc_tax_script,27,11,0:21:13,1273,,16,14003
20140116-ccc_311_calgary_combined,2014/01/16,ccc_311_calgary_combined,6344,3526,0:10:45,645,,2818,2274270
20140116-ccc_priority_script,2014/01/16,ccc_priority_script,38,33,0:00:28,28,,5,924
20140116-ccc_tax_script,2014/01/16,ccc_tax_script,25,9,0:14:51,891,,16,8019
20140117-ccc_311_calgary_combined,2014/01/17,ccc_311_calgary_combined,4525,3249,0:04:05,245,,1276,796005
20140117-ccc_priority_script,2014/01/17,ccc_priority_script,34,34,0:00:14,14,,0,476
20140117-ccc_tax_script,2014/01/17,ccc_tax_script,20,16,0:03:24,204,,4,3264
20140118-ccc_311_calgary_combined,2014/01/18,ccc_311_calgary_combined,2041,1881,0:00:43,43,,160,80883
20140118-ccc_priority_script,2014/01/18,ccc_priority_script,28,24,0:00:18,18,,4,432
20140118-ccc_tax_script,2014/01/18,ccc_tax_script,1,1,0:01:39,99,,0,99
20140119-ccc_311_calgary_combined,2014/01/19,ccc_311_calgary_combined,1903,1629,0:01:33,93,,274,151497
20140119-ccc_priority_script,2014/01/19,ccc_priority_script,31,30,0:00:31,31,,1,930
20140119-ccc_tax_script,2014/01/19,ccc_tax_script,2,2,0:00:49,49,,0,98
20140120-ccc_311_calgary_combined,2014/01/20,ccc_311_calgary_combined,5679,3295,0:09:22,562,,2384,1851790
20140120-ccc_priority_script,2014/01/20,ccc_priority_script,37,34,0:00:39,39,,3,1326
20140120-ccc_tax_script,2014/01/20,ccc_tax_script,22,11,0:06:55,415,,11,4565
20140121-ccc_311_calgary_combined,2014/01/21,ccc_311_calgary_combined,5761,3172,0:11:14,674,,2589,2137928
20140121-ccc_priority_script,2014/01/21,ccc_priority_script,75,71,0:00:25,25,,4,1775
20140121-ccc_tax_script,2014/01/21,ccc_tax_script,36,18,0:09:28,568,,18,10224
20140122-ccc_311_calgary_combined,2014/01/22,ccc_311_calgary_combined,4617,3476,0:04:31,271,,1141,941996
20140122-ccc_priority_script,2014/01/22,ccc_priority_script,55,54,0:00:11,11,,1,594
20140122-ccc_tax_script,2014/01/22,ccc_tax_script,20,17,0:01:18,78,,3,1326
20140123-ccc_311_calgary_combined,2014/01/23,ccc_311_calgary_combined,5499,3361,0:08:25,505,,2138,1697305
20140123-ccc_priority_script,2014/01/23,ccc_priority_script,39,36,0:00:17,17,,3,612
20140123-ccc_tax_script,2014/01/23,ccc_tax_script,29,18,0:09:32,572,,11,10296
20140124-ccc_311_calgary_combined,2014/01/24,ccc_311_calgary_combined,5369,3337,0:02:04,124,,2032,413788
20140124-ccc_priority_script,2014/01/24,ccc_priority_script,44,42,0:00:12,12,,2,504
20140124-ccc_tax_script,2014/01/24,ccc_tax_script,19,16,0:00:02,2,,3,32
20140125-ccc_311_calgary_combined,2014/01/25,ccc_311_calgary_combined,2558,1413,0:09:37,577,,1145,815301
20140125-ccc_priority_script,2014/01/25,ccc_priority_script,28,24,0:00:35,35,,4,840
20140126-ccc_311_calgary_combined,2014/01/26,ccc_311_calgary_combined,1526,1295,0:02:04,124,,231,160580
20140126-ccc_priority_script,2014/01/26,ccc_priority_script,22,21,0:00:12,12,,1,252
20140126-ccc_tax_script,2014/01/26,ccc_tax_script,4,1,0:00:02,2,,3,2
20140127-ccc_311_calgary_combined,2014/01/27,ccc_311_calgary_combined,4806,3828,0:03:32,212,,978,811536
20140127-ccc_priority_script,2014/01/27,ccc_priority_script,31,28,0:00:14,14,,3,392
20140127-ccc_tax_script,2014/01/27,ccc_tax_script,27,18,0:03:11,191,,9,3438
20140128-ccc_311_calgary_combined,2014/01/28,ccc_311_calgary_combined,4597,3691,0:03:00,180,,906,664380
20140128-ccc_priority_script,2014/01/28,ccc_priority_script,31,28,0:00:13,13,,3,364
20140128-ccc_tax_script,2014/01/28,ccc_tax_script,16,12,0:03:29,209,,4,2508
20140129-ccc_311_calgary_combined,2014/01/29,ccc_311_calgary_combined,3949,3514,0:01:25,85,,435,298690
20140129-ccc_priority_script,2014/01/29,ccc_priority_script,51,49,0:00:13,13,,2,637
20140129-ccc_tax_script,2014/01/29,ccc_tax_script,22,19,0:01:34,94,,3,1786
20140130-ccc_311_calgary_combined,2014/01/30,ccc_311_calgary_combined,3404,3307,0:00:20,20,,97,66140
20140130-ccc_priority_script,2014/01/30,ccc_priority_script,31,31,0:00:10,10,,0,310
20140130-ccc_tax_script,2014/01/30,ccc_tax_script,11,10,0:00:38,38,,1,380
20140131-ccc_311_calgary_combined,2014/01/31,ccc_311_calgary_combined,3131,2985,0:00:33,33,,146,98505
20140131-ccc_priority_script,2014/01/31,ccc_priority_script,34,33,0:00:11,11,,1,363
20140131-ccc_tax_script,2014/01/31,ccc_tax_script,27,25,0:00:33,33,,2,825
20140201-ccc_311_calgary_combined,2014/02/01,ccc_311_calgary_combined,1299,1243,0:00:17,17,,56,21131
20140201-ccc_priority_script,2014/02/01,ccc_priority_script,12,12,0:00:11,11,,0,132
20140201-ccc_tax_script,2014/02/01,ccc_tax_script,2,2,0:02:29,149,,0,298
20140202-ccc_311_calgary_combined,2014/02/02,ccc_311_calgary_combined,896,882,0:00:11,11,,14,9702
20140202-ccc_priority_script,2014/02/02,ccc_priority_script,8,8,0:00:05,5,,0,40
20140203-ccc_311_calgary_combined,2014/02/03,ccc_311_calgary_combined,3370,3235,0:00:26,26,,135,84110
20140203-ccc_priority_script,2014/02/03,ccc_priority_script,26,23,0:00:07,7,,3,161
20140203-ccc_tax_script,2014/02/03,ccc_tax_script,17,16,0:00:21,21,,1,336
20140204-ccc_311_calgary_combined,2014/02/04,ccc_311_calgary_combined,3292,3172,0:00:25,25,,120,79300
20140204-ccc_priority_script,2014/02/04,ccc_priority_script,27,27,0:00:11,11,,0,297
20140204-ccc_tax_script,2014/02/04,ccc_tax_script,16,16,0:00:29,29,,0,464
20140205-ccc_311_calgary_combined,2014/02/05,ccc_311_calgary_combined,3269,3193,0:00:13,13,,76,41509
20140205-ccc_priority_script,2014/02/05,ccc_priority_script,47,45,0:00:06,6,,2,270
20140205-ccc_tax_script,2014/02/05,ccc_tax_script,17,17,0:00:15,15,,0,255
20140206-ccc_311_calgary_combined,2014/02/06,ccc_311_calgary_combined,3231,3203,0:00:08,8,,28,25624
20140206-ccc_priority_script,2014/02/06,ccc_priority_script,39,37,0:00:09,9,,2,333
20140206-ccc_tax_script,2014/02/06,ccc_tax_script,16,16,0:00:10,10,,0,160
20140207-ccc_311_calgary_combined,2014/02/07,ccc_311_calgary_combined,2945,2885,0:00:17,17,,60,49045
20140207-ccc_priority_script,2014/02/07,ccc_priority_script,30,29,0:00:07,7,,1,203
20140207-ccc_tax_script,2014/02/07,ccc_tax_script,15,15,0:00:13,13,,0,195
20140208-ccc_311_calgary_combined,2014/02/08,ccc_311_calgary_combined,1279,1262,0:00:07,7,,17,8834
20140208-ccc_priority_script,2014/02/08,ccc_priority_script,27,25,0:00:15,15,,2,375
20140208-ccc_tax_script,2014/02/08,ccc_tax_script,1,1,0:00:05,5,,0,5
20140209-ccc_311_calgary_combined,2014/02/09,ccc_311_calgary_combined,835,830,0:00:06,6,,5,4980
20140209-ccc_priority_script,2014/02/09,ccc_priority_script,15,14,0:00:11,11,,1,154
20140209-ccc_tax_script,2014/02/09,ccc_tax_script,1,1,0:00:04,4,,0,4
20140210-ccc_311_calgary_combined,2014/02/10,ccc_311_calgary_combined,3411,3359,0:00:12,12,,52,40308
20140210-ccc_priority_script,2014/02/10,ccc_priority_script,23,21,0:00:09,9,,2,189
20140210-ccc_tax_script,2014/02/10,ccc_tax_script,15,13,0:00:16,16,,2,208
20140211-ccc_311_calgary_combined,2014/02/11,ccc_311_calgary_combined,3287,3225,0:00:13,13,,62,41925
20140211-ccc_priority_script,2014/02/11,ccc_priority_script,32,32,0:00:08,8,,0,256
20140211-ccc_tax_script,2014/02/11,ccc_tax_script,16,16,0:00:17,17,,0,272
20140212-ccc_311_calgary_combined,2014/02/12,ccc_311_calgary_combined,3164,3119,0:00:09,9,,45,28071
20140212-ccc_priority_script,2014/02/12,ccc_priority_script,29,28,0:00:09,9,,1,252
20140212-ccc_tax_script,2014/02/12,ccc_tax_script,17,17,0:00:06,6,,0,102
20140213-ccc_311_calgary_combined,2014/02/13,ccc_311_calgary_combined,3064,3003,0:00:10,10,,61,30030
20140213-ccc_priority_script,2014/02/13,ccc_priority_script,36,35,0:00:06,6,,1,210
20140213-ccc_tax_script,2014/02/13,ccc_tax_script,17,17,0:00:11,11,,0,187
20140214-ccc_311_calgary_combined,2014/02/14,ccc_311_calgary_combined,2755,2726,0:00:09,9,,29,24534
20140214-ccc_priority_script,2014/02/14,ccc_priority_script,29,28,0:00:09,9,,1,252
20140214-ccc_tax_script,2014/02/14,ccc_tax_script,13,13,0:00:06,6,,0,78
20140215-ccc_311_calgary_combined,2014/02/15,ccc_311_calgary_combined,1239,1208,0:00:09,9,,31,10872
20140215-ccc_priority_script,2014/02/15,ccc_priority_script,23,23,0:00:05,5,,0,115
20140215-ccc_tax_script,2014/02/15,ccc_tax_script,1,1,0:00:26,26,,0,26
20140216-ccc_311_calgary_combined,2014/02/16,ccc_311_calgary_combined,1250,1182,0:00:24,24,,68,28368
20140216-ccc_priority_script,2014/02/16,ccc_priority_script,24,24,0:00:21,21,,0,504
20140217-ccc_311_calgary_combined,2014/02/17,ccc_311_calgary_combined,1775,1725,0:00:13,13,,50,22425
20140217-ccc_priority_script,2014/02/17,ccc_priority_script,11,11,0:00:07,7,,0,77
20140217-ccc_tax_script,2014/02/17,ccc_tax_script,8,6,0:00:16,16,,2,96
20140218-ccc_311_calgary_combined,2014/02/18,ccc_311_calgary_combined,4099,3379,0:02:29,149,,720,503471
20140218-ccc_priority_script,2014/02/18,ccc_priority_script,31,28,0:00:12,12,,3,336
20140218-ccc_tax_script,2014/02/18,ccc_tax_script,24,21,0:01:49,109,,3,2289
20140219-ccc_311_calgary_combined,2014/02/19,ccc_311_calgary_combined,3602,3069,0:02:08,128,,533,392832
20140219-ccc_priority_script,2014/02/19,ccc_priority_script,38,36,0:00:19,19,,2,684
20140219-ccc_tax_script,2014/02/19,ccc_tax_script,21,16,0:02:29,149,,5,2384
20140220-ccc_311_calgary_combined,2014/02/20,ccc_311_calgary_combined,3611,3258,0:01:13,73,,353,237834
20140220-ccc_priority_script,2014/02/20,ccc_priority_script,20,20,0:00:21,21,,0,420
20140220-ccc_tax_script,2014/02/20,ccc_tax_script,33,26,0:01:08,68,,7,1768
20140221-ccc_311_calgary_combined,2014/02/21,ccc_311_calgary_combined,3215,2920,0:01:08,68,,295,198560
20140221-ccc_priority_script,2014/02/21,ccc_priority_script,26,25,0:00:27,27,,1,675
20140221-ccc_tax_script,2014/02/21,ccc_tax_script,25,21,0:01:01,61,,4,1281
20140222-ccc_311_calgary_combined,2014/02/22,ccc_311_calgary_combined,1188,1154,0:00:18,18,,34,20772
20140222-ccc_priority_script,2014/02/22,ccc_priority_script,19,19,0:01:35,95,,0,1805
20140222-ccc_tax_script,2014/02/22,ccc_tax_script,2,2,0:00:06,6,,0,12
20140223-ccc_311_calgary_combined,2014/02/23,ccc_311_calgary_combined,805,799,0:00:07,7,,6,5593
20140223-ccc_priority_script,2014/02/23,ccc_priority_script,30,29,0:00:19,19,,1,551
20140223-ccc_tax_script,2014/02/23,ccc_tax_script,1,1,0:00:06,6,,0,6
20140224-ccc_311_calgary_combined,2014/02/24,ccc_311_calgary_combined,3600,3265,0:01:07,67,,335,218755
20140224-ccc_priority_script,2014/02/24,ccc_priority_script,43,43,0:00:17,17,,0,731
20140224-ccc_tax_script,2014/02/24,ccc_tax_script,23,20,0:01:38,98,,3,1960
20140225-ccc_311_calgary_combined,2014/02/25,ccc_311_calgary_combined,3202,3111,0:00:23,23,,91,71553
20140225-ccc_priority_script,2014/02/25,ccc_priority_script,29,28,0:00:09,9,,1,252
20140225-ccc_tax_script,2014/02/25,ccc_tax_script,17,17,0:00:13,13,,0,221
20140226-ccc_311_calgary_combined,2014/02/26,ccc_311_calgary_combined,3318,3197,0:00:28,28,,121,89516
20140226-ccc_priority_script,2014/02/26,ccc_priority_script,24,24,0:00:07,7,,0,168
20140226-ccc_tax_script,2014/02/26,ccc_tax_script,10,10,0:00:23,23,,0,230
20140227-ccc_311_calgary_combined,2014/02/27,ccc_311_calgary_combined,3160,3082,0:00:17,17,,78,52394
20140227-ccc_priority_script,2014/02/27,ccc_priority_script,26,26,0:00:09,9,,0,234
20140227-ccc_tax_script,2014/02/27,ccc_tax_script,10,9,0:00:22,22,,1,198
20140228-ccc_311_calgary_combined,2014/02/28,ccc_311_calgary_combined,2943,2850,0:00:16,16,,93,45600
20140228-ccc_priority_script,2014/02/28,ccc_priority_script,31,31,0:00:06,6,,0,186
20140228-ccc_tax_script,2014/02/28,ccc_tax_script,12,11,0:00:07,7,,1,77
20140301-ccc_311_calgary_combined,2014/03/01,ccc_311_calgary_combined,1234,1184,0:00:15,15,,50,17760
20140301-ccc_priority_script,2014/03/01,ccc_priority_script,31,30,0:00:19,19,,1,570
20140301-ccc_tax_script,2014/03/01,ccc_tax_script,2,2,0:00:07,7,,0,14
20140302-ccc_311_calgary_combined,2014/03/02,ccc_311_calgary_combined,1024,1004,0:00:09,9,,20,9036
20140302-ccc_priority_script,2014/03/02,ccc_priority_script,22,22,0:00:07,7,,0,154
20140302-ccc_tax_script,2014/03/02,ccc_tax_script,1,1,0:00:06,6,,0,6
20140303-ccc_311_calgary_combined,2014/03/03,ccc_311_calgary_combined,3542,3220,0:01:05,65,,322,209300
20140303-ccc_priority_script,2014/03/03,ccc_priority_script,31,29,0:00:09,9,,2,261
20140303-ccc_tax_script,2014/03/03,ccc_tax_script,22,18,0:02:01,121,,4,2178
20140304-ccc_311_calgary_combined,2014/03/04,ccc_311_calgary_combined,3343,3093,0:00:58,58,,250,179394
20140304-ccc_priority_script,2014/03/04,ccc_priority_script,27,26,0:00:09,9,,1,234
20140304-ccc_tax_script,2014/03/04,ccc_tax_script,20,20,0:01:11,71,,0,1420
20140305-ccc_311_calgary_combined,2014/03/05,ccc_311_calgary_combined,3290,3235,0:00:13,13,,55,42055
20140305-ccc_priority_script,2014/03/05,ccc_priority_script,37,37,0:00:06,6,,0,222
20140305-ccc_tax_script,2014/03/05,ccc_tax_script,27,26,0:00:15,15,,1,390
20140306-ccc_311_calgary_combined,2014/03/06,ccc_311_calgary_combined,2963,2925,0:00:10,10,,38,29250
20140306-ccc_priority_script,2014/03/06,ccc_priority_script,24,23,0:00:05,5,,1,115
20140306-ccc_tax_script,2014/03/06,ccc_tax_script,22,22,0:00:08,8,,0,176
20140307-ccc_311_calgary_combined,2014/03/07,ccc_311_calgary_combined,2881,2819,0:00:19,19,,62,53561
20140307-ccc_priority_script,2014/03/07,ccc_priority_script,27,27,0:00:08,8,,0,216
20140307-ccc_tax_script,2014/03/07,ccc_tax_script,19,19,0:00:06,6,,0,114
20140308-ccc_311_calgary_combined,2014/03/08,ccc_311_calgary_combined,1942,1651,0:02:30,150,,291,247650
20140308-ccc_priority_script,2014/03/08,ccc_priority_script,25,22,0:00:41,41,,3,902
20140309-ccc_311_calgary_combined,2014/03/09,ccc_311_calgary_combined,2883,1534,0:01:38,98,,1349,150332
20140309-ccc_priority_script,2014/03/09,ccc_priority_script,68,59,0:00:25,25,,9,1475
20140310-ccc_311_calgary_combined,2014/03/10,ccc_311_calgary_combined,4878,3803,0:04:02,242,,1075,920326
20140310-ccc_priority_script,2014/03/10,ccc_priority_script,50,45,0:00:24,24,,5,1080
20140310-ccc_tax_script,2014/03/10,ccc_tax_script,26,21,0:04:38,278,,5,5838
20140311-ccc_311_calgary_combined,2014/03/11,ccc_311_calgary_combined,4113,3686,0:01:19,79,,427,291194
20140311-ccc_priority_script,2014/03/11,ccc_priority_script,46,45,0:00:17,17,,1,765
20140311-ccc_tax_script,2014/03/11,ccc_tax_script,10,9,0:00:39,39,,1,351
20140312-ccc_311_calgary_combined,2014/03/12,ccc_311_calgary_combined,4282,3646,0:02:02,122,,636,444812
20140312-ccc_priority_script,2014/03/12,ccc_priority_script,46,43,0:00:20,20,,3,860
20140312-ccc_tax_script,2014/03/12,ccc_tax_script,13,10,0:02:02,122,,3,1220
20140313-ccc_311_calgary_combined,2014/03/13,ccc_311_calgary_combined,3867,3186,0:02:19,139,,681,442854
20140313-ccc_priority_script,2014/03/13,ccc_priority_script,30,27,0:00:21,21,,3,567
20140313-ccc_tax_script,2014/03/13,ccc_tax_script,21,14,0:02:34,154,,7,2156
20140314-ccc_311_calgary_combined,2014/03/14,ccc_311_calgary_combined,3580,3126,0:01:45,105,,454,328230
20140314-ccc_priority_script,2014/03/14,ccc_priority_script,54,51,0:00:18,18,,3,918
20140314-ccc_tax_script,2014/03/14,ccc_tax_script,22,20,0:01:55,115,,2,2300
20140315-ccc_311_calgary_combined,2014/03/15,ccc_311_calgary_combined,1621,1567,0:00:16,16,,54,25072
20140315-ccc_priority_script,2014/03/15,ccc_priority_script,39,36,0:00:07,7,,3,252
20140315-ccc_tax_script,2014/03/15,ccc_tax_script,1,1,0:00:05,5,,0,5
20140316-ccc_311_calgary_combined,2014/03/16,ccc_311_calgary_combined,1394,1334,0:00:27,27,,60,36018
20140316-ccc_priority_script,2014/03/16,ccc_priority_script,23,22,0:00:09,9,,1,198
20140317-ccc_311_calgary_combined,2014/03/17,ccc_311_calgary_combined,4025,3467,0:02:11,131,,558,454177
20140317-ccc_priority_script,2014/03/17,ccc_priority_script,27,27,0:00:14,14,,0,378
20140317-ccc_tax_script,2014/03/17,ccc_tax_script,9,8,0:02:33,153,,1,1224
20140318-ccc_311_calgary_combined,2014/03/18,ccc_311_calgary_combined,3678,3250,0:01:29,89,,428,289250
20140318-ccc_priority_script,2014/03/18,ccc_priority_script,44,44,0:00:22,22,,0,968
20140318-ccc_tax_script,2014/03/18,ccc_tax_script,16,15,0:02:26,146,,1,2190
20140319-ccc_311_calgary_combined,2014/03/19,ccc_311_calgary_combined,3577,3098,0:01:57,117,,479,362466
20140319-ccc_priority_script,2014/03/19,ccc_priority_script,31,29,0:00:08,8,,2,232
20140319-ccc_tax_script,2014/03/19,ccc_tax_script,18,14,0:04:05,245,,4,3430
20140320-ccc_311_calgary_combined,2014/03/20,ccc_311_calgary_combined,3064,2993,0:00:11,11,,71,32923
20140320-ccc_priority_script,2014/03/20,ccc_priority_script,63,61,0:00:07,7,,2,427
20140320-ccc_tax_script,2014/03/20,ccc_tax_script,23,19,0:00:08,8,,4,152
20140321-ccc_311_calgary_combined,2014/03/21,ccc_311_calgary_combined,2806,2747,0:00:14,14,,59,38458
20140321-ccc_priority_script,2014/03/21,ccc_priority_script,39,37,0:00:07,7,,2,259
20140321-ccc_tax_script,2014/03/21,ccc_tax_script,21,20,0:00:09,9,,1,180
20140322-ccc_311_calgary_combined,2014/03/22,ccc_311_calgary_combined,945,927,0:00:09,9,,18,8343
20140322-ccc_priority_script,2014/03/22,ccc_priority_script,17,16,0:00:06,6,,1,96
20140322-ccc_tax_script,2014/03/22,ccc_tax_script,3,3,0:00:03,3,,0,9
20140323-ccc_311_calgary_combined,2014/03/23,ccc_311_calgary_combined,757,751,0:00:07,7,,6,5257
20140323-ccc_priority_script,2014/03/23,ccc_priority_script,12,12,0:00:15,15,,0,180
20140324-ccc_311_calgary_combined,2014/03/24,ccc_311_calgary_combined,3306,3132,0:00:38,38,,174,119016
20140324-ccc_priority_script,2014/03/24,ccc_priority_script,15,15,0:00:07,7,,0,105
20140324-ccc_tax_script,2014/03/24,ccc_tax_script,27,24,0:00:44,44,,3,1056
20140325-ccc_311_calgary_combined,2014/03/25,ccc_311_calgary_combined,2955,2835,0:00:28,28,,120,79380
20140325-ccc_priority_script,2014/03/25,ccc_priority_script,22,21,0:00:07,7,,1,147
20140325-ccc_tax_script,2014/03/25,ccc_tax_script,19,18,0:00:23,23,,1,414
20140326-ccc_311_calgary_combined,2014/03/26,ccc_311_calgary_combined,2922,2859,0:00:10,10,,63,28590
20140326-ccc_priority_script,2014/03/26,ccc_priority_script,43,42,0:00:06,6,,1,252
20140326-ccc_tax_script,2014/03/26,ccc_tax_script,23,23,0:00:09,9,,0,207
20140327-ccc_311_calgary_combined,2014/03/27,ccc_311_calgary_combined,2863,2833,0:00:08,8,,30,22664
20140327-ccc_priority_script,2014/03/27,ccc_priority_script,16,16,0:00:07,7,,0,112
20140327-ccc_tax_script,2014/03/27,ccc_tax_script,20,20,0:00:10,10,,0,200
20140328-ccc_311_calgary_combined,2014/03/28,ccc_311_calgary_combined,2752,2698,0:00:12,12,,54,32376
20140328-ccc_priority_script,2014/03/28,ccc_priority_script,19,19,0:00:17,17,,0,323
20140328-ccc_tax_script,2014/03/28,ccc_tax_script,25,24,0:00:17,17,,1,408
20140329-ccc_311_calgary_combined,2014/03/29,ccc_311_calgary_combined,1116,1082,0:00:12,12,,34,12984
20140329-ccc_priority_script,2014/03/29,ccc_priority_script,28,28,0:00:08,8,,0,224
20140329-ccc_tax_script,2014/03/29,ccc_tax_script,3,3,0:00:06,6,,0,18
20140330-ccc_311_calgary_combined,2014/03/30,ccc_311_calgary_combined,806,788,0:00:09,9,,18,7092
20140330-ccc_priority_script,2014/03/30,ccc_priority_script,15,14,0:00:14,14,,1,196
20140331-ccc_311_calgary_combined,2014/03/31,ccc_311_calgary_combined,3242,3182,0:00:11,11,,60,35002
20140331-ccc_priority_script,2014/03/31,ccc_priority_script,22,21,0:00:09,9,,1,189
20140331-ccc_tax_script,2014/03/31,ccc_tax_script,21,21,0:00:07,7,,0,147
20140401-ccc_311_calgary_combined,2014/04/01,ccc_311_calgary_combined,3540,3268,0:00:51,51,,272,166668
20140401-ccc_priority_script,2014/04/01,ccc_priority_script,28,28,0:00:13,13,,0,364
20140401-ccc_tax_script,2014/04/01,ccc_tax_script,29,26,0:00:28,28,,3,728
20140402-ccc_311_calgary_combined,2014/04/02,ccc_311_calgary_combined,3388,3268,0:00:16,16,,120,52288
20140402-ccc_priority_script,2014/04/02,ccc_priority_script,23,21,0:00:06,6,,2,126
20140402-ccc_tax_script,2014/04/02,ccc_tax_script,22,22,0:00:14,14,,0,308
20140403-ccc_311_calgary_combined,2014/04/03,ccc_311_calgary_combined,3072,3005,0:00:11,11,,67,33055
20140403-ccc_priority_script,2014/04/03,ccc_priority_script,26,24,0:00:06,6,,2,144
20140403-ccc_tax_script,2014/04/03,ccc_tax_script,24,23,0:00:05,5,,1,115
20140404-ccc_311_calgary_combined,2014/04/04,ccc_311_calgary_combined,3276,3105,0:00:40,40,,171,124200
20140404-ccc_priority_script,2014/04/04,ccc_priority_script,26,25,0:00:15,15,,1,375
20140404-ccc_tax_script,2014/04/04,ccc_tax_script,15,14,0:00:39,39,,1,546
20140405-ccc_311_calgary_combined,2014/04/05,ccc_311_calgary_combined,1440,1391,0:00:16,16,,49,22256
20140405-ccc_priority_script,2014/04/05,ccc_priority_script,16,16,0:00:07,7,,0,112
20140405-ccc_tax_script,2014/04/05,ccc_tax_script,3,3,0:00:04,4,,0,12
20140406-ccc_311_calgary_combined,2014/04/06,ccc_311_calgary_combined,1211,1196,0:00:08,8,,15,9568
20140406-ccc_priority_script,2014/04/06,ccc_priority_script,13,13,0:00:05,5,,0,65
20140407-ccc_311_calgary_combined,2014/04/07,ccc_311_calgary_combined,4566,3225,0:04:41,281,,1341,906225
20140407-ccc_priority_script,2014/04/07,ccc_priority_script,36,32,0:00:15,15,,4,480
20140407-ccc_tax_script,2014/04/07,ccc_tax_script,20,14,0:05:14,314,,6,4396
20140408-ccc_311_calgary_combined,2014/04/08,ccc_311_calgary_combined,4126,3748,0:01:16,76,,378,284848
20140408-ccc_priority_script,2014/04/08,ccc_priority_script,34,34,0:00:12,12,,0,408
20140408-ccc_tax_script,2014/04/08,ccc_tax_script,15,14,0:01:44,104,,1,1456
20140409-ccc_311_calgary_combined,2014/04/09,ccc_311_calgary_combined,3925,3625,0:01:02,62,,300,224750
20140409-ccc_priority_script,2014/04/09,ccc_priority_script,34,34,0:00:12,12,,0,408
20140409-ccc_tax_script,2014/04/09,ccc_tax_script,17,15,0:00:40,40,,2,600
20140410-ccc_311_calgary_combined,2014/04/10,ccc_311_calgary_combined,3731,3425,0:01:15,75,,306,256875
20140410-ccc_priority_script,2014/04/10,ccc_priority_script,29,29,0:00:20,20,,0,580
20140410-ccc_tax_script,2014/04/10,ccc_tax_script,19,17,0:01:20,80,,2,1360
20140411-ccc_311_calgary_combined,2014/04/11,ccc_311_calgary_combined,3562,3265,0:01:06,66,,297,215490
20140411-ccc_priority_script,2014/04/11,ccc_priority_script,25,23,0:00:17,17,,2,391
20140411-ccc_tax_script,2014/04/11,ccc_tax_script,17,15,0:00:54,54,,2,810
20140412-ccc_311_calgary_combined,2014/04/12,ccc_311_calgary_combined,1537,1430,0:00:37,37,,107,52910
20140412-ccc_priority_script,2014/04/12,ccc_priority_script,26,24,0:00:07,7,,2,168
20140412-ccc_tax_script,2014/04/12,ccc_tax_script,1,1,0:00:07,7,,0,7
20140413-ccc_311_calgary_combined,2014/04/13,ccc_311_calgary_combined,1263,1175,0:00:34,34,,88,39950
20140413-ccc_priority_script,2014/04/13,ccc_priority_script,24,23,0:00:14,14,,1,322
20140414-ccc_311_calgary_combined,2014/04/14,ccc_311_calgary_combined,4238,3836,0:01:06,66,,402,253176
20140414-ccc_priority_script,2014/04/14,ccc_priority_script,18,17,0:00:17,17,,1,289
20140414-ccc_tax_script,2014/04/14,ccc_tax_script,22,18,0:00:54,54,,4,972
20140415-ccc_311_calgary_combined,2014/04/15,ccc_311_calgary_combined,3999,3394,0:01:57,117,,605,397098
20140415-ccc_priority_script,2014/04/15,ccc_priority_script,48,47,0:00:11,11,,1,517
20140415-ccc_tax_script,2014/04/15,ccc_tax_script,15,14,0:03:47,227,,1,3178
20140416-ccc_311_calgary_combined,2014/04/16,ccc_311_calgary_combined,3326,3169,0:00:38,38,,157,120422
20140416-ccc_priority_script,2014/04/16,ccc_priority_script,43,39,0:00:09,9,,4,351
20140416-ccc_tax_script,2014/04/16,ccc_tax_script,17,16,0:00:30,30,,1,480
20140417-ccc_311_calgary_combined,2014/04/17,ccc_311_calgary_combined,3691,3567,0:00:17,17,,124,60639
20140417-ccc_priority_script,2014/04/17,ccc_priority_script,30,29,0:00:08,8,,1,232
20140417-ccc_tax_script,2014/04/17,ccc_tax_script,14,13,0:00:12,12,,1,156
20140418-ccc_311_calgary_combined,2014/04/18,ccc_311_calgary_combined,1507,1484,0:00:09,9,,23,13356
20140418-ccc_priority_script,2014/04/18,ccc_priority_script,18,18,0:00:11,11,,0,198
20140418-ccc_tax_script,2014/04/18,ccc_tax_script,1,1,0:00:03,3,,0,3
20140419-ccc_311_calgary_combined,2014/04/19,ccc_311_calgary_combined,1375,1312,0:00:22,22,,63,28864
20140419-ccc_priority_script,2014/04/19,ccc_priority_script,20,19,0:00:13,13,,1,247
20140419-ccc_tax_script,2014/04/19,ccc_tax_script,1,1,0:00:03,3,,0,3
20140420-ccc_311_calgary_combined,2014/04/20,ccc_311_calgary_combined,1023,996,0:00:13,13,,27,12948
20140420-ccc_priority_script,2014/04/20,ccc_priority_script,24,22,0:00:05,5,,2,110
20140420-ccc_tax_script,2014/04/20,ccc_tax_script,1,1,0:00:11,11,,0,11
20140421-ccc_311_calgary_combined,2014/04/21,ccc_311_calgary_combined,3911,3451,0:01:25,85,,460,293335
20140421-ccc_priority_script,2014/04/21,ccc_priority_script,29,28,0:00:18,18,,1,504
20140421-ccc_tax_script,2014/04/21,ccc_tax_script,11,8,0:00:35,35,,3,280
20140422-ccc_311_calgary_combined,2014/04/22,ccc_311_calgary_combined,4408,3670,0:02:21,141,,738,517470
20140422-ccc_priority_script,2014/04/22,ccc_priority_script,41,39,0:00:11,11,,2,429
20140422-ccc_tax_script,2014/04/22,ccc_tax_script,20,16,0:02:49,169,,4,2704
20140423-ccc_311_calgary_combined,2014/04/23,ccc_311_calgary_combined,4328,3835,0:01:43,103,,493,395005
20140423-ccc_priority_script,2014/04/23,ccc_priority_script,37,35,0:00:16,16,,2,560
20140423-ccc_tax_script,2014/04/23,ccc_tax_script,14,11,0:02:03,123,,3,1353
20140424-ccc_311_calgary_combined,2014/04/24,ccc_311_calgary_combined,4098,3693,0:01:19,79,,405,291747
20140424-ccc_priority_script,2014/04/24,ccc_priority_script,36,35,0:00:09,9,,1,315
20140424-ccc_tax_script,2014/04/24,ccc_tax_script,18,15,0:01:46,106,,3,1590
20140425-ccc_311_calgary_combined,2014/04/25,ccc_311_calgary_combined,3686,3526,0:00:31,31,,160,109306
20140425-ccc_priority_script,2014/04/25,ccc_priority_script,28,24,0:00:15,15,,4,360
20140425-ccc_tax_script,2014/04/25,ccc_tax_script,15,14,0:00:08,8,,1,112
20140426-ccc_311_calgary_combined,2014/04/26,ccc_311_calgary_combined,1435,1380,0:00:17,17,,55,23460
20140426-ccc_priority_script,2014/04/26,ccc_priority_script,25,25,0:00:12,12,,0,300
20140426-ccc_tax_script,2014/04/26,ccc_tax_script,2,2,0:00:45,45,,0,90
20140427-ccc_311_calgary_combined,2014/04/27,ccc_311_calgary_combined,1350,1301,0:00:20,20,,49,26020
20140427-ccc_priority_script,2014/04/27,ccc_priority_script,20,20,0:00:11,11,,0,220
20140428-ccc_311_calgary_combined,2014/04/28,ccc_311_calgary_combined,4515,4155,0:00:56,56,,360,232680
20140428-ccc_priority_script,2014/04/28,ccc_priority_script,24,24,0:00:08,8,,0,192
20140428-ccc_tax_script,2014/04/28,ccc_tax_script,14,13,0:00:53,53,,1,689
20140429-ccc_311_calgary_combined,2014/04/29,ccc_311_calgary_combined,4480,3783,0:02:17,137,,697,518271
20140429-ccc_priority_script,2014/04/29,ccc_priority_script,39,34,0:00:11,11,,5,374
20140429-ccc_tax_script,2014/04/29,ccc_tax_script,24,19,0:03:53,233,,5,4427
20140430-ccc_311_calgary_combined,2014/04/30,ccc_311_calgary_combined,4619,3916,0:02:02,122,,703,477752
20140430-ccc_priority_script,2014/04/30,ccc_priority_script,36,35,0:00:11,11,,1,385
20140430-ccc_tax_script,2014/04/30,ccc_tax_script,23,19,0:01:14,74,,4,1406
20140501-ccc_311_calgary_combined,2014/05/01,ccc_311_calgary_combined,4273,3966,0:00:48,48,,307,190368
20140501-ccc_priority_script,2014/05/01,ccc_priority_script,42,39,0:00:11,11,,3,429
20140501-ccc_tax_script,2014/05/01,ccc_tax_script,19,16,0:00:44,44,,3,704
20140502-ccc_311_calgary_combined,2014/05/02,ccc_311_calgary_combined,3903,3785,0:00:20,20,,118,75700
20140502-ccc_priority_script,2014/05/02,ccc_priority_script,53,52,0:00:10,10,,1,520
20140502-ccc_tax_script,2014/05/02,ccc_tax_script,19,19,0:00:07,7,,0,133
20140503-ccc_311_calgary_combined,2014/05/03,ccc_311_calgary_combined,1455,1415,0:00:19,19,,40,26885
20140503-ccc_priority_script,2014/05/03,ccc_priority_script,29,28,0:00:10,10,,1,280
20140503-ccc_tax_script,2014/05/03,ccc_tax_script,2,2,0:00:15,15,,0,30
20140504-ccc_311_calgary_combined,2014/05/04,ccc_311_calgary_combined,1086,1056,0:00:18,18,,30,19008
20140504-ccc_priority_script,2014/05/04,ccc_priority_script,22,22,0:00:16,16,,0,352
20140504-ccc_tax_script,2014/05/04,ccc_tax_script,1,1,0:00:03,3,,0,3
20140505-ccc_311_calgary_combined,2014/05/05,ccc_311_calgary_combined,4087,3876,0:00:39,39,,211,151164
20140505-ccc_priority_script,2014/05/05,ccc_priority_script,27,26,0:00:11,11,,1,286
20140505-ccc_tax_script,2014/05/05,ccc_tax_script,18,16,0:01:03,63,,2,1008
20140506-ccc_311_calgary_combined,2014/05/06,ccc_311_calgary_combined,4067,3910,0:01:17,77,,157,301070
20140506-ccc_priority_script,2014/05/06,ccc_priority_script,37,37,0:00:09,9,,0,333
20140506-ccc_tax_script,2014/05/06,ccc_tax_script,17,15,0:00:27,27,,2,405
20140507-ccc_311_calgary_combined,2014/05/07,ccc_311_calgary_combined,4201,3992,0:00:34,34,,209,135728
20140507-ccc_priority_script,2014/05/07,ccc_priority_script,34,34,0:00:09,9,,0,306
20140507-ccc_tax_script,2014/05/07,ccc_tax_script,21,21,0:00:24,24,,0,504
20140508-ccc_311_calgary_combined,2014/05/08,ccc_311_calgary_combined,3937,3678,0:00:45,45,,259,165510
20140508-ccc_priority_script,2014/05/08,ccc_priority_script,27,22,0:00:09,9,,5,198
20140508-ccc_tax_script,2014/05/08,ccc_tax_script,20,19,0:00:44,44,,1,836
20140509-ccc_311_calgary_combined,2014/05/09,ccc_311_calgary_combined,3536,3323,0:00:42,42,,213,139566
20140509-ccc_priority_script,2014/05/09,ccc_priority_script,40,40,0:00:06,6,,0,240
20140509-ccc_tax_script,2014/05/09,ccc_tax_script,20,16,0:00:57,57,,4,912
20140510-ccc_311_calgary_combined,2014/05/10,ccc_311_calgary_combined,1505,1449,0:00:31,31,,56,44919
20140510-ccc_priority_script,2014/05/10,ccc_priority_script,18,18,0:00:07,7,,0,126
20140510-ccc_tax_script,2014/05/10,ccc_tax_script,1,1,0:00:28,28,,0,28
20140511-ccc_311_calgary_combined,2014/05/11,ccc_311_calgary_combined,1155,1114,0:00:16,16,,41,17824
20140511-ccc_priority_script,2014/05/11,ccc_priority_script,27,26,0:00:10,10,,1,260
20140511-ccc_tax_script,2014/05/11,ccc_tax_script,1,0,0:00:00,0,,1,0
20140512-ccc_311_calgary_combined,2014/05/12,ccc_311_calgary_combined,4715,4012,0:02:24,144,,703,577728
20140512-ccc_priority_script,2014/05/12,ccc_priority_script,30,27,0:00:13,13,,3,351
20140512-ccc_tax_script,2014/05/12,ccc_tax_script,23,21,0:02:21,141,,2,2961
20140513-ccc_311_calgary_combined,2014/05/13,ccc_311_calgary_combined,4380,4019,0:01:06,66,,361,265254
20140513-ccc_priority_script,2014/05/13,ccc_priority_script,30,30,0:00:09,9,,0,270
20140513-ccc_tax_script,2014/05/13,ccc_tax_script,28,24,0:01:26,86,,4,2064
20140514-ccc_311_calgary_combined,2014/05/14,ccc_311_calgary_combined,4234,3909,0:00:59,59,,325,230631
20140514-ccc_priority_script,2014/05/14,ccc_priority_script,26,24,0:00:14,14,,2,336
20140514-ccc_tax_script,2014/05/14,ccc_tax_script,23,20,0:00:35,35,,3,700
20140515-ccc_311_calgary_combined,2014/05/15,ccc_311_calgary_combined,3888,3576,0:02:10,130,,312,464880
20140515-ccc_priority_script,2014/05/15,ccc_priority_script,35,32,0:00:11,11,,3,352
20140515-ccc_tax_script,2014/05/15,ccc_tax_script,12,11,0:01:53,113,,1,1243
20140516-ccc_311_calgary_combined,2014/05/16,ccc_311_calgary_combined,3624,3393,0:00:52,52,,231,176436
20140516-ccc_priority_script,2014/05/16,ccc_priority_script,39,37,0:00:11,11,,2,407
20140516-ccc_tax_script,2014/05/16,ccc_tax_script,17,17,0:01:17,77,,0,1309
20140517-ccc_311_calgary_combined,2014/05/17,ccc_311_calgary_combined,1399,1352,0:00:15,15,,47,20280
20140517-ccc_priority_script,2014/05/17,ccc_priority_script,23,22,0:00:10,10,,1,220
20140518-ccc_311_calgary_combined,2014/05/18,ccc_311_calgary_combined,1166,1152,0:00:09,9,,14,10368
20140518-ccc_priority_script,2014/05/18,ccc_priority_script,25,23,0:00:13,13,,2,299
20140519-ccc_311_calgary_combined,2014/05/19,ccc_311_calgary_combined,1440,1412,0:00:13,13,,28,18356
20140519-ccc_priority_script,2014/05/19,ccc_priority_script,25,23,0:00:06,6,,2,138
20140519-ccc_tax_script,2014/05/19,ccc_tax_script,1,1,0:00:03,3,,0,3
20140520-ccc_311_calgary_combined,2014/05/20,ccc_311_calgary_combined,5260,4514,0:01:56,116,,746,523624
20140520-ccc_priority_script,2014/05/20,ccc_priority_script,52,51,0:00:18,18,,1,918
20140520-ccc_tax_script,2014/05/20,ccc_tax_script,18,16,0:02:12,132,,2,2112
20140521-ccc_311_calgary_combined,2014/05/21,ccc_311_calgary_combined,4650,3984,0:01:53,113,,666,450192
20140521-ccc_priority_script,2014/05/21,ccc_priority_script,38,36,0:00:14,14,,2,504
20140521-ccc_tax_script,2014/05/21,ccc_tax_script,23,19,0:00:38,38,,4,722
20140522-ccc_311_calgary_combined,2014/05/22,ccc_311_calgary_combined,4651,4016,0:01:58,118,,635,473888
20140522-ccc_priority_script,2014/05/22,ccc_priority_script,42,41,0:00:17,17,,1,697
20140522-ccc_tax_script,2014/05/22,ccc_tax_script,25,22,0:01:58,118,,3,2596
20140523-ccc_311_calgary_combined,2014/05/23,ccc_311_calgary_combined,4395,3907,0:01:32,92,,488,359444
20140523-ccc_priority_script,2014/05/23,ccc_priority_script,48,46,0:00:12,12,,2,552
20140523-ccc_tax_script,2014/05/23,ccc_tax_script,11,9,0:01:29,89,,2,801
20140524-ccc_311_calgary_combined,2014/05/24,ccc_311_calgary_combined,1841,1626,0:01:17,77,,215,125202
20140524-ccc_priority_script,2014/05/24,ccc_priority_script,38,37,0:00:17,17,,1,629
20140524-ccc_tax_script,2014/05/24,ccc_tax_script,1,1,0:00:07,7,,0,7
20140525-ccc_311_calgary_combined,2014/05/25,ccc_311_calgary_combined,1418,1342,0:00:28,28,,76,37576
20140525-ccc_priority_script,2014/05/25,ccc_priority_script,14,14,0:00:05,5,,0,70
20140526-ccc_311_calgary_combined,2014/05/26,ccc_311_calgary_combined,6199,4011,0:05:53,353,,2188,1415883
20140526-ccc_priority_script,2014/05/26,ccc_priority_script,26,25,0:00:25,25,,1,625
20140526-ccc_tax_script,2014/05/26,ccc_tax_script,20,13,0:08:23,503,,7,6539
20140527-ccc_311_calgary_combined,2014/05/27,ccc_311_calgary_combined,6306,4523,0:04:58,298,,1783,1347854
20140527-ccc_priority_script,2014/05/27,ccc_priority_script,41,40,0:00:15,15,,1,600
20140527-ccc_tax_script,2014/05/27,ccc_tax_script,15,12,0:05:45,345,,3,4140
20140528-ccc_311_calgary_combined,2014/05/28,ccc_311_calgary_combined,5379,3589,0:06:44,404,,1790,1449956
20140528-ccc_priority_script,2014/05/28,ccc_priority_script,28,28,0:00:19,19,,0,532
20140528-ccc_tax_script,2014/05/28,ccc_tax_script,18,12,0:08:08,488,,6,5856
20140529-ccc_311_calgary_combined,2014/05/29,ccc_311_calgary_combined,5019,4050,0:03:10,190,,969,769500
20140529-ccc_priority_script,2014/05/29,ccc_priority_script,35,33,0:00:16,16,,2,528
20140529-ccc_tax_script,2014/05/29,ccc_tax_script,10,6,0:02:47,167,,4,1002
20140530-ccc_311_calgary_combined,2014/05/30,ccc_311_calgary_combined,4769,3635,0:04:16,256,,1134,930560
20140530-ccc_priority_script,2014/05/30,ccc_priority_script,60,54,0:00:25,25,,6,1350
20140530-ccc_tax_script,2014/05/30,ccc_tax_script,23,14,0:05:23,323,,9,4522
20140531-ccc_311_calgary_combined,2014/05/31,ccc_311_calgary_combined,1901,1691,0:01:09,69,,210,116679
20140531-ccc_priority_script,2014/05/31,ccc_priority_script,27,25,0:00:14,14,,2,350
20140531-ccc_tax_script,2014/05/31,ccc_tax_script,1,1,0:00:04,4,,0,4
20140601-ccc_311_calgary_combined,2014/06/01,ccc_311_calgary_combined,1649,1304,0:02:33,153,,345,199512
20140601-ccc_priority_script,2014/06/01,ccc_priority_script,32,30,0:00:29,29,,2,870
20140601-ccc_tax_script,2014/06/01,ccc_tax_script,2,1,0:07:42,462,,1,462
20140602-ccc_311_calgary_combined,2014/06/02,ccc_311_calgary_combined,6166,3990,0:07:51,471,,2176,1879290
20140602-ccc_priority_script,2014/06/02,ccc_priority_script,41,40,0:00:25,25,,1,1000
20140602-ccc_tax_script,2014/06/02,ccc_tax_script,17,8,0:10:16,616,,9,4928
20140603-ccc_311_calgary_combined,2014/06/03,ccc_311_calgary_combined,5844,3823,0:06:43,403,,2021,1540669
20140603-ccc_help_script,2014/06/03,ccc_help_script,1,1,0:00:37,37,,0,37
20140603-ccc_priority_script,2014/06/03,ccc_priority_script,42,41,0:00:18,18,,1,738
20140603-ccc_tax_script,2014/06/03,ccc_tax_script,32,14,0:06:18,378,,18,5292
20140604-ccc_311_calgary_combined,2014/06/04,ccc_311_calgary_combined,5643,4130,0:04:27,267,,1513,1102710
20140604-ccc_help_script,2014/06/04,ccc_help_script,2,2,0:00:09,9,,0,18
20140604-ccc_priority_script,2014/06/04,ccc_priority_script,50,49,0:00:15,15,,1,735
20140604-ccc_tax_script,2014/06/04,ccc_tax_script,23,13,0:07:23,443,,10,5759
20140605-ccc_311_calgary_combined,2014/06/05,ccc_311_calgary_combined,4714,4043,0:02:10,130,,671,525590
20140605-ccc_help_script,2014/06/05,ccc_help_script,3,3,0:00:22,22,,0,66
20140605-ccc_priority_script,2014/06/05,ccc_priority_script,25,25,0:00:24,24,,0,600
20140606-ccc_311_calgary_combined,2014/06/06,ccc_311_calgary_combined,4378,4029,0:01:21,81,,349,326349
20140606-ccc_help_script,2014/06/06,ccc_help_script,1,1,0:00:04,4,,0,4
20140606-ccc_priority_script,2014/06/06,ccc_priority_script,37,35,0:00:08,8,,2,280
20140607-ccc_311_calgary_combined,2014/06/07,ccc_311_calgary_combined,1643,1602,0:00:20,20,,41,32040
20140607-ccc_priority_script,2014/06/07,ccc_priority_script,24,22,0:00:10,10,,2,220
20140608-ccc_311_calgary_combined,2014/06/08,ccc_311_calgary_combined,1471,1424,0:00:17,17,,47,24208
20140608-ccc_priority_script,2014/06/08,ccc_priority_script,36,34,0:00:09,9,,2,306
20140609-ccc_311_calgary_combined,2014/06/09,ccc_311_calgary_combined,5554,4183,0:04:48,288,,1371,1204704
20140609-ccc_priority_script,2014/06/09,ccc_priority_script,39,34,0:00:13,13,,5,442
20140610-ccc_311_calgary_combined,2014/06/10,ccc_311_calgary_combined,5137,3772,0:05:13,313,,1365,1180636
20140610-ccc_help_script,2014/06/10,ccc_help_script,9,9,0:00:11,11,,0,99
20140610-ccc_priority_script,2014/06/10,ccc_priority_script,47,47,0:00:23,23,,0,1081
20140611-ccc_311_calgary_combined,2014/06/11,ccc_311_calgary_combined,5107,4171,0:03:04,184,,936,767464
20140611-ccc_help_script,2014/06/11,ccc_help_script,4,3,0:00:20,20,,1,60
20140611-ccc_priority_script,2014/06/11,ccc_priority_script,47,46,0:00:15,15,,1,690
20140612-ccc_311_calgary_combined,2014/06/12,ccc_311_calgary_combined,4671,4032,0:02:03,123,,639,495936
20140612-ccc_help_script,2014/06/12,ccc_help_script,3,3,0:00:05,5,,0,15
20140612-ccc_priority_script,2014/06/12,ccc_priority_script,48,44,0:00:14,14,,4,616
20140613-ccc_311_calgary_combined,2014/06/13,ccc_311_calgary_combined,3881,3766,0:00:28,28,,115,105448
20140613-ccc_help_script,2014/06/13,ccc_help_script,3,3,0:00:08,8,,0,24
20140613-ccc_priority_script,2014/06/13,ccc_priority_script,28,28,0:00:09,9,,0,252
20140614-ccc_311_calgary_combined,2014/06/14,ccc_311_calgary_combined,1547,1444,0:00:44,44,,103,63536
20140614-ccc_help_script,2014/06/14,ccc_help_script,2,2,0:00:37,37,,0,74
20140614-ccc_priority_script,2014/06/14,ccc_priority_script,38,37,0:00:10,10,,1,370
20140615-ccc_311_calgary_combined,2014/06/15,ccc_311_calgary_combined,1108,1052,0:00:42,42,,56,44184
20140615-ccc_priority_script,2014/06/15,ccc_priority_script,30,29,0:00:19,19,,1,551
20140616-ccc_311_calgary_combined,2014/06/16,ccc_311_calgary_combined,5371,4311,0:03:14,194,,1060,836334
20140616-ccc_help_script,2014/06/16,ccc_help_script,3,3,0:00:09,9,,0,27
20140616-ccc_priority_script,2014/06/16,ccc_priority_script,35,35,0:00:18,18,,0,630
20140616-ccc_tax_script,2014/06/16,ccc_tax_script,21,17,0:03:59,239,,4,4063
20140617-ccc_311_calgary_combined,2014/06/17,ccc_311_calgary_combined,4850,4167,0:01:54,114,,683,475038
20140617-ccc_help_script,2014/06/17,ccc_help_script,1,1,0:00:06,6,,0,6
20140617-ccc_priority_script,2014/06/17,ccc_priority_script,38,36,0:00:11,11,,2,396
20140617-ccc_tax_script,2014/06/17,ccc_tax_script,22,17,0:01:46,106,,5,1802
20140618-ccc_311_calgary_combined,2014/06/18,ccc_311_calgary_combined,4455,3960,0:01:38,98,,495,388080
20140618-ccc_help_script,2014/06/18,ccc_help_script,3,3,0:00:09,9,,0,27
20140618-ccc_priority_script,2014/06/18,ccc_priority_script,39,36,0:00:25,25,,3,900
20140618-ccc_tax_script,2014/06/18,ccc_tax_script,12,11,0:02:03,123,,1,1353
20140619-ccc_311_calgary_combined,2014/06/19,ccc_311_calgary_combined,4902,4072,0:02:25,145,,830,590440
20140619-ccc_help_script,2014/06/19,ccc_help_script,2,2,0:00:10,10,,0,20
20140619-ccc_priority_script,2014/06/19,ccc_priority_script,44,40,0:00:35,35,,4,1400
20140619-ccc_tax_script,2014/06/19,ccc_tax_script,14,12,0:01:46,106,,2,1272
20140620-ccc_311_calgary_combined,2014/06/20,ccc_311_calgary_combined,4488,3860,0:01:59,119,,628,459340
20140620-ccc_help_script,2014/06/20,ccc_help_script,4,4,0:00:06,6,,0,24
20140620-ccc_priority_script,2014/06/20,ccc_priority_script,55,52,0:00:17,17,,3,884
20140620-ccc_tax_script,2014/06/20,ccc_tax_script,22,21,0:01:26,86,,1,1806
20140621-ccc_311_calgary_combined,2014/06/21,ccc_311_calgary_combined,1676,1579,0:00:33,33,,97,52107
20140621-ccc_priority_script,2014/06/21,ccc_priority_script,35,35,0:00:11,11,,0,385
20140622-ccc_311_calgary_combined,2014/06/22,ccc_311_calgary_combined,1632,1493,0:01:00,60,,139,89580
20140622-ccc_priority_script,2014/06/22,ccc_priority_script,45,43,0:00:24,24,,2,1032
20140623-ccc_311_calgary_combined,2014/06/23,ccc_311_calgary_combined,5981,4422,0:04:41,281,,1559,1242582
20140623-ccc_help_script,2014/06/23,ccc_help_script,1,1,0:00:07,7,,0,7
20140623-ccc_priority_script,2014/06/23,ccc_priority_script,45,43,0:00:15,15,,2,645
20140623-ccc_tax_script,2014/06/23,ccc_tax_script,28,21,0:05:13,313,,7,6573
20140624-ccc_311_calgary_combined,2014/06/24,ccc_311_calgary_combined,5866,3634,0:06:39,399,,2232,1449966
20140624-ccc_help_script,2014/06/24,ccc_help_script,2,2,0:00:19,19,,0,38
20140624-ccc_priority_script,2014/06/24,ccc_priority_script,42,34,0:00:21,21,,8,714
20140624-ccc_tax_script,2014/06/24,ccc_tax_script,43,20,0:09:38,578,,23,11560
20140625-ccc_311_calgary_combined,2014/06/25,ccc_311_calgary_combined,5309,4340,0:02:55,175,,969,759500
20140625-ccc_help_script,2014/06/25,ccc_help_script,3,3,0:00:08,8,,0,24
20140625-ccc_priority_script,2014/06/25,ccc_priority_script,43,43,0:00:19,19,,0,817
20140625-ccc_tax_script,2014/06/25,ccc_tax_script,23,17,0:02:55,175,,6,2975
20140626-ccc_311_calgary_combined,2014/06/26,ccc_311_calgary_combined,5199,4178,0:03:06,186,,1021,777108
20140626-ccc_help_script,2014/06/26,ccc_help_script,5,5,0:00:14,14,,0,70
20140626-ccc_priority_script,2014/06/26,ccc_priority_script,42,39,0:00:19,19,,3,741
20140626-ccc_tax_script,2014/06/26,ccc_tax_script,21,20,0:02:58,178,,1,3560
20140627-ccc_311_calgary_combined,2014/06/27,ccc_311_calgary_combined,5167,4271,0:02:51,171,,896,730341
20140627-ccc_help_script,2014/06/27,ccc_help_script,3,2,0:00:09,9,,1,18
20140627-ccc_priority_script,2014/06/27,ccc_priority_script,37,37,0:00:17,17,,0,629
20140627-ccc_tax_script,2014/06/27,ccc_tax_script,29,23,0:03:43,223,,6,5129
20140628-ccc_311_calgary_combined,2014/06/28,ccc_311_calgary_combined,1653,1590,0:00:19,19,,63,30210
20140628-ccc_help_script,2014/06/28,ccc_help_script,1,1,0:00:02,2,,0,2
20140628-ccc_priority_script,2014/06/28,ccc_priority_script,30,29,0:00:08,8,,1,232
20140629-ccc_311_calgary_combined,2014/06/29,ccc_311_calgary_combined,1464,1430,0:00:15,15,,34,21450
20140629-ccc_help_script,2014/06/29,ccc_help_script,1,1,0:00:05,5,,0,5
20140629-ccc_priority_script,2014/06/29,ccc_priority_script,25,24,0:00:09,9,,1,216
20140630-ccc_311_calgary_combined,2014/06/30,ccc_311_calgary_combined,6510,5326,0:03:04,184,,1184,979984
20140630-ccc_priority_script,2014/06/30,ccc_priority_script,25,24,0:00:15,15,,1,360
20140630-ccc_tax_script,2014/06/30,ccc_tax_script,25,22,0:03:00,180,,3,3960
20140701-ccc_311_calgary_combined,2014/07/01,ccc_311_calgary_combined,2520,2383,0:00:29,29,,137,69107
20140701-ccc_help_script,2014/07/01,ccc_help_script,6,6,0:00:04,4,,0,24
20140701-ccc_priority_script,2014/07/01,ccc_priority_script,35,34,0:00:09,9,,1,306
20140701-ccc_tax_script,2014/07/01,ccc_tax_script,3,3,0:00:05,5,,0,15
20140702-ccc_311_calgary_combined,2014/07/02,ccc_311_calgary_combined,5326,4622,0:02:00,120,,704,554640
20140702-ccc_help_script,2014/07/02,ccc_help_script,3,3,0:00:10,10,,0,30
20140702-ccc_priority_script,2014/07/02,ccc_priority_script,34,34,0:00:12,12,,0,408
20140702-ccc_tax_script,2014/07/02,ccc_tax_script,14,13,0:01:47,107,,1,1391
20140703-ccc_311_calgary_combined,2014/07/03,ccc_311_calgary_combined,4870,4189,0:01:58,118,,681,494302
20140703-ccc_help_script,2014/07/03,ccc_help_script,5,5,0:00:15,15,,0,75
20140703-ccc_priority_script,2014/07/03,ccc_priority_script,42,41,0:00:16,16,,1,656
20140703-ccc_tax_script,2014/07/03,ccc_tax_script,28,20,0:01:37,97,,8,1940
20140704-ccc_311_calgary_combined,2014/07/04,ccc_311_calgary_combined,4077,3677,0:01:09,69,,400,253713
20140704-ccc_help_script,2014/07/04,ccc_help_script,3,3,0:00:04,4,,0,12
20140704-ccc_priority_script,2014/07/04,ccc_priority_script,38,38,0:00:25,25,,0,950
20140704-ccc_tax_script,2014/07/04,ccc_tax_script,24,21,0:00:47,47,,3,987
20140705-ccc_311_calgary_combined,2014/07/05,ccc_311_calgary_combined,1726,1445,0:01:59,119,,281,171955
20140705-ccc_priority_script,2014/07/05,ccc_priority_script,41,40,0:00:41,41,,1,1640
20140706-ccc_311_calgary_combined,2014/07/06,ccc_311_calgary_combined,1389,1170,0:01:43,103,,219,120510
20140706-ccc_priority_script,2014/07/06,ccc_priority_script,29,27,0:00:43,43,,2,1161
20140707-ccc_311_calgary_combined,2014/07/07,ccc_311_calgary_combined,5020,3960,0:03:33,213,,1060,843480
20140707-ccc_help_script,2014/07/07,ccc_help_script,1,1,0:00:03,3,,0,3
20140707-ccc_priority_script,2014/07/07,ccc_priority_script,35,34,0:00:14,14,,1,476
20140707-ccc_tax_script,2014/07/07,ccc_tax_script,15,11,0:05:44,344,,4,3784
20140708-ccc_311_calgary_combined,2014/07/08,ccc_311_calgary_combined,4456,3826,0:02:11,131,,630,501206
20140708-ccc_help_script,2014/07/08,ccc_help_script,4,2,0:00:10,10,,2,20
20140708-ccc_priority_script,2014/07/08,ccc_priority_script,49,49,0:00:19,19,,0,931
20140708-ccc_tax_script,2014/07/08,ccc_tax_script,28,18,0:01:35,95,,10,1710
20140709-ccc_311_calgary_combined,2014/07/09,ccc_311_calgary_combined,4427,3457,0:03:30,210,,970,725970
20140709-ccc_help_script,2014/07/09,ccc_help_script,3,2,0:00:31,31,,1,62
20140709-ccc_priority_script,2014/07/09,ccc_priority_script,46,45,0:00:14,14,,1,630
20140709-ccc_tax_script,2014/07/09,ccc_tax_script,16,12,0:04:24,264,,4,3168
20140710-ccc_311_calgary_combined,2014/07/10,ccc_311_calgary_combined,4690,3179,0:06:01,361,,1511,1147619
20140710-ccc_help_script,2014/07/10,ccc_help_script,4,3,0:00:27,27,,1,81
20140710-ccc_priority_script,2014/07/10,ccc_priority_script,61,57,0:00:17,17,,4,969
20140710-ccc_tax_script,2014/07/10,ccc_tax_script,14,11,0:06:45,405,,3,4455
20140711-ccc_311_calgary_combined,2014/07/11,ccc_311_calgary_combined,3836,3285,0:02:00,120,,551,394200
20140711-ccc_help_script,2014/07/11,ccc_help_script,3,3,0:00:11,11,,0,33
20140711-ccc_priority_script,2014/07/11,ccc_priority_script,52,44,0:00:15,15,,8,660
20140711-ccc_tax_script,2014/07/11,ccc_tax_script,17,15,0:02:28,148,,2,2220
20140712-ccc_311_calgary_combined,2014/07/12,ccc_311_calgary_combined,1608,1465,0:00:50,50,,143,73250
20140712-ccc_help_script,2014/07/12,ccc_help_script,1,1,0:00:13,13,,0,13
20140712-ccc_priority_script,2014/07/12,ccc_priority_script,40,35,0:00:14,14,,5,490
20140712-ccc_tax_script,2014/07/12,ccc_tax_script,1,1,0:01:37,97,,0,97
20140713-ccc_311_calgary_combined,2014/07/13,ccc_311_calgary_combined,1337,1239,0:00:27,27,,98,33453
20140713-ccc_help_script,2014/07/13,ccc_help_script,1,1,0:00:06,6,,0,6
20140713-ccc_priority_script,2014/07/13,ccc_priority_script,27,27,0:00:08,8,,0,216
20140714-ccc_311_calgary_combined,2014/07/14,ccc_311_calgary_combined,4570,3600,0:03:51,231,,970,831600
20140714-ccc_help_script,2014/07/14,ccc_help_script,5,3,0:00:11,11,,2,33
20140714-ccc_priority_script,2014/07/14,ccc_priority_script,53,46,0:00:20,20,,7,920
20140714-ccc_tax_script,2014/07/14,ccc_tax_script,21,14,0:03:44,224,,7,3136
20140715-ccc_311_calgary_combined,2014/07/15,ccc_311_calgary_combined,4541,3177,0:05:27,327,,1364,1038879
20140715-ccc_help_script,2014/07/15,ccc_help_script,5,5,0:00:13,13,,0,65
20140715-ccc_priority_script,2014/07/15,ccc_priority_script,51,50,0:00:20,20,,1,1000
20140715-ccc_tax_script,2014/07/15,ccc_tax_script,24,12,0:08:17,497,,12,5964
20140716-ccc_311_calgary_combined,2014/07/16,ccc_311_calgary_combined,4469,3293,0:04:45,285,,1176,938505
20140716-ccc_help_script,2014/07/16,ccc_help_script,6,6,0:00:13,13,,0,78
20140716-ccc_priority_script,2014/07/16,ccc_priority_script,66,45,0:00:17,17,,21,765
20140716-ccc_tax_script,2014/07/16,ccc_tax_script,17,11,0:06:19,379,,6,4169
20140717-ccc_311_calgary_combined,2014/07/17,ccc_311_calgary_combined,4259,3704,0:01:48,108,,555,400032
20140717-ccc_help_script,2014/07/17,ccc_help_script,5,5,0:00:12,12,,0,60
20140717-ccc_priority_script,2014/07/17,ccc_priority_script,63,59,0:00:16,16,,4,944
20140717-ccc_tax_script,2014/07/17,ccc_tax_script,17,14,0:02:03,123,,3,1722
20140718-ccc_311_calgary_combined,2014/07/18,ccc_311_calgary_combined,3861,3493,0:01:28,88,,368,307384
20140718-ccc_help_script,2014/07/18,ccc_help_script,3,3,0:00:06,6,,0,18
20140718-ccc_priority_script,2014/07/18,ccc_priority_script,35,33,0:00:21,21,,2,693
20140718-ccc_tax_script,2014/07/18,ccc_tax_script,13,12,0:01:24,84,,1,1008
20140719-ccc_311_calgary_combined,2014/07/19,ccc_311_calgary_combined,1517,1490,0:00:14,14,,27,20860
20140719-ccc_help_script,2014/07/19,ccc_help_script,1,1,0:00:10,10,,0,10
20140719-ccc_priority_script,2014/07/19,ccc_priority_script,33,31,0:00:07,7,,2,217
20140719-ccc_tax_script,2014/07/19,ccc_tax_script,1,0,0:00:00,0,,1,0
20140720-ccc_311_calgary_combined,2014/07/20,ccc_311_calgary_combined,1225,1195,0:00:12,12,,30,14340
20140720-ccc_priority_script,2014/07/20,ccc_priority_script,31,30,0:00:07,7,,1,210
20140721-ccc_311_calgary_combined,2014/07/21,ccc_311_calgary_combined,4421,3787,0:02:21,141,,634,533967
20140721-ccc_help_script,2014/07/21,ccc_help_script,7,7,0:00:07,7,,0,49
20140721-ccc_priority_script,2014/07/21,ccc_priority_script,43,41,0:00:13,13,,2,533
20140721-ccc_tax_script,2014/07/21,ccc_tax_script,16,14,0:02:11,131,,2,1834
20140722-ccc_311_calgary_combined,2014/07/22,ccc_311_calgary_combined,4228,3490,0:02:54,174,,738,607260
20140722-ccc_help_script,2014/07/22,ccc_help_script,4,4,0:00:26,26,,0,104
20140722-ccc_priority_script,2014/07/22,ccc_priority_script,28,27,0:00:16,16,,1,432
20140722-ccc_tax_script,2014/07/22,ccc_tax_script,22,19,0:02:51,171,,3,3249
20140723-ccc_311_calgary_combined,2014/07/23,ccc_311_calgary_combined,4303,3630,0:02:40,160,,673,580800
20140723-ccc_help_script,2014/07/23,ccc_help_script,8,8,0:00:13,13,,0,104
20140723-ccc_priority_script,2014/07/23,ccc_priority_script,39,39,0:00:24,24,,0,936
20140723-ccc_tax_script,2014/07/23,ccc_tax_script,24,17,0:03:56,236,,7,4012
20140724-ccc_311_calgary_combined,2014/07/24,ccc_311_calgary_combined,4464,3515,0:03:30,210,,949,738150
20140724-ccc_help_script,2014/07/24,ccc_help_script,10,9,0:00:13,13,,1,117
20140724-ccc_priority_script,2014/07/24,ccc_priority_script,48,48,0:00:18,18,,0,864
20140724-ccc_tax_script,2014/07/24,ccc_tax_script,21,16,0:03:17,197,,5,3152
20140725-ccc_311_calgary_combined,2014/07/25,ccc_311_calgary_combined,3705,3354,0:01:27,87,,351,291798
20140725-ccc_help_script,2014/07/25,ccc_help_script,4,4,0:00:17,17,,0,68
20140725-ccc_priority_script,2014/07/25,ccc_priority_script,26,25,0:00:14,14,,1,350
20140725-ccc_tax_script,2014/07/25,ccc_tax_script,18,16,0:01:32,92,,2,1472
20140726-ccc_311_calgary_combined,2014/07/26,ccc_311_calgary_combined,1495,1401,0:00:36,36,,94,50436
20140726-ccc_priority_script,2014/07/26,ccc_priority_script,25,25,0:00:07,7,,0,175
20140726-ccc_tax_script,2014/07/26,ccc_tax_script,3,2,0:01:51,111,,1,222
20140727-ccc_311_calgary_combined,2014/07/27,ccc_311_calgary_combined,1352,1281,0:00:35,35,,71,44835
20140727-ccc_priority_script,2014/07/27,ccc_priority_script,19,18,0:00:10,10,,1,180
20140727-ccc_tax_script,2014/07/27,ccc_tax_script,1,1,0:00:02,2,,0,2
20140728-ccc_311_calgary_combined,2014/07/28,ccc_311_calgary_combined,4369,3924,0:01:46,106,,445,415944
20140728-ccc_priority_script,2014/07/28,ccc_priority_script,47,45,0:00:14,14,,2,630
20140728-ccc_tax_script,2014/07/28,ccc_tax_script,19,17,0:02:15,135,,2,2295
20140729-ccc_311_calgary_combined,2014/07/29,ccc_311_calgary_combined,4269,3684,0:02:03,123,,585,453132
20140729-ccc_help_script,2014/07/29,ccc_help_script,3,3,0:00:06,6,,0,18
20140729-ccc_priority_script,2014/07/29,ccc_priority_script,41,38,0:00:16,16,,3,608
20140729-ccc_tax_script,2014/07/29,ccc_tax_script,33,30,0:02:39,159,,3,4770
20140730-ccc_311_calgary_combined,2014/07/30,ccc_311_calgary_combined,4441,3323,0:04:11,251,,1118,834073
20140730-ccc_help_script,2014/07/30,ccc_help_script,5,4,0:00:19,19,,1,76
20140730-ccc_priority_script,2014/07/30,ccc_priority_script,60,56,0:00:17,17,,4,952
20140730-ccc_tax_script,2014/07/30,ccc_tax_script,27,18,0:05:01,301,,9,5418
20140731-ccc_311_calgary_combined,2014/07/31,ccc_311_calgary_combined,3866,3530,0:01:24,84,,336,296520
20140731-ccc_help_script,2014/07/31,ccc_help_script,8,8,0:00:15,15,,0,120
20140731-ccc_priority_script,2014/07/31,ccc_priority_script,31,30,0:00:16,16,,1,480
20140731-ccc_tax_script,2014/07/31,ccc_tax_script,12,8,0:02:04,124,,4,992
20140801-ccc_311_calgary_combined,2014/08/01,ccc_311_calgary_combined,3704,3386,0:01:17,77,,318,260722
20140801-ccc_help_script,2014/08/01,ccc_help_script,4,4,0:00:21,21,,0,84
20140801-ccc_priority_script,2014/08/01,ccc_priority_script,44,41,0:00:12,12,,3,492
20140801-ccc_tax_script,2014/08/01,ccc_tax_script,10,9,0:01:04,64,,1,576
20140802-ccc_311_calgary_combined,2014/08/02,ccc_311_calgary_combined,1380,1337,0:00:19,19,,43,25403
20140802-ccc_priority_script,2014/08/02,ccc_priority_script,16,16,0:00:05,5,,0,80
20140802-ccc_tax_script,2014/08/02,ccc_tax_script,1,1,0:00:08,8,,0,8
20140803-ccc_311_calgary_combined,2014/08/03,ccc_311_calgary_combined,1302,1235,0:00:22,22,,67,27170
20140803-ccc_help_script,2014/08/03,ccc_help_script,1,1,0:00:08,8,,0,8
20140803-ccc_priority_script,2014/08/03,ccc_priority_script,28,25,0:00:08,8,,3,200
20140804-ccc_311_calgary_combined,2014/08/04,ccc_311_calgary_combined,1537,1490,0:00:21,21,,47,31290
20140804-ccc_help_script,2014/08/04,ccc_help_script,2,2,0:00:08,8,,0,16
20140804-ccc_priority_script,2014/08/04,ccc_priority_script,32,29,0:00:12,12,,3,348
20140805-ccc_311_calgary_combined,2014/08/05,ccc_311_calgary_combined,4995,3436,0:06:18,378,,1559,1298808
20140805-ccc_help_script,2014/08/05,ccc_help_script,4,4,0:00:13,13,,0,52
20140805-ccc_priority_script,2014/08/05,ccc_priority_script,39,37,0:00:17,17,,2,629
20140805-ccc_tax_script,2014/08/05,ccc_tax_script,25,13,0:08:38,518,,12,6734
20140806-ccc_311_calgary_combined,2014/08/06,ccc_311_calgary_combined,4398,3667,0:02:49,169,,731,619723
20140806-ccc_help_script,2014/08/06,ccc_help_script,5,5,0:00:18,18,,0,90
20140806-ccc_priority_script,2014/08/06,ccc_priority_script,30,30,0:00:23,23,,0,690
20140806-ccc_tax_script,2014/08/06,ccc_tax_script,11,9,0:08:02,482,,2,4338
20140807-ccc_311_calgary_combined,2014/08/07,ccc_311_calgary_combined,3947,3473,0:01:53,113,,474,392449
20140807-ccc_help_script,2014/08/07,ccc_help_script,2,2,0:00:05,5,,0,10
20140807-ccc_priority_script,2014/08/07,ccc_priority_script,37,34,0:00:15,15,,3,510
20140807-ccc_tax_script,2014/08/07,ccc_tax_script,13,13,0:02:22,142,,0,1846
20140808-ccc_311_calgary_combined,2014/08/08,ccc_311_calgary_combined,3764,3628,0:00:30,30,,136,108840
20140808-ccc_help_script,2014/08/08,ccc_help_script,1,1,0:00:46,46,,0,46
20140808-ccc_priority_script,2014/08/08,ccc_priority_script,70,57,0:00:16,16,,13,912
20140808-ccc_tax_script,2014/08/08,ccc_tax_script,14,14,0:00:26,26,,0,364
20140809-ccc_311_calgary_combined,2014/08/09,ccc_311_calgary_combined,1439,1356,0:00:34,34,,83,46104
20140809-ccc_priority_script,2014/08/09,ccc_priority_script,28,28,0:00:18,18,,0,504
20140810-ccc_311_calgary_combined,2014/08/10,ccc_311_calgary_combined,1193,1154,0:00:26,26,,39,30004
20140810-ccc_priority_script,2014/08/10,ccc_priority_script,28,28,0:00:50,50,,0,1400
20140811-ccc_311_calgary_combined,2014/08/11,ccc_311_calgary_combined,4442,3750,0:02:18,138,,692,517500
20140811-ccc_help_script,2014/08/11,ccc_help_script,4,4,0:00:08,8,,0,32
20140811-ccc_priority_script,2014/08/11,ccc_priority_script,34,31,0:00:11,11,,3,341
20140811-ccc_tax_script,2014/08/11,ccc_tax_script,10,9,0:04:31,271,,1,2439
20140812-ccc_311_calgary_combined,2014/08/12,ccc_311_calgary_combined,4166,3685,0:01:51,111,,481,409035
20140812-ccc_help_script,2014/08/12,ccc_help_script,3,1,0:00:02,2,,2,2
20140812-ccc_priority_script,2014/08/12,ccc_priority_script,50,44,0:00:14,14,,6,616
20140812-ccc_tax_script,2014/08/12,ccc_tax_script,11,6,0:01:35,95,,5,570
20140813-ccc_311_calgary_combined,2014/08/13,ccc_311_calgary_combined,3990,3296,0:02:41,161,,694,530656
20140813-ccc_help_script,2014/08/13,ccc_help_script,6,5,0:00:19,19,,1,95
20140813-ccc_priority_script,2014/08/13,ccc_priority_script,48,47,0:00:12,12,,1,564
20140813-ccc_tax_script,2014/08/13,ccc_tax_script,18,15,0:04:29,269,,3,4035
20140814-ccc_311_calgary_combined,2014/08/14,ccc_311_calgary_combined,3966,3124,0:03:29,209,,842,652916
20140814-ccc_help_script,2014/08/14,ccc_help_script,2,2,0:00:22,22,,0,44
20140814-ccc_priority_script,2014/08/14,ccc_priority_script,47,42,0:00:15,15,,5,630
20140814-ccc_tax_script,2014/08/14,ccc_tax_script,17,15,0:03:45,225,,2,3375
20140815-ccc_311_calgary_combined,2014/08/15,ccc_311_calgary_combined,3513,3171,0:01:13,73,,342,231483
20140815-ccc_help_script,2014/08/15,ccc_help_script,5,4,0:00:09,9,,1,36
20140815-ccc_priority_script,2014/08/15,ccc_priority_script,55,38,0:00:14,14,,17,532
20140815-ccc_tax_script,2014/08/15,ccc_tax_script,9,8,0:01:34,94,,1,752
20140816-ccc_311_calgary_combined,2014/08/16,ccc_311_calgary_combined,1178,1134,0:00:20,20,,44,22680
20140816-ccc_help_script,2014/08/16,ccc_help_script,1,1,0:00:05,5,,0,5
20140816-ccc_priority_script,2014/08/16,ccc_priority_script,31,29,0:00:14,14,,2,406
20140817-ccc_311_calgary_combined,2014/08/17,ccc_311_calgary_combined,1025,991,0:00:18,18,,34,17838
20140817-ccc_priority_script,2014/08/17,ccc_priority_script,22,22,0:00:07,7,,0,154
20140818-ccc_311_calgary_combined,2014/08/18,ccc_311_calgary_combined,4222,3369,0:03:27,207,,853,697383
20140818-ccc_priority_script,2014/08/18,ccc_priority_script,23,23,0:00:15,15,,0,345
20140818-ccc_tax_script,2014/08/18,ccc_tax_script,17,14,0:03:57,237,,3,3318
20140819-ccc_311_calgary_combined,2014/08/19,ccc_311_calgary_combined,4167,2931,0:04:44,284,,1236,832404
20140819-ccc_help_script,2014/08/19,ccc_help_script,1,1,0:00:43,43,,0,43
20140819-ccc_priority_script,2014/08/19,ccc_priority_script,41,36,0:00:16,16,,5,576
20140819-ccc_tax_script,2014/08/19,ccc_tax_script,12,9,0:03:18,198,,3,1782
20140820-ccc_311_calgary_combined,2014/08/20,ccc_311_calgary_combined,3882,3195,0:03:02,182,,687,581490
20140820-ccc_help_script,2014/08/20,ccc_help_script,3,3,0:00:11,11,,0,33
20140820-ccc_priority_script,2014/08/20,ccc_priority_script,35,35,0:00:11,11,,0,385
20140820-ccc_tax_script,2014/08/20,ccc_tax_script,12,9,0:05:06,306,,3,2754
20140821-ccc_311_calgary_combined,2014/08/21,ccc_311_calgary_combined,3513,3205,0:01:21,81,,308,259605
20140821-ccc_help_script,2014/08/21,ccc_help_script,11,11,0:00:09,9,,0,99
20140821-ccc_priority_script,2014/08/21,ccc_priority_script,27,25,0:00:11,11,,2,275
20140821-ccc_tax_script,2014/08/21,ccc_tax_script,11,7,0:01:41,101,,4,707
20140822-ccc_311_calgary_combined,2014/08/22,ccc_311_calgary_combined,3173,2937,0:01:06,66,,236,193842
20140822-ccc_help_script,2014/08/22,ccc_help_script,5,5,0:00:04,4,,0,20
20140822-ccc_priority_script,2014/08/22,ccc_priority_script,24,22,0:00:16,16,,2,352
20140822-ccc_tax_script,2014/08/22,ccc_tax_script,25,21,0:01:21,81,,4,1701
20140823-ccc_311_calgary_combined,2014/08/23,ccc_311_calgary_combined,1266,1245,0:00:14,14,,21,17430
20140823-ccc_priority_script,2014/08/23,ccc_priority_script,25,25,0:00:07,7,,0,175
20140824-ccc_311_calgary_combined,2014/08/24,ccc_311_calgary_combined,1045,1023,0:00:18,18,,22,18414
20140824-ccc_priority_script,2014/08/24,ccc_priority_script,23,23,0:00:13,13,,0,299
20140825-ccc_311_calgary_combined,2014/08/25,ccc_311_calgary_combined,4100,3651,0:01:43,103,,449,376053
20140825-ccc_priority_script,2014/08/25,ccc_priority_script,27,26,0:00:12,12,,1,312
20140825-ccc_tax_script,2014/08/25,ccc_tax_script,10,8,0:02:36,156,,2,1248
20140826-ccc_311_calgary_combined,2014/08/26,ccc_311_calgary_combined,4109,3374,0:02:54,174,,735,587076
20140826-ccc_help_script,2014/08/26,ccc_help_script,3,3,0:00:05,5,,0,15
20140826-ccc_priority_script,2014/08/26,ccc_priority_script,36,34,0:00:17,17,,2,578
20140826-ccc_tax_script,2014/08/26,ccc_tax_script,18,15,0:02:56,176,,3,2640
20140827-ccc_311_calgary_combined,2014/08/27,ccc_311_calgary_combined,4609,3186,0:05:55,355,,1423,1131030
20140827-ccc_help_script,2014/08/27,ccc_help_script,7,7,0:00:23,23,,0,161
20140827-ccc_priority_script,2014/08/27,ccc_priority_script,39,39,0:00:19,19,,0,741
20140827-ccc_tax_script,2014/08/27,ccc_tax_script,23,14,0:05:43,343,,9,4802
20140828-ccc_311_calgary_combined,2014/08/28,ccc_311_calgary_combined,4315,3355,0:04:31,271,,960,909205
20140828-ccc_help_script,2014/08/28,ccc_help_script,4,4,0:00:09,9,,0,36
20140828-ccc_priority_script,2014/08/28,ccc_priority_script,26,24,0:00:14,14,,2,336
20140828-ccc_tax_script,2014/08/28,ccc_tax_script,21,13,0:04:23,263,,8,3419
20140829-ccc_311_calgary_combined,2014/08/29,ccc_311_calgary_combined,3737,3406,0:01:28,88,,331,299728
20140829-ccc_help_script,2014/08/29,ccc_help_script,1,1,0:00:09,9,,0,9
20140829-ccc_priority_script,2014/08/29,ccc_priority_script,34,33,0:00:15,15,,1,495
20140829-ccc_tax_script,2014/08/29,ccc_tax_script,10,7,0:00:42,42,,3,294
20140830-ccc_311_calgary_combined,2014/08/30,ccc_311_calgary_combined,1339,1218,0:01:12,72,,121,87696
20140830-ccc_help_script,2014/08/30,ccc_help_script,1,1,0:00:02,2,,0,2
20140830-ccc_priority_script,2014/08/30,ccc_priority_script,24,20,0:00:30,30,,4,600
20140831-ccc_311_calgary_combined,2014/08/31,ccc_311_calgary_combined,1119,1025,0:01:07,67,,94,68675
20140831-ccc_help_script,2014/08/31,ccc_help_script,1,1,0:00:02,2,,0,2
20140831-ccc_priority_script,2014/08/31,ccc_priority_script,38,36,0:00:18,18,,2,648
20140901-ccc_311_calgary_combined,2014/09/01,ccc_311_calgary_combined,1346,1287,0:00:35,35,,59,45045
20140901-ccc_help_script,2014/09/01,ccc_help_script,3,3,0:00:05,5,,0,15
20140901-ccc_priority_script,2014/09/01,ccc_priority_script,30,30,0:00:09,9,,0,270
20140902-ccc_311_calgary_combined,2014/09/02,ccc_311_calgary_combined,4601,3859,0:02:55,175,,742,675325
20140902-ccc_help_script,2014/09/02,ccc_help_script,3,3,0:00:19,19,,0,57
20140902-ccc_priority_script,2014/09/02,ccc_priority_script,28,28,0:00:13,13,,0,364
20140902-ccc_tax_script,2014/09/02,ccc_tax_script,17,14,0:04:06,246,,3,3444
20140903-ccc_311_calgary_combined,2014/09/03,ccc_311_calgary_combined,4102,3859,0:01:04,64,,243,246976
20140903-ccc_help_script,2014/09/03,ccc_help_script,3,3,0:00:02,2,,0,6
20140903-ccc_priority_script,2014/09/03,ccc_priority_script,29,28,0:00:10,10,,1,280
20140903-ccc_tax_script,2014/09/03,ccc_tax_script,17,15,0:02:15,135,,2,2025
20140904-ccc_311_calgary_combined,2014/09/04,ccc_311_calgary_combined,5148,3789,0:03:30,210,,1359,795690
20140904-ccc_help_script,2014/09/04,ccc_help_script,5,5,0:00:22,22,,0,110
20140904-ccc_priority_script,2014/09/04,ccc_priority_script,42,42,0:00:16,16,,0,672
20140904-ccc_tax_script,2014/09/04,ccc_tax_script,11,9,0:04:07,247,,2,2223
20140905-ccc_311_calgary_combined,2014/09/05,ccc_311_calgary_combined,3838,3431,0:01:45,105,,407,360255
20140905-ccc_help_script,2014/09/05,ccc_help_script,8,8,0:00:10,10,,0,80
20140905-ccc_priority_script,2014/09/05,ccc_priority_script,33,31,0:00:21,21,,2,651
20140905-ccc_tax_script,2014/09/05,ccc_tax_script,19,18,0:01:13,73,,1,1314
20140906-ccc_311_calgary_combined,2014/09/06,ccc_311_calgary_combined,1416,1357,0:00:24,24,,59,32568
20140906-ccc_help_script,2014/09/06,ccc_help_script,3,3,0:00:03,3,,0,9
20140906-ccc_priority_script,2014/09/06,ccc_priority_script,29,28,0:00:14,14,,1,392
20140907-ccc_311_calgary_combined,2014/09/07,ccc_311_calgary_combined,1215,1144,0:00:42,42,,71,48048
20140907-ccc_priority_script,2014/09/07,ccc_priority_script,31,28,0:00:14,14,,3,392
20140908-ccc_311_calgary_combined,2014/09/08,ccc_311_calgary_combined,5748,3896,0:05:39,339,,1852,1320744
20140908-ccc_help_script,2014/09/08,ccc_help_script,3,3,0:00:33,33,,0,99
20140908-ccc_priority_script,2014/09/08,ccc_priority_script,90,82,0:00:25,25,,8,2050
20140908-ccc_tax_script,2014/09/08,ccc_tax_script,18,11,0:02:25,145,,7,1595
20140909-ccc_311_calgary_combined,2014/09/09,ccc_311_calgary_combined,5866,4130,0:06:26,386,,1736,1594180
20140909-ccc_help_script,2014/09/09,ccc_help_script,13,12,0:00:07,7,,1,84
20140909-ccc_priority_script,2014/09/09,ccc_priority_script,67,66,0:00:13,13,,1,858
20140909-ccc_tax_script,2014/09/09,ccc_tax_script,18,12,0:06:08,368,,6,4416
20140910-ccc_311_calgary_combined,2014/09/10,ccc_311_calgary_combined,12320,4585,0:19:42,1182,,7735,5419470
20140910-ccc_help_script,2014/09/10,ccc_help_script,38,37,0:00:14,14,,1,518
20140910-ccc_priority_script,2014/09/10,ccc_priority_script,161,158,0:00:20,20,,3,3160
20140910-ccc_tax_script,2014/09/10,ccc_tax_script,10,4,0:21:30,1290,,6,5160
20140911-ccc_311_calgary_combined,2014/09/11,ccc_311_calgary_combined,5764,3778,0:06:07,367,,1986,1386526
20140911-ccc_help_script,2014/09/11,ccc_help_script,46,46,0:00:11,11,,0,506
20140911-ccc_priority_script,2014/09/11,ccc_priority_script,54,52,0:05:20,320,,2,16640
20140911-ccc_tax_script,2014/09/11,ccc_tax_script,24,13,0:05:20,320,,11,4160
20140912-ccc_311_calgary_combined,2014/09/12,ccc_311_calgary_combined,4737,3269,0:05:16,316,,1468,1033004
20140912-ccc_help_script,2014/09/12,ccc_help_script,52,51,0:00:15,15,,1,765
20140912-ccc_priority_script,2014/09/12,ccc_priority_script,49,47,0:00:16,16,,2,752
20140912-ccc_tax_script,2014/09/12,ccc_tax_script,19,13,0:05:47,347,,6,4511
20140913-ccc_311_calgary_combined,2014/09/13,ccc_311_calgary_combined,2683,1586,0:09:24,564,,1097,894504
20140913-ccc_help_script,2014/09/13,ccc_help_script,25,25,0:00:30,30,,0,750
20140913-ccc_priority_script,2014/09/13,ccc_priority_script,30,28,0:00:32,32,,2,896
20140913-ccc_tax_script,2014/09/13,ccc_tax_script,1,0,0:00:00,0,,1,0
20140914-ccc_311_calgary_combined,2014/09/14,ccc_311_calgary_combined,1955,1563,0:02:15,135,,392,211005
20140914-ccc_help_script,2014/09/14,ccc_help_script,21,21,0:00:26,26,,0,546
20140914-ccc_priority_script,2014/09/14,ccc_priority_script,27,25,0:00:28,28,,2,700
20140915-ccc_311_calgary_combined,2014/09/15,ccc_311_calgary_combined,5682,3500,0:09:11,551,,2182,1928500
20140915-ccc_help_script,2014/09/15,ccc_help_script,6,5,0:00:46,46,,1,230
20140915-ccc_priority_script,2014/09/15,ccc_priority_script,34,32,0:00:15,15,,2,480
20140915-ccc_tax_script,2014/09/15,ccc_tax_script,25,16,0:13:11,791,,9,12656
20140916-ccc_311_calgary_combined,2014/09/16,ccc_311_calgary_combined,5140,3230,0:08:03,483,,1910,1560090
20140916-ccc_help_script,2014/09/16,ccc_help_script,6,6,0:00:16,16,,0,96
20140916-ccc_priority_script,2014/09/16,ccc_priority_script,50,49,0:00:19,19,,1,931
20140916-ccc_tax_script,2014/09/16,ccc_tax_script,18,11,0:08:59,539,,7,5929
20140917-ccc_311_calgary_combined,2014/09/17,ccc_311_calgary_combined,4812,3313,0:06:17,377,,1499,1249001
20140917-ccc_help_script,2014/09/17,ccc_help_script,5,5,0:00:22,22,,0,110
20140917-ccc_priority_script,2014/09/17,ccc_priority_script,58,52,0:00:18,18,,6,936
20140917-ccc_tax_script,2014/09/17,ccc_tax_script,23,12,0:08:29,509,,11,6108
20140918-ccc_311_calgary_combined,2014/09/18,ccc_311_calgary_combined,4318,3098,0:05:19,319,,1220,988262
20140918-ccc_help_script,2014/09/18,ccc_help_script,7,6,0:00:10,10,,1,60
20140918-ccc_priority_script,2014/09/18,ccc_priority_script,43,42,0:00:23,23,,1,966
20140918-ccc_tax_script,2014/09/18,ccc_tax_script,19,14,0:05:13,313,,5,4382
20140919-ccc_311_calgary_combined,2014/09/19,ccc_311_calgary_combined,3662,3362,0:00:58,58,,300,194996
20140919-ccc_help_script,2014/09/19,ccc_help_script,5,5,0:00:10,10,,0,50
20140919-ccc_priority_script,2014/09/19,ccc_priority_script,32,31,0:00:09,9,,1,279
20140919-ccc_tax_script,2014/09/19,ccc_tax_script,16,11,0:01:16,76,,5,836
20140920-ccc_311_calgary_combined,2014/09/20,ccc_311_calgary_combined,1647,1446,0:01:18,78,,201,112788
20140920-ccc_help_script,2014/09/20,ccc_help_script,3,3,0:00:25,25,,0,75
20140920-ccc_priority_script,2014/09/20,ccc_priority_script,32,30,0:00:23,23,,2,690
20140921-ccc_311_calgary_combined,2014/09/21,ccc_311_calgary_combined,1342,1219,0:00:59,59,,123,71921
20140921-ccc_priority_script,2014/09/21,ccc_priority_script,35,29,0:00:15,15,,6,435
20140922-ccc_311_calgary_combined,2014/09/22,ccc_311_calgary_combined,4810,2948,0:09:02,542,,1862,1597816
20140922-ccc_help_script,2014/09/22,ccc_help_script,5,4,0:00:16,16,,1,64
20140922-ccc_priority_script,2014/09/22,ccc_priority_script,44,43,0:00:21,21,,1,903
20140922-ccc_tax_script,2014/09/22,ccc_tax_script,28,15,0:10:48,648,,13,9720
20140923-ccc_311_calgary_combined,2014/09/23,ccc_311_calgary_combined,4189,3027,0:05:10,310,,1162,938370
20140923-ccc_help_script,2014/09/23,ccc_help_script,7,7,0:00:17,17,,0,119
20140923-ccc_priority_script,2014/09/23,ccc_priority_script,36,36,0:00:16,16,,0,576
20140923-ccc_tax_script,2014/09/23,ccc_tax_script,22,12,0:04:03,243,,10,2916
20140924-ccc_311_calgary_combined,2014/09/24,ccc_311_calgary_combined,4086,3332,0:02:42,162,,754,539784
20140924-ccc_help_script,2014/09/24,ccc_help_script,6,4,0:00:11,11,,2,44
20140924-ccc_priority_script,2014/09/24,ccc_priority_script,41,41,0:00:14,14,,0,574
20140924-ccc_tax_script,2014/09/24,ccc_tax_script,17,13,0:20:30,1230,,4,15990
20140925-ccc_311_calgary_combined,2014/09/25,ccc_311_calgary_combined,4595,3267,0:05:01,301,,1328,983367
20140925-ccc_help_script,2014/09/25,ccc_help_script,4,3,0:00:19,19,,1,57
20140925-ccc_priority_script,2014/09/25,ccc_priority_script,30,30,0:00:09,9,,0,270
20140925-ccc_tax_script,2014/09/25,ccc_tax_script,21,16,0:05:38,338,,5,5408
20140926-ccc_311_calgary_combined,2014/09/26,ccc_311_calgary_combined,3530,2911,0:02:47,167,,619,486137
20140926-ccc_priority_script,2014/09/26,ccc_priority_script,27,27,0:00:18,18,,0,486
20140926-ccc_tax_script,2014/09/26,ccc_tax_script,15,12,0:03:32,212,,3,2544
20140927-ccc_311_calgary_combined,2014/09/27,ccc_311_calgary_combined,1358,1284,0:00:40,40,,74,51360
20140927-ccc_help_script,2014/09/27,ccc_help_script,2,2,0:00:37,37,,0,74
20140927-ccc_priority_script,2014/09/27,ccc_priority_script,23,23,0:00:22,22,,0,506
20140928-ccc_311_calgary_combined,2014/09/28,ccc_311_calgary_combined,1158,1123,0:00:19,19,,35,21337
20140928-ccc_priority_script,2014/09/28,ccc_priority_script,11,11,0:00:09,9,,0,99
20140929-ccc_311_calgary_combined,2014/09/29,ccc_311_calgary_combined,4576,3259,0:05:57,357,,1317,1163463
20140929-ccc_help_script,2014/09/29,ccc_help_script,5,5,0:00:13,13,,0,65
20140929-ccc_priority_script,2014/09/29,ccc_priority_script,32,28,0:00:20,20,,4,560
20140929-ccc_tax_script,2014/09/29,ccc_tax_script,23,15,0:06:30,390,,8,5850
20140930-ccc_311_calgary_combined,2014/09/30,ccc_311_calgary_combined,3772,3236,0:02:06,126,,536,407736
20140930-ccc_help_script,2014/09/30,ccc_help_script,3,3,0:00:09,9,,0,27
20140930-ccc_priority_script,2014/09/30,ccc_priority_script,46,42,0:00:27,27,,4,1134
20140930-ccc_tax_script,2014/09/30,ccc_tax_script,15,14,0:02:04,124,,1,1736
20141001-ccc_311_calgary_combined,2014/10/01,ccc_311_calgary_combined,4139,3312,0:03:13,193,,827,639216
20141001-ccc_help_script,2014/10/01,ccc_help_script,4,3,0:00:23,23,,1,69
20141001-ccc_priority_script,2014/10/01,ccc_priority_script,37,36,0:00:20,20,,1,720
20141001-ccc_tax_script,2014/10/01,ccc_tax_script,18,8,0:02:50,170,,10,1360
20141002-ccc_311_calgary_combined,2014/10/02,ccc_311_calgary_combined,3504,3302,0:00:50,50,,202,165100
20141002-ccc_help_script,2014/10/02,ccc_help_script,1,1,0:00:02,2,,0,2
20141002-ccc_priority_script,2014/10/02,ccc_priority_script,37,36,0:00:10,10,,1,360
20141002-ccc_tax_script,2014/10/02,ccc_tax_script,29,26,0:00:37,37,,3,962
20141003-ccc_311_calgary_combined,2014/10/03,ccc_311_calgary_combined,3182,2998,0:00:51,51,,184,152898
20141003-ccc_help_script,2014/10/03,ccc_help_script,8,8,0:00:06,6,,0,48
20141003-ccc_priority_script,2014/10/03,ccc_priority_script,25,23,0:00:10,10,,2,230
20141003-ccc_tax_script,2014/10/03,ccc_tax_script,15,13,0:01:10,70,,2,910
20141004-ccc_311_calgary_combined,2014/10/04,ccc_311_calgary_combined,1347,1288,0:00:22,22,,59,28336
20141004-ccc_help_script,2014/10/04,ccc_help_script,1,1,0:00:01,1,,0,1
20141004-ccc_priority_script,2014/10/04,ccc_priority_script,13,13,0:00:04,4,,0,52
20141005-ccc_311_calgary_combined,2014/10/05,ccc_311_calgary_combined,1096,1069,0:00:17,17,,27,18173
20141005-ccc_priority_script,2014/10/05,ccc_priority_script,16,16,0:00:16,16,,0,256
20141006-ccc_311_calgary_combined,2014/10/06,ccc_311_calgary_combined,3978,3294,0:02:54,174,,684,573156
20141006-ccc_help_script,2014/10/06,ccc_help_script,3,3,0:00:06,6,,0,18
20141006-ccc_priority_script,2014/10/06,ccc_priority_script,33,33,0:00:18,18,,0,594
20141006-ccc_tax_script,2014/10/06,ccc_tax_script,15,11,0:04:53,293,,4,3223
20141007-ccc_311_calgary_combined,2014/10/07,ccc_311_calgary_combined,3928,2948,0:04:36,276,,980,813648
20141007-ccc_help_script,2014/10/07,ccc_help_script,3,3,0:00:15,15,,0,45
20141007-ccc_priority_script,2014/10/07,ccc_priority_script,46,43,0:00:24,24,,3,1032
20141007-ccc_tax_script,2014/10/07,ccc_tax_script,14,10,0:04:41,281,,4,2810
20141008-ccc_311_calgary_combined,2014/10/08,ccc_311_calgary_combined,3791,2963,0:03:28,208,,828,616304
20141008-ccc_help_script,2014/10/08,ccc_help_script,8,8,0:00:22,22,,0,176
20141008-ccc_priority_script,2014/10/08,ccc_priority_script,43,41,0:00:15,15,,2,615
20141008-ccc_tax_script,2014/10/08,ccc_tax_script,16,13,0:04:27,267,,3,3471
20141009-ccc_311_calgary_combined,2014/10/09,ccc_311_calgary_combined,3574,3304,0:01:03,63,,270,208152
20141009-ccc_help_script,2014/10/09,ccc_help_script,6,6,0:00:17,17,,0,102
20141009-ccc_priority_script,2014/10/09,ccc_priority_script,33,33,0:00:12,12,,0,396
20141009-ccc_tax_script,2014/10/09,ccc_tax_script,10,10,0:00:53,53,,0,530
20141010-ccc_311_calgary_combined,2014/10/10,ccc_311_calgary_combined,3206,2979,0:00:57,57,,227,169803
20141010-ccc_help_script,2014/10/10,ccc_help_script,2,2,0:00:43,43,,0,86
20141010-ccc_priority_script,2014/10/10,ccc_priority_script,31,28,0:00:10,10,,3,280
20141010-ccc_tax_script,2014/10/10,ccc_tax_script,8,8,0:01:01,61,,0,488
20141011-ccc_311_calgary_combined,2014/10/11,ccc_311_calgary_combined,1251,1180,0:00:35,35,,71,41300
20141011-ccc_priority_script,2014/10/11,ccc_priority_script,36,35,0:00:31,31,,1,1085
20141011-ccc_tax_script,2014/10/11,ccc_tax_script,1,1,0:04:01,241,,0,241
20141012-ccc_311_calgary_combined,2014/10/12,ccc_311_calgary_combined,1363,1303,0:00:19,19,,60,24757
20141012-ccc_help_script,2014/10/12,ccc_help_script,2,2,0:00:16,16,,0,32
20141012-ccc_priority_script,2014/10/12,ccc_priority_script,27,26,0:00:16,16,,1,416
20141013-ccc_311_calgary_combined,2014/10/13,ccc_311_calgary_combined,1411,1389,0:00:08,8,,22,11112
20141013-ccc_priority_script,2014/10/13,ccc_priority_script,24,23,0:00:05,5,,1,115
20141014-ccc_311_calgary_combined,2014/10/14,ccc_311_calgary_combined,4073,3692,0:01:06,66,,381,243672
20141014-ccc_help_script,2014/10/14,ccc_help_script,6,6,0:00:06,6,,0,36
20141014-ccc_priority_script,2014/10/14,ccc_priority_script,41,40,0:00:14,14,,1,560
20141014-ccc_tax_script,2014/10/14,ccc_tax_script,9,8,0:02:30,150,,1,1200
20141015-ccc_311_calgary_combined,2014/10/15,ccc_311_calgary_combined,3576,3285,0:00:58,58,,291,190530
20141015-ccc_help_script,2014/10/15,ccc_help_script,4,3,0:00:14,14,,1,42
20141015-ccc_priority_script,2014/10/15,ccc_priority_script,21,20,0:00:11,11,,1,220
20141015-ccc_tax_script,2014/10/15,ccc_tax_script,20,18,0:01:24,84,,2,1512
20141016-ccc_311_calgary_combined,2014/10/16,ccc_311_calgary_combined,3394,3150,0:00:45,45,,244,141750
20141016-ccc_help_script,2014/10/16,ccc_help_script,3,3,0:00:11,11,,0,33
20141016-ccc_priority_script,2014/10/16,ccc_priority_script,32,32,0:00:09,9,,0,288
20141016-ccc_tax_script,2014/10/16,ccc_tax_script,13,12,0:01:31,91,,1,1092
20141017-ccc_311_calgary_combined,2014/10/17,ccc_311_calgary_combined,3386,3175,0:00:48,48,,211,152400
20141017-ccc_help_script,2014/10/17,ccc_help_script,2,2,0:00:17,17,,0,34
20141017-ccc_priority_script,2014/10/17,ccc_priority_script,21,21,0:00:08,8,,0,168
20141017-ccc_tax_script,2014/10/17,ccc_tax_script,10,10,0:01:35,95,,0,950
20141018-ccc_311_calgary_combined,2014/10/18,ccc_311_calgary_combined,1415,1128,0:01:52,112,,287,126336
20141018-ccc_help_script,2014/10/18,ccc_help_script,1,1,0:00:12,12,,0,12
20141018-ccc_priority_script,2014/10/18,ccc_priority_script,31,30,0:00:29,29,,1,870
20141019-ccc_311_calgary_combined,2014/10/19,ccc_311_calgary_combined,941,836,0:00:56,56,,105,46816
20141019-ccc_help_script,2014/10/19,ccc_help_script,1,1,0:00:13,13,,0,13
20141019-ccc_priority_script,2014/10/19,ccc_priority_script,34,28,0:00:26,26,,6,728
20141020-ccc_311_calgary_combined,2014/10/20,ccc_311_calgary_combined,3987,3289,0:02:51,171,,698,562419
20141020-ccc_help_script,2014/10/20,ccc_help_script,4,4,0:00:11,11,,0,44
20141020-ccc_priority_script,2014/10/20,ccc_priority_script,24,24,0:00:10,10,,0,240
20141020-ccc_tax_script,2014/10/20,ccc_tax_script,14,9,0:03:57,237,,5,2133
20141021-ccc_311_calgary_combined,2014/10/21,ccc_311_calgary_combined,3777,2976,0:03:22,202,,801,601152
20141021-ccc_help_script,2014/10/21,ccc_help_script,4,4,0:00:15,15,,0,60
20141021-ccc_priority_script,2014/10/21,ccc_priority_script,38,38,0:00:13,13,,0,494
20141021-ccc_tax_script,2014/10/21,ccc_tax_script,18,11,0:06:54,414,,7,4554
20141022-ccc_311_calgary_combined,2014/10/22,ccc_311_calgary_combined,3420,2708,0:03:25,205,,712,555140
20141022-ccc_help_script,2014/10/22,ccc_help_script,3,3,0:00:12,12,,0,36
20141022-ccc_priority_script,2014/10/22,ccc_priority_script,26,23,0:00:16,16,,3,368
20141022-ccc_tax_script,2014/10/22,ccc_tax_script,14,11,0:02:54,174,,3,1914
20141023-ccc_311_calgary_combined,2014/10/23,ccc_311_calgary_combined,3634,2846,0:03:23,203,,788,577738
20141023-ccc_help_script,2014/10/23,ccc_help_script,6,6,0:00:26,26,,0,156
20141023-ccc_priority_script,2014/10/23,ccc_priority_script,40,38,0:00:17,17,,2,646
20141023-ccc_tax_script,2014/10/23,ccc_tax_script,15,12,0:04:26,266,,3,3192
20141024-ccc_311_calgary_combined,2014/10/24,ccc_311_calgary_combined,3459,3019,0:01:49,109,,440,329071
20141024-ccc_help_script,2014/10/24,ccc_help_script,3,3,0:00:13,13,,0,39
20141024-ccc_priority_script,2014/10/24,ccc_priority_script,39,38,0:00:15,15,,1,570
20141024-ccc_tax_script,2014/10/24,ccc_tax_script,16,9,0:01:52,112,,7,1008
20141025-ccc_311_calgary_combined,2014/10/25,ccc_311_calgary_combined,1376,1152,0:02:02,122,,224,140544
20141025-ccc_priority_script,2014/10/25,ccc_priority_script,31,30,0:00:15,15,,1,450
20141026-ccc_311_calgary_combined,2014/10/26,ccc_311_calgary_combined,1148,1122,0:00:13,13,,26,14586
20141026-ccc_priority_script,2014/10/26,ccc_priority_script,16,16,0:00:15,15,,0,240
20141026-ccc_tax_script,2014/10/26,ccc_tax_script,1,1,0:00:09,9,,0,9
20141027-ccc_311_calgary_combined,2014/10/27,ccc_311_calgary_combined,3821,3448,0:01:32,92,,373,317216
20141027-ccc_help_script,2014/10/27,ccc_help_script,1,1,0:00:09,9,,0,9
20141027-ccc_priority_script,2014/10/27,ccc_priority_script,18,17,0:00:09,9,,1,153
20141027-ccc_tax_script,2014/10/27,ccc_tax_script,26,23,0:02:27,147,,3,3381
20141028-ccc_311_calgary_combined,2014/10/28,ccc_311_calgary_combined,3638,2637,0:05:06,306,,1001,806922
20141028-ccc_help_script,2014/10/28,ccc_help_script,5,5,0:00:13,13,,0,65
20141028-ccc_priority_script,2014/10/28,ccc_priority_script,24,23,0:00:11,11,,1,253
20141028-ccc_tax_script,2014/10/28,ccc_tax_script,26,18,0:03:36,216,,8,3888
20141029-ccc_311_calgary_combined,2014/10/29,ccc_311_calgary_combined,3395,2782,0:03:01,181,,613,503542
20141029-ccc_help_script,2014/10/29,ccc_help_script,1,1,0:00:05,5,,0,5
20141029-ccc_priority_script,2014/10/29,ccc_priority_script,36,34,0:00:16,16,,2,544
20141029-ccc_tax_script,2014/10/29,ccc_tax_script,13,8,0:04:45,285,,5,2280
20141030-ccc_311_calgary_combined,2014/10/30,ccc_311_calgary_combined,3001,2567,0:00:29,29,,434,74443
20141030-ccc_help_script,2014/10/30,ccc_help_script,3,3,0:00:05,5,,0,15
20141030-ccc_priority_script,2014/10/30,ccc_priority_script,28,27,0:00:13,13,,1,351
20141030-ccc_tax_script,2014/10/30,ccc_tax_script,15,10,0:00:26,26,,5,260
20141031-ccc_311_calgary_combined,2014/10/31,ccc_311_calgary_combined,2894,2610,0:01:26,86,,284,224460
20141031-ccc_help_script,2014/10/31,ccc_help_script,3,3,0:00:06,6,,0,18
20141031-ccc_priority_script,2014/10/31,ccc_priority_script,30,27,0:00:11,11,,3,297
20141031-ccc_tax_script,2014/10/31,ccc_tax_script,19,16,0:01:00,60,,3,960
20141101-ccc_311_calgary_combined,2014/11/01,ccc_311_calgary_combined,1114,1036,0:00:37,37,,78,38332
20141101-ccc_priority_script,2014/11/01,ccc_priority_script,21,21,0:00:07,7,,0,147
20141102-ccc_311_calgary_combined,2014/11/02,ccc_311_calgary_combined,1098,1052,0:00:25,25,,46,26300
20141102-ccc_priority_script,2014/11/02,ccc_priority_script,51,49,0:00:16,16,,2,784
20141103-ccc_311_calgary_combined,2014/11/03,ccc_311_calgary_combined,3609,3465,0:00:29,29,,144,100485
20141103-ccc_priority_script,2014/11/03,ccc_priority_script,28,27,0:00:13,13,,1,351
20141103-ccc_tax_script,2014/11/03,ccc_tax_script,20,20,0:00:26,26,,0,520
20141104-ccc_311_calgary_combined,2014/11/04,ccc_311_calgary_combined,3620,3113,0:02:00,120,,507,373560
20141104-ccc_help_script,2014/11/04,ccc_help_script,4,4,0:00:12,12,,0,48
20141104-ccc_priority_script,2014/11/04,ccc_priority_script,28,28,0:00:13,13,,0,364
20141104-ccc_tax_script,2014/11/04,ccc_tax_script,16,13,0:02:28,148,,3,1924
20141105-ccc_311_calgary_combined,2014/11/05,ccc_311_calgary_combined,3550,2715,0:03:54,234,,835,635310
20141105-ccc_help_script,2014/11/05,ccc_help_script,10,10,0:00:16,16,,0,160
20141105-ccc_priority_script,2014/11/05,ccc_priority_script,31,29,0:00:21,21,,2,609
20141105-ccc_tax_script,2014/11/05,ccc_tax_script,20,11,0:03:44,224,,9,2464
20141106-ccc_311_calgary_combined,2014/11/06,ccc_311_calgary_combined,3370,2826,0:02:32,152,,544,429552
20141106-ccc_help_script,2014/11/06,ccc_help_script,6,6,0:00:04,4,,0,24
20141106-ccc_priority_script,2014/11/06,ccc_priority_script,33,31,0:00:13,13,,2,403
20141106-ccc_tax_script,2014/11/06,ccc_tax_script,19,12,0:02:33,153,,7,1836
20141107-ccc_311_calgary_combined,2014/11/07,ccc_311_calgary_combined,3132,2630,0:02:37,157,,502,412910
20141107-ccc_help_script,2014/11/07,ccc_help_script,8,7,0:00:07,7,,1,49
20141107-ccc_priority_script,2014/11/07,ccc_priority_script,19,18,0:00:15,15,,1,270
20141107-ccc_tax_script,2014/11/07,ccc_tax_script,16,15,0:02:13,133,,1,1995
20141108-ccc_311_calgary_combined,2014/11/08,ccc_311_calgary_combined,1260,1224,0:00:19,19,,36,23256
20141108-ccc_help_script,2014/11/08,ccc_help_script,2,2,0:00:13,13,,0,26
20141108-ccc_priority_script,2014/11/08,ccc_priority_script,23,23,0:00:06,6,,0,138
20141109-ccc_311_calgary_combined,2014/11/09,ccc_311_calgary_combined,1020,994,0:00:12,12,,26,11928
20141109-ccc_help_script,2014/11/09,ccc_help_script,4,4,0:00:39,39,,0,156
20141109-ccc_priority_script,2014/11/09,ccc_priority_script,50,49,0:00:08,8,,1,392
20141109-ccc_tax_script,2014/11/09,ccc_tax_script,1,1,0:00:06,6,,0,6
20141110-ccc_311_calgary_combined,2014/11/10,ccc_311_calgary_combined,3459,3409,0:00:11,11,,50,37499
20141110-ccc_help_script,2014/11/10,ccc_help_script,10,10,0:00:06,6,,0,60
20141110-ccc_priority_script,2014/11/10,ccc_priority_script,44,41,0:00:07,7,,3,287
20141110-ccc_tax_script,2014/11/10,ccc_tax_script,17,17,0:00:16,16,,0,272
20141111-ccc_311_calgary_combined,2014/11/11,ccc_311_calgary_combined,1685,1653,0:00:11,11,,32,18183
20141111-ccc_help_script,2014/11/11,ccc_help_script,4,4,0:00:06,6,,0,24
20141111-ccc_priority_script,2014/11/11,ccc_priority_script,33,30,0:00:08,8,,3,240
20141111-ccc_tax_script,2014/11/11,ccc_tax_script,7,6,0:00:06,6,,1,36
20141112-ccc_311_calgary_combined,2014/11/12,ccc_311_calgary_combined,3222,2739,0:02:07,127,,483,347853
20141112-ccc_help_script,2014/11/12,ccc_help_script,7,6,0:00:21,21,,1,126
20141112-ccc_priority_script,2014/11/12,ccc_priority_script,29,27,0:00:13,13,,2,351
20141112-ccc_tax_script,2014/11/12,ccc_tax_script,27,23,0:02:31,151,,4,3473
20141113-ccc_311_calgary_combined,2014/11/13,ccc_311_calgary_combined,3115,2376,0:04:30,270,,739,641520
20141113-ccc_help_script,2014/11/13,ccc_help_script,7,7,0:00:11,11,,0,77
20141113-ccc_priority_script,2014/11/13,ccc_priority_script,44,41,0:00:18,18,,3,738
20141113-ccc_tax_script,2014/11/13,ccc_tax_script,20,15,0:06:22,382,,5,5730
20141114-ccc_311_calgary_combined,2014/11/14,ccc_311_calgary_combined,2965,2557,0:02:10,130,,408,332410
20141114-ccc_help_script,2014/11/14,ccc_help_script,5,5,0:00:12,12,,0,60
20141114-ccc_priority_script,2014/11/14,ccc_priority_script,39,39,0:00:11,11,,0,429
20141114-ccc_tax_script,2014/11/14,ccc_tax_script,9,7,0:03:05,185,,2,1295
20141115-ccc_311_calgary_combined,2014/11/15,ccc_311_calgary_combined,1028,1001,0:00:19,19,,27,19019
20141115-ccc_help_script,2014/11/15,ccc_help_script,1,1,0:00:05,5,,0,5
20141115-ccc_priority_script,2014/11/15,ccc_priority_script,18,17,0:00:06,6,,1,102
20141115-ccc_tax_script,2014/11/15,ccc_tax_script,1,1,0:00:06,6,,0,6
20141116-ccc_311_calgary_combined,2014/11/16,ccc_311_calgary_combined,870,856,0:00:11,11,,14,9416
20141116-ccc_priority_script,2014/11/16,ccc_priority_script,25,24,0:00:11,11,,1,264
20141116-ccc_tax_script,2014/11/16,ccc_tax_script,1,1,0:00:03,3,,0,3
20141117-ccc_311_calgary_combined,2014/11/17,ccc_311_calgary_combined,3329,3281,0:00:08,8,,48,26248
20141117-ccc_help_script,2014/11/17,ccc_help_script,1,1,0:00:04,4,,0,4
20141117-ccc_priority_script,2014/11/17,ccc_priority_script,25,25,0:00:11,11,,0,275
20141117-ccc_tax_script,2014/11/17,ccc_tax_script,20,20,0:00:12,12,,0,240
20141118-ccc_311_calgary_combined,2014/11/18,ccc_311_calgary_combined,3071,2840,0:01:04,64,,231,181760
20141118-ccc_help_script,2014/11/18,ccc_help_script,5,5,0:00:17,17,,0,85
20141118-ccc_priority_script,2014/11/18,ccc_priority_script,33,30,0:00:09,9,,3,270
20141118-ccc_tax_script,2014/11/18,ccc_tax_script,22,21,0:02:21,141,,1,2961
20141119-ccc_311_calgary_combined,2014/11/19,ccc_311_calgary_combined,3016,2620,0:01:56,116,,396,303920
20141119-ccc_help_script,2014/11/19,ccc_help_script,9,9,0:00:19,19,,0,171
20141119-ccc_priority_script,2014/11/19,ccc_priority_script,19,18,0:00:13,13,,1,234
20141119-ccc_tax_script,2014/11/19,ccc_tax_script,28,23,0:03:09,189,,5,4347
20141120-ccc_311_calgary_combined,2014/11/20,ccc_311_calgary_combined,3339,2723,0:03:05,185,,616,503755
20141120-ccc_help_script,2014/11/20,ccc_help_script,10,10,0:00:16,16,,0,160
20141120-ccc_priority_script,2014/11/20,ccc_priority_script,41,39,0:00:11,11,,2,429
20141120-ccc_tax_script,2014/11/20,ccc_tax_script,24,19,0:04:08,248,,5,4712
20141121-ccc_311_calgary_combined,2014/11/21,ccc_311_calgary_combined,3280,2574,0:04:12,252,,706,648648
20141121-ccc_help_script,2014/11/21,ccc_help_script,6,5,0:00:15,15,,1,75
20141121-ccc_priority_script,2014/11/21,ccc_priority_script,20,20,0:00:13,13,,0,260
20141121-ccc_tax_script,2014/11/21,ccc_tax_script,18,12,0:05:43,343,,6,4116
20141122-ccc_311_calgary_combined,2014/11/22,ccc_311_calgary_combined,1066,1005,0:00:41,41,,61,41205
20141122-ccc_help_script,2014/11/22,ccc_help_script,1,1,0:00:05,5,,0,5
20141122-ccc_priority_script,2014/11/22,ccc_priority_script,9,8,0:00:06,6,,1,48
20141123-ccc_311_calgary_combined,2014/11/23,ccc_311_calgary_combined,763,752,0:00:09,9,,11,6768
20141123-ccc_help_script,2014/11/23,ccc_help_script,1,1,0:00:04,4,,0,4
20141123-ccc_priority_script,2014/11/23,ccc_priority_script,14,14,0:00:05,5,,0,70
20141123-ccc_tax_script,2014/11/23,ccc_tax_script,1,1,0:00:07,7,,0,7
20141124-ccc_311_calgary_combined,2014/11/24,ccc_311_calgary_combined,3314,3183,0:00:37,37,,131,117771
20141124-ccc_help_script,2014/11/24,ccc_help_script,5,5,0:00:08,8,,0,40
20141124-ccc_priority_script,2014/11/24,ccc_priority_script,30,28,0:00:12,12,,2,336
20141124-ccc_tax_script,2014/11/24,ccc_tax_script,19,17,0:00:43,43,,2,731
20141125-ccc_311_calgary_combined,2014/11/25,ccc_311_calgary_combined,3069,2711,0:01:50,110,,358,298210
20141125-ccc_help_script,2014/11/25,ccc_help_script,8,8,0:00:19,19,,0,152
20141125-ccc_priority_script,2014/11/25,ccc_priority_script,27,27,0:00:15,15,,0,405
20141125-ccc_tax_script,2014/11/25,ccc_tax_script,15,11,0:02:32,152,,4,1672
20141126-ccc_311_calgary_combined,2014/11/26,ccc_311_calgary_combined,3304,2551,0:04:14,254,,753,647954
20141126-ccc_help_script,2014/11/26,ccc_help_script,7,7,0:00:14,14,,0,98
20141126-ccc_priority_script,2014/11/26,ccc_priority_script,21,21,0:00:20,20,,0,420
20141126-ccc_tax_script,2014/11/26,ccc_tax_script,16,11,0:04:47,287,,5,3157
20141127-ccc_311_calgary_combined,2014/11/27,ccc_311_calgary_combined,3405,2498,0:05:40,340,,907,849320
20141127-ccc_help_script,2014/11/27,ccc_help_script,9,9,0:00:11,11,,0,99
20141127-ccc_priority_script,2014/11/27,ccc_priority_script,33,32,0:00:16,16,,1,512
20141127-ccc_tax_script,2014/11/27,ccc_tax_script,16,8,0:05:49,349,,8,2792
20141128-ccc_311_calgary_combined,2014/11/28,ccc_311_calgary_combined,2990,2607,0:01:50,110,,383,286770
20141128-ccc_help_script,2014/11/28,ccc_help_script,5,5,0:00:13,13,,0,65
20141128-ccc_priority_script,2014/11/28,ccc_priority_script,58,58,0:00:12,12,,0,696
20141128-ccc_tax_script,2014/11/28,ccc_tax_script,16,14,0:02:27,147,,2,2058
20141129-ccc_311_calgary_combined,2014/11/29,ccc_311_calgary_combined,1443,1376,0:00:24,24,,67,33024
20141129-ccc_help_script,2014/11/29,ccc_help_script,1,1,0:00:07,7,,0,7
20141129-ccc_priority_script,2014/11/29,ccc_priority_script,55,52,0:00:12,12,,3,624
20141129-ccc_tax_script,2014/11/29,ccc_tax_script,1,1,0:00:17,17,,0,17
20141130-ccc_311_calgary_combined,2014/11/30,ccc_311_calgary_combined,875,854,0:00:21,21,,21,17934
20141130-ccc_priority_script,2014/11/30,ccc_priority_script,24,22,0:0:0,0,,2,0
20141201-ccc_311_calgary_combined,2014/12/01,ccc_311_calgary_combined,3354,2945,0:01:58,118,,409,347510
20141201-ccc_help_script,2014/12/01,ccc_help_script,4,4,0:00:29,29,,0,116
20141201-ccc_priority_script,2014/12/01,ccc_priority_script,26,26,0:00:19,19,,0,494
20141201-ccc_tax_script,2014/12/01,ccc_tax_script,11,7,0:05:29,329,,4,2303
20141202-ccc_311_calgary_combined,2014/12/02,ccc_311_calgary_combined,3484,2887,0:02:48,168,,597,485016
20141202-ccc_help_script,2014/12/02,ccc_help_script,1,1,0:00:14,14,,0,14
20141202-ccc_priority_script,2014/12/02,ccc_priority_script,30,27,0:00:15,15,,3,405
20141202-ccc_tax_script,2014/12/02,ccc_tax_script,23,17,0:02:55,175,,6,2975
20141203-ccc_311_calgary_combined,2014/12/03,ccc_311_calgary_combined,3165,2748,0:02:28,148,,417,406704
20141203-ccc_help_script,2014/12/03,ccc_help_script,4,4,0:00:07,7,,0,28
20141203-ccc_priority_script,2014/12/03,ccc_priority_script,42,36,0:00:11,11,,6,396
20141203-ccc_tax_script,2014/12/03,ccc_tax_script,17,14,0:03:21,201,,3,2814
20141204-ccc_311_calgary_combined,2014/12/04,ccc_311_calgary_combined,3016,2704,0:01:35,95,,312,256880
20141204-ccc_help_script,2014/12/04,ccc_help_script,8,8,0:00:14,14,,0,112
20141204-ccc_priority_script,2014/12/04,ccc_priority_script,25,25,0:00:17,17,,0,425
20141204-ccc_tax_script,2014/12/04,ccc_tax_script,24,21,0:01:45,105,,3,2205
20141205-ccc_311_calgary_combined,2014/12/05,ccc_311_calgary_combined,2651,2375,0:01:35,95,,276,225625
20141205-ccc_help_script,2014/12/05,ccc_help_script,4,4,0:00:04,4,,0,16
20141205-ccc_priority_script,2014/12/05,ccc_priority_script,33,32,0:00:09,9,,1,288
20141205-ccc_tax_script,2014/12/05,ccc_tax_script,10,10,0:00:41,41,,0,410
20141206-ccc_311_calgary_combined,2014/12/06,ccc_311_calgary_combined,999,982,0:00:18,18,,17,17676
20141206-ccc_priority_script,2014/12/06,ccc_priority_script,30,30,0:00:11,11,,0,330
20141207-ccc_311_calgary_combined,2014/12/07,ccc_311_calgary_combined,800,791,0:00:08,8,,9,6328
20141207-ccc_help_script,2014/12/07,ccc_help_script,1,1,0:00:05,5,,0,5
20141207-ccc_priority_script,2014/12/07,ccc_priority_script,29,26,0:00:07,7,,3,182
20141208-ccc_311_calgary_combined,2014/12/08,ccc_311_calgary_combined,3022,2964,0:00:15,15,,58,44460
20141208-ccc_help_script,2014/12/08,ccc_help_script,4,4,0:00:08,8,,0,32
20141208-ccc_priority_script,2014/12/08,ccc_priority_script,25,24,0:00:06,6,,1,144
20141208-ccc_tax_script,2014/12/08,ccc_tax_script,12,12,0:00:12,12,,0,144
20141209-ccc_311_calgary_combined,2014/12/09,ccc_311_calgary_combined,3017,2740,0:01:23,83,,277,227420
20141209-ccc_help_script,2014/12/09,ccc_help_script,7,6,0:00:10,10,,1,60
20141209-ccc_priority_script,2014/12/09,ccc_priority_script,32,29,0:00:16,16,,3,464
20141209-ccc_tax_script,2014/12/09,ccc_tax_script,10,8,0:02:13,133,,2,1064
20141210-ccc_311_calgary_combined,2014/12/10,ccc_311_calgary_combined,2802,2577,0:01:08,68,,225,175236
20141210-ccc_help_script,2014/12/10,ccc_help_script,4,4,0:00:06,6,,0,24
20141210-ccc_priority_script,2014/12/10,ccc_priority_script,21,19,0:00:17,17,,2,323
20141210-ccc_tax_script,2014/12/10,ccc_tax_script,16,12,0:01:20,80,,4,960
20141211-ccc_311_calgary_combined,2014/12/11,ccc_311_calgary_combined,3163,2788,0:02:03,123,,375,342924
20141211-ccc_help_script,2014/12/11,ccc_help_script,4,4,0:00:16,16,,0,64
20141211-ccc_priority_script,2014/12/11,ccc_priority_script,29,27,0:00:17,17,,2,459
20141211-ccc_tax_script,2014/12/11,ccc_tax_script,17,15,0:02:31,151,,2,2265
20141212-ccc_311_calgary_combined,2014/12/12,ccc_311_calgary_combined,2961,2619,0:02:03,123,,342,322137
20141212-ccc_help_script,2014/12/12,ccc_help_script,10,10,0:00:09,9,,0,90
20141212-ccc_priority_script,2014/12/12,ccc_priority_script,29,27,0:00:12,12,,2,324
20141212-ccc_tax_script,2014/12/12,ccc_tax_script,29,25,0:01:48,108,,4,2700
20141213-ccc_311_calgary_combined,2014/12/13,ccc_311_calgary_combined,1014,973,0:00:27,27,,41,26271
20141213-ccc_priority_script,2014/12/13,ccc_priority_script,21,20,0:00:06,6,,1,120
20141214-ccc_311_calgary_combined,2014/12/14,ccc_311_calgary_combined,882,868,0:00:17,17,,14,14756
20141214-ccc_help_script,2014/12/14,ccc_help_script,1,1,0:00:06,6,,0,6
20141214-ccc_priority_script,2014/12/14,ccc_priority_script,21,21,0:00:05,5,,0,105
20141215-ccc_311_calgary_combined,2014/12/15,ccc_311_calgary_combined,3241,3132,0:00:32,32,,109,100224
20141215-ccc_help_script,2014/12/15,ccc_help_script,6,6,0:00:12,12,,0,72
20141215-ccc_priority_script,2014/12/15,ccc_priority_script,21,21,0:00:10,10,,0,210
20141215-ccc_tax_script,2014/12/15,ccc_tax_script,9,9,0:00:12,12,,0,108
20141216-ccc_311_calgary_combined,2014/12/16,ccc_311_calgary_combined,3026,2887,0:00:42,42,,139,121254
20141216-ccc_help_script,2014/12/16,ccc_help_script,9,6,0:00:05,5,,3,30
20141216-ccc_priority_script,2014/12/16,ccc_priority_script,29,26,0:00:19,19,,3,494
20141216-ccc_tax_script,2014/12/16,ccc_tax_script,16,12,0:00:19,19,,4,228
20141217-ccc_311_calgary_combined,2014/12/17,ccc_311_calgary_combined,2781,2604,0:00:57,57,,177,148428
20141217-ccc_help_script,2014/12/17,ccc_help_script,5,5,0:00:25,25,,0,125
20141217-ccc_priority_script,2014/12/17,ccc_priority_script,30,29,0:00:16,16,,1,464
20141217-ccc_tax_script,2014/12/17,ccc_tax_script,20,18,0:01:10,70,,2,1260
20141218-ccc_311_calgary_combined,2014/12/18,ccc_311_calgary_combined,2818,2562,0:01:19,79,,256,202398
20141218-ccc_help_script,2014/12/18,ccc_help_script,4,3,0:00:16,16,,1,48
20141218-ccc_priority_script,2014/12/18,ccc_priority_script,26,26,0:00:16,16,,0,416
20141218-ccc_tax_script,2014/12/18,ccc_tax_script,17,17,0:01:20,80,,0,1360
20141219-ccc_311_calgary_combined,2014/12/19,ccc_311_calgary_combined,2490,2368,0:00:43,43,,122,101824
20141219-ccc_help_script,2014/12/19,ccc_help_script,2,2,0:00:08,8,,0,16
20141219-ccc_priority_script,2014/12/19,ccc_priority_script,27,27,0:00:13,13,,0,351
20141219-ccc_tax_script,2014/12/19,ccc_tax_script,18,16,0:00:26,26,,2,416
20141220-ccc_311_calgary_combined,2014/12/20,ccc_311_calgary_combined,1005,988,0:00:11,11,,17,10868
20141220-ccc_priority_script,2014/12/20,ccc_priority_script,14,14,0:00:07,7,,0,98
20141220-ccc_tax_script,2014/12/20,ccc_tax_script,1,1,0:00:06,6,,0,6
20141221-ccc_311_calgary_combined,2014/12/21,ccc_311_calgary_combined,857,840,0:00:17,17,,17,14280
20141221-ccc_priority_script,2014/12/21,ccc_priority_script,11,10,0:00:06,6,,1,60
20141221-ccc_tax_script,2014/12/21,ccc_tax_script,2,2,0:00:04,4,,0,8
20141222-ccc_311_calgary_combined,2014/12/22,ccc_311_calgary_combined,2992,2813,0:00:55,55,,179,154715
20141222-ccc_help_script,2014/12/22,ccc_help_script,6,5,0:00:04,4,,1,20
20141222-ccc_priority_script,2014/12/22,ccc_priority_script,20,20,0:00:08,8,,0,160
20141222-ccc_tax_script,2014/12/22,ccc_tax_script,20,17,0:01:17,77,,3,1309
20141223-ccc_311_calgary_combined,2014/12/23,ccc_311_calgary_combined,2569,2430,0:00:52,52,,139,126360
20141223-ccc_help_script,2014/12/23,ccc_help_script,4,3,0:00:04,4,,1,12
20141223-ccc_priority_script,2014/12/23,ccc_priority_script,25,24,0:00:12,12,,1,288
20141223-ccc_tax_script,2014/12/23,ccc_tax_script,10,9,0:01:20,80,,1,720
20141224-ccc_311_calgary_combined,2014/12/24,ccc_311_calgary_combined,1430,1412,0:00:09,9,,18,12708
20141224-ccc_help_script,2014/12/24,ccc_help_script,3,3,0:00:05,5,,0,15
20141224-ccc_priority_script,2014/12/24,ccc_priority_script,32,32,0:00:06,6,,0,192
20141224-ccc_tax_script,2014/12/24,ccc_tax_script,2,2,0:00:11,11,,0,22
20141225-ccc_311_calgary_combined,2014/12/25,ccc_311_calgary_combined,294,290,0:00:07,7,,4,2030
20141225-ccc_help_script,2014/12/25,ccc_help_script,1,1,0:00:03,3,,0,3
20141225-ccc_priority_script,2014/12/25,ccc_priority_script,14,14,0:00:10,10,,0,140
20141226-ccc_311_calgary_combined,2014/12/26,ccc_311_calgary_combined,797,786,0:00:08,8,,11,6288
20141226-ccc_priority_script,2014/12/26,ccc_priority_script,10,10,0:00:06,6,,0,60
20141227-ccc_311_calgary_combined,2014/12/27,ccc_311_calgary_combined,965,948,0:00:10,10,,17,9480
20141227-ccc_help_script,2014/12/27,ccc_help_script,1,1,0:00:05,5,,0,5
20141227-ccc_priority_script,2014/12/27,ccc_priority_script,13,13,0:00:07,7,,0,91
20141227-ccc_tax_script,2014/12/27,ccc_tax_script,1,1,0:00:04,4,,0,4
20141228-ccc_311_calgary_combined,2014/12/28,ccc_311_calgary_combined,658,655,0:00:07,7,,3,4585
20141228-ccc_help_script,2014/12/28,ccc_help_script,2,2,0:00:07,7,,0,14
20141228-ccc_priority_script,2014/12/28,ccc_priority_script,11,11,0:00:06,6,,0,66
20141229-ccc_311_calgary_combined,2014/12/29,ccc_311_calgary_combined,2550,2480,0:00:22,22,,70,54560
20141229-ccc_help_script,2014/12/29,ccc_help_script,3,3,0:00:06,6,,0,18
20141229-ccc_priority_script,2014/12/29,ccc_priority_script,44,44,0:00:06,6,,0,264
20141229-ccc_tax_script,2014/12/29,ccc_tax_script,1,1,0:00:03,3,,0,3
20141230-ccc_311_calgary_combined,2014/12/30,ccc_311_calgary_combined,2541,2378,0:00:56,56,,163,133168
20141230-ccc_help_script,2014/12/30,ccc_help_script,6,6,0:00:09,9,,0,54
20141230-ccc_priority_script,2014/12/30,ccc_priority_script,23,22,0:00:11,11,,1,242
20141231-ccc_311_calgary_combined,2014/12/31,ccc_311_calgary_combined,2034,2005,0:00:11,11,,29,22055
20141231-ccc_help_script,2014/12/31,ccc_help_script,4,4,0:00:11,11,,0,44
20141231-ccc_priority_script,2014/12/31,ccc_priority_script,20,20,0:00:07,7,,0,140
20150101-ccc_311_calgary_combined,2015/01/01,ccc_311_calgary_combined,672,669,0:00:07,7,,3,4683
20150101-ccc_priority_script,2015/01/01,ccc_priority_script,11,11,0:00:06,6,,0,66
20150102-ccc_311_calgary_combined,2015/01/02,ccc_311_calgary_combined,2194,2153,0:00:12,12,,41,25836
20150102-ccc_help_script,2015/01/02,ccc_help_script,3,3,0:00:06,6,,0,18
20150102-ccc_priority_script,2015/01/02,ccc_priority_script,26,26,0:00:14,14,,0,364
20150102-ccc_tax_script,2015/01/02,ccc_tax_script,11,11,0:00:06,6,,0,66
20150103-ccc_311_calgary_combined,2015/01/03,ccc_311_calgary_combined,963,947,0:00:10,10,,16,9470
20150103-ccc_help_script,2015/01/03,ccc_help_script,1,1,0:00:11,11,,0,11
20150103-ccc_priority_script,2015/01/03,ccc_priority_script,48,47,0:00:07,7,,1,329
20150104-ccc_311_calgary_combined,2015/01/04,ccc_311_calgary_combined,851,839,0:00:09,9,,12,7551
20150104-ccc_priority_script,2015/01/04,ccc_priority_script,27,27,0:00:08,8,,0,216
20150105-ccc_311_calgary_combined,2015/01/05,ccc_311_calgary_combined,3233,3157,0:00:17,17,,76,53669
20150105-ccc_help_script,2015/01/05,ccc_help_script,7,7,0:00:13,13,,0,91
20150105-ccc_priority_script,2015/01/05,ccc_priority_script,24,24,0:00:10,10,,0,240
20150105-ccc_tax_script,2015/01/05,ccc_tax_script,20,18,0:00:16,16,,2,288
20150106-ccc_311_calgary_combined,2015/01/06,ccc_311_calgary_combined,3378,3052,0:01:12,72,,326,219744
20150106-ccc_help_script,2015/01/06,ccc_help_script,6,5,0:00:07,7,,1,35
20150106-ccc_priority_script,2015/01/06,ccc_priority_script,33,32,0:00:11,11,,1,352
20150106-ccc_tax_script,2015/01/06,ccc_tax_script,19,19,0:01:06,66,,0,1254
20150107-ccc_311_calgary_combined,2015/01/07,ccc_311_calgary_combined,3954,3190,0:02:47,167,,764,532730
20150107-ccc_help_script,2015/01/07,ccc_help_script,6,6,0:00:10,10,,0,60
20150107-ccc_priority_script,2015/01/07,ccc_priority_script,45,45,0:00:15,15,,0,675
20150107-ccc_tax_script,2015/01/07,ccc_tax_script,15,15,0:02:59,179,,0,2685
20150108-ccc_311_calgary_combined,2015/01/08,ccc_311_calgary_combined,3455,2861,0:02:38,158,,594,452038
20150108-ccc_help_script,2015/01/08,ccc_help_script,5,3,0:00:06,6,,2,18
20150108-ccc_priority_script,2015/01/08,ccc_priority_script,34,28,0:00:16,16,,6,448
20150108-ccc_tax_script,2015/01/08,ccc_tax_script,19,16,0:02:05,125,,3,2000
20150109-ccc_311_calgary_combined,2015/01/09,ccc_311_calgary_combined,3110,2792,0:01:22,82,,318,228944
20150109-ccc_help_script,2015/01/09,ccc_help_script,3,2,0:00:09,9,,1,18
20150109-ccc_priority_script,2015/01/09,ccc_priority_script,22,22,0:00:15,15,,0,330
20150109-ccc_tax_script,2015/01/09,ccc_tax_script,21,19,0:02:17,137,,2,2603
20150110-ccc_311_calgary_combined,2015/01/10,ccc_311_calgary_combined,1059,1052,0:00:07,7,,7,7364
20150110-ccc_help_script,2015/01/10,ccc_help_script,1,1,0:00:05,5,,0,5
20150110-ccc_priority_script,2015/01/10,ccc_priority_script,24,22,0:00:10,10,,2,220
20150111-ccc_311_calgary_combined,2015/01/11,ccc_311_calgary_combined,791,782,0:00:10,10,,9,7820
20150111-ccc_priority_script,2015/01/11,ccc_priority_script,27,26,0:00:07,7,,1,182
20150111-ccc_tax_script,2015/01/11,ccc_tax_script,1,1,0:00:04,4,,0,4
20150112-ccc_311_calgary_combined,2015/01/12,ccc_311_calgary_combined,3318,3239,0:00:21,21,,79,68019
20150112-ccc_help_script,2015/01/12,ccc_help_script,3,3,0:00:05,5,,0,15
20150112-ccc_priority_script,2015/01/12,ccc_priority_script,29,29,0:00:12,12,,0,348
20150112-ccc_tax_script,2015/01/12,ccc_tax_script,21,21,0:00:21,21,,0,441
20150113-ccc_311_calgary_combined,2015/01/13,ccc_311_calgary_combined,3178,2928,0:01:11,71,,250,207888
20150113-ccc_help_script,2015/01/13,ccc_help_script,5,5,0:00:08,8,,0,40
20150113-ccc_priority_script,2015/01/13,ccc_priority_script,21,20,0:00:17,17,,1,340
20150113-ccc_tax_script,2015/01/13,ccc_tax_script,21,18,0:01:39,99,,3,1782
20150114-ccc_311_calgary_combined,2015/01/14,ccc_311_calgary_combined,3184,2774,0:01:49,109,,410,302366
20150114-ccc_help_script,2015/01/14,ccc_help_script,1,1,0:00:08,8,,0,8
20150114-ccc_priority_script,2015/01/14,ccc_priority_script,24,23,0:00:13,13,,1,299
20150114-ccc_tax_script,2015/01/14,ccc_tax_script,20,15,0:01:40,100,,5,1500
20150115-ccc_311_calgary_combined,2015/01/15,ccc_311_calgary_combined,3216,2832,0:01:50,110,,384,311520
20150115-ccc_help_script,2015/01/15,ccc_help_script,4,4,0:00:09,9,,0,36
20150115-ccc_priority_script,2015/01/15,ccc_priority_script,28,26,0:00:14,14,,2,364
20150115-ccc_tax_script,2015/01/15,ccc_tax_script,14,13,0:01:57,117,,1,1521
20150116-ccc_311_calgary_combined,2015/01/16,ccc_311_calgary_combined,3235,2484,0:04:05,245,,751,608580
20150116-ccc_help_script,2015/01/16,ccc_help_script,4,3,0:00:13,13,,1,39
20150116-ccc_priority_script,2015/01/16,ccc_priority_script,25,25,0:00:15,15,,0,375
20150116-ccc_tax_script,2015/01/16,ccc_tax_script,21,19,0:05:24,324,,2,6156
20150117-ccc_311_calgary_combined,2015/01/17,ccc_311_calgary_combined,1263,1213,0:00:29,29,,50,35177
20150117-ccc_priority_script,2015/01/17,ccc_priority_script,16,16,0:00:09,9,,0,144
20150118-ccc_311_calgary_combined,2015/01/18,ccc_311_calgary_combined,913,889,0:00:16,16,,24,14224
20150118-ccc_priority_script,2015/01/18,ccc_priority_script,14,12,0:00:12,12,,2,144
20150118-ccc_tax_script,2015/01/18,ccc_tax_script,1,1,0:00:07,7,,0,7
20150119-ccc_311_calgary_combined,2015/01/19,ccc_311_calgary_combined,3353,3297,0:00:18,18,,56,59346
20150119-ccc_help_script,2015/01/19,ccc_help_script,4,4,0:00:04,4,,0,16
20150119-ccc_priority_script,2015/01/19,ccc_priority_script,15,14,0:00:10,10,,1,140
20150119-ccc_tax_script,2015/01/19,ccc_tax_script,17,16,0:00:30,30,,1,480
20150120-ccc_311_calgary_combined,2015/01/20,ccc_311_calgary_combined,3302,3010,0:01:19,79,,292,237790
20150120-ccc_help_script,2015/01/20,ccc_help_script,7,7,0:00:08,8,,0,56
20150120-ccc_priority_script,2015/01/20,ccc_priority_script,26,26,0:00:15,15,,0,390
20150120-ccc_tax_script,2015/01/20,ccc_tax_script,15,11,0:02:13,133,,4,1463
20150121-ccc_311_calgary_combined,2015/01/21,ccc_311_calgary_combined,3021,2821,0:00:55,55,,200,155155
20150121-ccc_help_script,2015/01/21,ccc_help_script,6,6,0:00:08,8,,0,48
20150121-ccc_priority_script,2015/01/21,ccc_priority_script,23,20,0:00:07,7,,3,140
20150121-ccc_tax_script,2015/01/21,ccc_tax_script,13,13,0:00:28,28,,0,364
20150122-ccc_311_calgary_combined,2015/01/22,ccc_311_calgary_combined,3108,2932,0:00:51,51,,176,149532
20150122-ccc_help_script,2015/01/22,ccc_help_script,7,6,0:00:20,20,,1,120
20150122-ccc_priority_script,2015/01/22,ccc_priority_script,28,27,0:00:09,9,,1,243
20150122-ccc_tax_script,2015/01/22,ccc_tax_script,8,8,0:00:47,47,,0,376
20150123-ccc_311_calgary_combined,2015/01/23,ccc_311_calgary_combined,2980,2846,0:00:31,31,,134,88226
20150123-ccc_help_script,2015/01/23,ccc_help_script,2,1,0:00:02,2,,1,2
20150123-ccc_priority_script,2015/01/23,ccc_priority_script,34,30,0:00:12,12,,4,360
20150123-ccc_tax_script,2015/01/23,ccc_tax_script,16,15,0:00:23,23,,1,345
20150124-ccc_311_calgary_combined,2015/01/24,ccc_311_calgary_combined,1275,1201,0:00:41,41,,74,49241
20150124-ccc_priority_script,2015/01/24,ccc_priority_script,26,25,0:00:19,19,,1,475
20150125-ccc_311_calgary_combined,2015/01/25,ccc_311_calgary_combined,996,984,0:00:10,10,,12,9840
20150125-ccc_priority_script,2015/01/25,ccc_priority_script,15,15,0:00:05,5,,0,75
20150126-ccc_311_calgary_combined,2015/01/26,ccc_311_calgary_combined,3447,3356,0:00:21,21,,91,70476
20150126-ccc_help_script,2015/01/26,ccc_help_script,1,1,0:00:01,1,,0,1
20150126-ccc_priority_script,2015/01/26,ccc_priority_script,33,31,0:00:11,11,,2,341
20150126-ccc_tax_script,2015/01/26,ccc_tax_script,26,26,0:00:17,17,,0,442
20150127-ccc_311_calgary_combined,2015/01/27,ccc_311_calgary_combined,3338,3027,0:01:40,100,,311,302700
20150127-ccc_help_script,2015/01/27,ccc_help_script,6,5,0:00:08,8,,1,40
20150127-ccc_priority_script,2015/01/27,ccc_priority_script,28,26,0:00:11,11,,2,286
20150127-ccc_tax_script,2015/01/27,ccc_tax_script,14,14,0:01:16,76,,0,1064
20150128-ccc_311_calgary_combined,2015/01/28,ccc_311_calgary_combined,3438,2724,0:03:46,226,,714,615624
20150128-ccc_help_script,2015/01/28,ccc_help_script,10,10,0:00:15,15,,0,150
20150128-ccc_priority_script,2015/01/28,ccc_priority_script,25,23,0:00:17,17,,2,391
20150128-ccc_tax_script,2015/01/28,ccc_tax_script,11,9,0:04:13,253,,2,2277
20150129-ccc_311_calgary_combined,2015/01/29,ccc_311_calgary_combined,3027,2776,0:01:12,72,,251,199872
20150129-ccc_help_script,2015/01/29,ccc_help_script,9,9,0:00:17,17,,0,153
20150129-ccc_priority_script,2015/01/29,ccc_priority_script,27,27,0:00:11,11,,0,297
20150129-ccc_tax_script,2015/01/29,ccc_tax_script,23,19,0:01:54,114,,4,2166
20150130-ccc_311_calgary_combined,2015/01/30,ccc_311_calgary_combined,2921,2489,0:02:35,155,,432,385795
20150130-ccc_help_script,2015/01/30,ccc_help_script,5,5,0:00:21,21,,0,105
20150130-ccc_priority_script,2015/01/30,ccc_priority_script,38,35,0:00:17,17,,3,595
20150130-ccc_tax_script,2015/01/30,ccc_tax_script,19,14,0:03:38,218,,5,3052
20150131-ccc_311_calgary_combined,2015/01/31,ccc_311_calgary_combined,989,967,0:00:11,11,,22,10637
20150131-ccc_priority_script,2015/01/31,ccc_priority_script,39,39,0:00:07,7,,0,273
20150131-ccc_tax_script,2015/01/31,ccc_tax_script,1,1,0:00:07,7,,0,7
20150201-ccc_311_calgary_combined,2015/02/01,ccc_311_calgary_combined,646,642,0:00:07,7,,4,4494
20150201-ccc_help_script,2015/02/01,ccc_help_script,3,3,0:00:06,6,,0,18
20150201-ccc_priority_script,2015/02/01,ccc_priority_script,24,24,0:00:06,6,,0,144
20150202-ccc_311_calgary_combined,2015/02/02,ccc_311_calgary_combined,3026,2988,0:00:11,11,,38,32868
20150202-ccc_help_script,2015/02/02,ccc_help_script,2,5,0:00:04,4,,0,20
20150202-ccc_priority_script,2015/02/02,ccc_priority_script,26,23,0:00:08,8,,3,184
20150202-ccc_tax_script,2015/02/02,ccc_tax_script,19,19,0:00:10,10,,0,190
20150203-ccc_311_calgary_combined,2015/02/03,ccc_311_calgary_combined,2977,2891,0:00:19,19,,86,54929
20150203-ccc_help_script,2015/02/03,ccc_help_script,5,5,0:00:07,7,,0,35
20150203-ccc_priority_script,2015/02/03,ccc_priority_script,33,31,0:00:11,11,,2,341
20150203-ccc_tax_script,2015/02/03,ccc_tax_script,25,20,0:00:16,16,,5,320
20150204-ccc_311_calgary_combined,2015/02/04,ccc_311_calgary_combined,2786,2731,0:00:18,18,,55,49158
20150204-ccc_help_script,2015/02/04,ccc_help_script,5,5,0:00:10,10,,0,50
20150204-ccc_priority_script,2015/02/04,ccc_priority_script,22,22,0:00:07,7,,0,154
20150204-ccc_tax_script,2015/02/04,ccc_tax_script,17,16,0:00:27,27,,1,432
20150205-ccc_311_calgary_combined,2015/02/05,ccc_311_calgary_combined,2643,2538,0:00:33,33,,105,83754
20150205-ccc_help_script,2015/02/05,ccc_help_script,8,8,0:00:14,14,,0,112
20150205-ccc_priority_script,2015/02/05,ccc_priority_script,20,20,0:00:08,8,,0,160
20150205-ccc_tax_script,2015/02/05,ccc_tax_script,14,14,0:00:33,33,,0,462
20150206-ccc_311_calgary_combined,2015/02/06,ccc_311_calgary_combined,2560,2466,0:00:22,22,,94,54252
20150206-ccc_help_script,2015/02/06,ccc_help_script,3,3,0:00:09,9,,0,27
20150206-ccc_priority_script,2015/02/06,ccc_priority_script,31,22,0:00:10,10,,1,220
20150206-ccc_tax_script,2015/02/06,ccc_tax_script,20,18,0:00:17,17,,2,306
20150207-ccc_311_calgary_combined,2015/02/07,ccc_311_calgary_combined,920,902,0:00:12,12,,18,10824
20150207-ccc_priority_script,2015/02/07,ccc_priority_script,16,16,0:00:19,19,,0,304
20150208-ccc_311_calgary_combined,2015/02/08,ccc_311_calgary_combined,780,774,0:00:07,7,,6,5418
20150208-ccc_priority_script,2015/02/08,ccc_priority_script,17,17,0:00:06,6,,0,102
20150209-ccc_311_calgary_combined,2015/02/09,ccc_311_calgary_combined,2999,2953,0:00:15,15,,46,44295
20150209-ccc_help_script,2015/02/09,ccc_help_script,3,3,0:00:09,9,,0,27
20150209-ccc_priority_script,2015/02/09,ccc_priority_script,14,14,0:00:11,11,,0,154
20150209-ccc_tax_script,2015/02/09,ccc_tax_script,19,19,0:00:09,9,,0,171
20150210-ccc_311_calgary_combined,2015/02/10,ccc_311_calgary_combined,2836,2606,0:01:01,61,,230,158966
20150210-ccc_help_script,2015/02/10,ccc_help_script,7,6,0:00:17,17,,1,102
20150210-ccc_priority_script,2015/02/10,ccc_priority_script,16,16,0:00:10,10,,0,160
20150210-ccc_tax_script,2015/02/10,ccc_tax_script,10,9,0:01:16,76,,8,684
20150211-ccc_311_calgary_combined,2015/02/11,ccc_311_calgary_combined,2594,2560,0:00:09,9,,34,23040
20150211-ccc_help_script,2015/02/11,ccc_help_script,1,1,0:00:03,3,,0,3
20150211-ccc_priority_script,2015/02/11,ccc_priority_script,22,21,0:00:08,8,,1,168
20150211-ccc_tax_script,2015/02/11,ccc_tax_script,20,20,0:00:09,9,,0,180
20150212-ccc_311_calgary_combined,2015/02/12,ccc_311_calgary_combined,3414,2935,0:01:39,99,,479,290565
20150212-ccc_help_script,2015/02/12,ccc_help_script,9,9,0:00:08,8,,0,72
20150212-ccc_priority_script,2015/02/12,ccc_priority_script,23,23,0:00:13,13,,0,299
20150212-ccc_tax_script,2015/02/12,ccc_tax_script,13,12,0:00:46,46,,1,552
20150213-ccc_311_calgary_combined,2015/02/13,ccc_311_calgary_combined,2885,2671,0:01:08,68,,214,181628
20150213-ccc_help_script,2015/02/13,ccc_help_script,3,1,0:00:26,26,,2,26
20150213-ccc_priority_script,2015/02/13,ccc_priority_script,28,27,0:00:22,22,,1,594
20150213-ccc_tax_script,2015/02/13,ccc_tax_script,10,10,0:01:44,104,,0,1040
20150214-ccc_311_calgary_combined,2015/02/14,ccc_311_calgary_combined,1128,1114,0:00:11,11,,14,12254
20150214-ccc_priority_script,2015/02/14,ccc_priority_script,19,17,0:00:10,10,,2,170
20150215-ccc_311_calgary_combined,2015/02/15,ccc_311_calgary_combined,945,936,0:00:09,9,,9,8424
20150215-ccc_priority_script,2015/02/15,ccc_priority_script,14,14,0:00:18,18,,0,252
20150216-ccc_311_calgary_combined,2015/02/16,ccc_311_calgary_combined,1485,1468,0:00:08,8,,17,11744
20150216-ccc_help_script,2015/02/16,ccc_help_script,1,1,0:00:15,15,,0,15
20150216-ccc_priority_script,2015/02/16,ccc_priority_script,17,15,0:00:12,12,,2,180
20150217-ccc_311_calgary_combined,2015/02/17,ccc_311_calgary_combined,3450,3277,0:00:33,33,,173,108141
20150217-ccc_help_script,2015/02/17,ccc_help_script,1,1,0:00:17,17,,0,17
20150217-ccc_priority_script,2015/02/17,ccc_priority_script,24,24,0:00:06,6,,0,144
20150217-ccc_tax_script,2015/02/17,ccc_tax_script,18,18,0:00:18,18,,0,324
20150218-ccc_311_calgary_combined,2015/02/18,ccc_311_calgary_combined,3082,2929,0:00:46,46,,153,134734
20150218-ccc_help_script,2015/02/18,ccc_help_script,1,1,0:00:09,9,,0,9
20150218-ccc_priority_script,2015/02/18,ccc_priority_script,17,16,0:00:23,23,,1,368
20150218-ccc_tax_script,2015/02/18,ccc_tax_script,19,19,0:00:38,38,,0,722
20150219-ccc_311_calgary_combined,2015/02/19,ccc_311_calgary_combined,2944,2875,0:00:21,21,,69,60375
20150219-ccc_help_script,2015/02/19,ccc_help_script,6,6,0:00:11,11,,0,66
20150219-ccc_priority_script,2015/02/19,ccc_priority_script,32,31,0:00:13,13,,1,403
20150219-ccc_tax_script,2015/02/19,ccc_tax_script,16,13,0:00:18,18,,3,234
20150220-ccc_311_calgary_combined,2015/02/20,ccc_311_calgary_combined,2778,2425,0:02:08,128,,353,310400
20150220-ccc_help_script,2015/02/20,ccc_help_script,9,9,0:00:15,15,,0,135
20150220-ccc_priority_script,2015/02/20,ccc_priority_script,21,21,0:00:11,11,,0,231
20150220-ccc_tax_script,2015/02/20,ccc_tax_script,18,16,0:02:54,174,,2,2784
20150221-ccc_311_calgary_combined,2015/02/21,ccc_311_calgary_combined,856,848,0:00:11,11,,8,9328
20150221-ccc_priority_script,2015/02/21,ccc_priority_script,17,17,0:00:25,25,,0,425
20150222-ccc_311_calgary_combined,2015/02/22,ccc_311_calgary_combined,707,696,0:00:07,7,,11,4872
20150222-ccc_priority_script,2015/02/22,ccc_priority_script,14,14,0:00:05,5,,0,70
20150223-ccc_311_calgary_combined,2015/02/23,ccc_311_calgary_combined,3212,3165,0:00:13,13,,47,41145
20150223-ccc_help_script,2015/02/23,ccc_help_script,2,2,0:00:04,4,,0,8
20150223-ccc_priority_script,2015/02/23,ccc_priority_script,21,21,0:00:17,17,,0,357
20150223-ccc_tax_script,2015/02/23,ccc_tax_script,11,11,0:00:07,7,,0,77
20150224-ccc_311_calgary_combined,2015/02/24,ccc_311_calgary_combined,2875,2797,0:00:22,22,,78,61534
20150224-ccc_help_script,2015/02/24,ccc_help_script,4,4,0:00:14,14,,0,56
20150224-ccc_priority_script,2015/02/24,ccc_priority_script,15,15,0:00:13,13,,0,195
20150224-ccc_tax_script,2015/02/24,ccc_tax_script,13,11,0:00:13,13,,2,143
20150225-ccc_311_calgary_combined,2015/02/25,ccc_311_calgary_combined,2694,2673,0:00:10,10,,21,26730
20150225-ccc_help_script,2015/02/25,ccc_help_script,2,2,0:00:02,2,,0,4
20150225-ccc_priority_script,2015/02/25,ccc_priority_script,26,26,0:00:06,6,,0,156
20150225-ccc_tax_script,2015/02/25,ccc_tax_script,16,16,0:00:18,18,,0,288
20150226-ccc_311_calgary_combined,2015/02/26,ccc_311_calgary_combined,2570,2534,0:00:11,11,,36,27874
20150226-ccc_help_script,2015/02/26,ccc_help_script,2,2,0:00:04,4,,0,8
20150226-ccc_priority_script,2015/02/26,ccc_priority_script,21,21,0:00:09,9,,0,189
20150226-ccc_tax_script,2015/02/26,ccc_tax_script,17,16,0:00:05,5,,1,80
20150227-ccc_311_calgary_combined,2015/02/27,ccc_311_calgary_combined,2523,2424,0:00:31,31,,99,75144
20150227-ccc_help_script,2015/02/27,ccc_help_script,4,4,0:00:08,8,,0,32
20150227-ccc_priority_script,2015/02/27,ccc_priority_script,23,23,0:00:13,13,,0,299
20150227-ccc_tax_script,2015/02/27,ccc_tax_script,13,13,0:00:40,40,,0,520
20150228-ccc_311_calgary_combined,2015/02/28,ccc_311_calgary_combined,926,916,0:00:09,9,,10,8244
20150228-ccc_priority_script,2015/02/28,ccc_priority_script,17,15,0:00:07,7,,2,105
20150228-ccc_tax_script,2015/02/28,ccc_tax_script,2,2,0:00:04,4,,0,8
20150301-ccc_311_calgary_combined,2015/03/01,ccc_311_calgary_combined,793,786,0:00:07,7,,7,5502
20150301-ccc_help_script,2015/03/01,ccc_help_script,3,3,0:00:06,6,,0,18
20150301-ccc_priority_script,2015/03/01,ccc_priority_script,21,21,0:00:06,6,,0,126
20150301-ccc_tax_script,2015/03/01,ccc_tax_script,1,1,0:00:02,2,,0,2
20150302-ccc_311_calgary_combined,2015/03/02,ccc_311_calgary_combined,3045,3010,0:00:12,12,,35,36120
20150302-ccc_help_script,2015/03/02,ccc_help_script,1,1,0:00:04,4,,0,4
20150302-ccc_priority_script,2015/03/02,ccc_priority_script,33,33,0:00:06,6,,0,198
20150302-ccc_tax_script,2015/03/02,ccc_tax_script,19,19,0:00:10,10,,0,190
20150303-ccc_311_calgary_combined,2015/03/03,ccc_311_calgary_combined,2845,2751,0:00:25,25,,94,68775
20150303-ccc_help_script,2015/03/03,ccc_help_script,5,5,0:00:07,7,,0,35
20150303-ccc_priority_script,2015/03/03,ccc_priority_script,23,23,0:00:11,11,,0,253
20150303-ccc_tax_script,2015/03/03,ccc_tax_script,12,11,0:00:18,18,,1,198
20150304-ccc_311_calgary_combined,2015/03/04,ccc_311_calgary_combined,2872,2799,0:00:18,18,,73,50382
20150304-ccc_help_script,2015/03/04,ccc_help_script,5,5,0:00:10,10,,0,50
20150304-ccc_priority_script,2015/03/04,ccc_priority_script,21,20,0:00:09,9,,1,180
20150304-ccc_tax_script,2015/03/04,ccc_tax_script,8,8,0:00:13,13,,0,104
20150305-ccc_311_calgary_combined,2015/03/05,ccc_311_calgary_combined,2933,2699,0:01:09,69,,234,186231
20150305-ccc_help_script,2015/03/05,ccc_help_script,8,8,0:00:14,14,,0,112
20150305-ccc_priority_script,2015/03/05,ccc_priority_script,30,29,0:00:13,13,,1,377
20150305-ccc_tax_script,2015/03/05,ccc_tax_script,9,7,0:00:56,56,,2,392
20150306-ccc_311_calgary_combined,2015/03/06,ccc_311_calgary_combined,2834,2680,0:00:45,45,,154,120600
20150306-ccc_help_script,2015/03/06,ccc_help_script,2,2,0:00:12,12,,0,24
20150306-ccc_priority_script,2015/03/06,ccc_priority_script,26,25,0:00:11,11,,1,275
20150306-ccc_tax_script,2015/03/06,ccc_tax_script,14,11,0:00:38,38,,3,418
20150307-ccc_311_calgary_combined,2015/03/07,ccc_311_calgary_combined,1150,1126,0:00:17,17,,24,19142
20150307-ccc_help_script,2015/03/07,ccc_help_script,1,1,0:00:04,4,,0,4
20150307-ccc_priority_script,2015/03/07,ccc_priority_script,18,17,0:00:17,17,,1,289
20150308-ccc_311_calgary_combined,2015/03/08,ccc_311_calgary_combined,872,864,0:00:12,12,,8,10368
20150308-ccc_help_script,2015/03/08,ccc_help_script,1,1,0:02:18,138,,0,138
20150308-ccc_priority_script,2015/03/08,ccc_priority_script,19,17,0:00:07,7,,2,119
20150309-ccc_311_calgary_combined,2015/03/09,ccc_311_calgary_combined,3360,3257,0:00:22,22,,103,71654
20150309-ccc_help_script,2015/03/09,ccc_help_script,2,2,0:00:10,10,,0,20
20150309-ccc_priority_script,2015/03/09,ccc_priority_script,24,23,0:00:11,11,,1,253
20150309-ccc_tax_script,2015/03/09,ccc_tax_script,14,12,0:00:24,24,,2,288
20150310-ccc_311_calgary_combined,2015/03/10,ccc_311_calgary_combined,3008,2842,0:00:41,41,,166,116522
20150310-ccc_help_script,2015/03/10,ccc_help_script,9,8,0:00:15,15,,1,120
20150310-ccc_priority_script,2015/03/10,ccc_priority_script,24,23,0:00:13,13,,1,299
20150310-ccc_tax_script,2015/03/10,ccc_tax_script,12,12,0:00:34,34,,0,408
20150311-ccc_311_calgary_combined,2015/03/11,ccc_311_calgary_combined,3021,2884,0:00:31,31,,137,89404
20150311-ccc_help_script,2015/03/11,ccc_help_script,5,5,0:00:07,7,,0,35
20150311-ccc_priority_script,2015/03/11,ccc_priority_script,32,32,0:00:09,9,,0,288
20150311-ccc_tax_script,2015/03/11,ccc_tax_script,18,18,0:00:15,15,,0,270
20150312-ccc_311_calgary_combined,2015/03/12,ccc_311_calgary_combined,3015,2810,0:00:52,52,,205,146120
20150312-ccc_help_script,2015/03/12,ccc_help_script,3,3,0:00:44,44,,0,132
20150312-ccc_priority_script,2015/03/12,ccc_priority_script,38,37,0:00:14,14,,1,518
20150312-ccc_tax_script,2015/03/12,ccc_tax_script,11,11,0:01:12,72,,0,792
20150313-ccc_311_calgary_combined,2015/03/13,ccc_311_calgary_combined,3063,2885,0:00:38,38,,178,109630
20150313-ccc_help_script,2015/03/13,ccc_help_script,7,7,0:00:09,9,,0,63
20150313-ccc_priority_script,2015/03/13,ccc_priority_script,37,37,0:00:10,10,,0,370
20150313-ccc_tax_script,2015/03/13,ccc_tax_script,10,9,0:00:27,27,,1,243
20150314-ccc_311_calgary_combined,2015/03/14,ccc_311_calgary_combined,1367,1158,0:01:58,118,,209,136644
20150314-ccc_help_script,2015/03/14,ccc_help_script,6,5,0:00:22,22,,1,110
20150314-ccc_priority_script,2015/03/14,ccc_priority_script,21,19,0:00:30,30,,2,570
20150314-ccc_tax_script,2015/03/14,ccc_tax_script,2,1,0:06:37,397,,1,397
20150315-ccc_311_calgary_combined,2015/03/15,ccc_311_calgary_combined,961,912,0:00:29,29,,49,26448
20150315-ccc_help_script,2015/03/15,ccc_help_script,2,2,0:00:05,5,,0,10
20150315-ccc_priority_script,2015/03/15,ccc_priority_script,25,24,0:00:14,14,,1,336
20150315-ccc_tax_script,2015/03/15,ccc_tax_script,1,1,0:00:29,29,,0,29
20150316-ccc_311_calgary_combined,2015/03/16,ccc_311_calgary_combined,3193,3144,0:00:12,12,,49,37728
20150316-ccc_help_script,2015/03/16,ccc_help_script,1,1,0:00:03,3,,0,3
20150316-ccc_priority_script,2015/03/16,ccc_priority_script,43,43,0:00:06,6,,0,258
20150316-ccc_tax_script,2015/03/16,ccc_tax_script,17,16,0:00:11,11,,1,176
20150317-ccc_311_calgary_combined,2015/03/17,ccc_311_calgary_combined,2766,2707,0:00:16,16,,59,43312
20150317-ccc_help_script,2015/03/17,ccc_help_script,6,6,0:00:03,3,,0,18
20150317-ccc_priority_script,2015/03/17,ccc_priority_script,21,20,0:00:07,7,,1,140
20150317-ccc_tax_script,2015/03/17,ccc_tax_script,19,19,0:00:11,11,,0,209
20150318-ccc_311_calgary_combined,2015/03/18,ccc_311_calgary_combined,2882,2748,0:00:39,39,,134,107172
20150318-ccc_help_script,2015/03/18,ccc_help_script,8,7,0:00:09,9,,1,63
20150318-ccc_priority_script,2015/03/18,ccc_priority_script,43,42,0:00:11,11,,1,462
20150318-ccc_tax_script,2015/03/18,ccc_tax_script,19,17,0:00:55,55,,2,935
20150319-ccc_311_calgary_combined,2015/03/19,ccc_311_calgary_combined,2837,2680,0:00:52,52,,157,139360
20150319-ccc_help_script,2015/03/19,ccc_help_script,3,3,0:00:08,8,,0,24
20150319-ccc_priority_script,2015/03/19,ccc_priority_script,34,34,0:00:24,24,,0,816
20150319-ccc_tax_script,2015/03/19,ccc_tax_script,14,14,0:00:54,54,,0,756
20150320-ccc_311_calgary_combined,2015/03/20,ccc_311_calgary_combined,2781,2671,0:00:35,35,,110,93485
20150320-ccc_help_script,2015/03/20,ccc_help_script,2,2,0:00:27,27,,0,54
20150320-ccc_priority_script,2015/03/20,ccc_priority_script,22,21,0:00:07,7,,1,147
20150320-ccc_tax_script,2015/03/20,ccc_tax_script,10,9,0:01:12,72,,1,648
20150321-ccc_311_calgary_combined,2015/03/21,ccc_311_calgary_combined,1177,1165,0:00:07,7,,12,8155
20150321-ccc_priority_script,2015/03/21,ccc_priority_script,18,16,0:00:08,8,,2,128
20150321-ccc_tax_script,2015/03/21,ccc_tax_script,2,2,0:00:10,10,,0,20
20150322-ccc_311_calgary_combined,2015/03/22,ccc_311_calgary_combined,850,838,0:00:06,6,,12,5028
20150322-ccc_priority_script,2015/03/22,ccc_priority_script,20,20,0:00:10,10,,0,200
20150323-ccc_311_calgary_combined,2015/03/23,ccc_311_calgary_combined,3120,3096,0:00:07,7,,24,21672
20150323-ccc_help_script,2015/03/23,ccc_help_script,5,5,0:00:04,4,,0,20
20150323-ccc_priority_script,2015/03/23,ccc_priority_script,24,24,0:00:04,4,,0,96
20150323-ccc_tax_script,2015/03/23,ccc_tax_script,16,15,0:00:09,9,,1,135
20150324-ccc_311_calgary_combined,2015/03/24,ccc_311_calgary_combined,2926,2902,0:00:07,7,,24,20314
20150324-ccc_help_script,2015/03/24,ccc_help_script,42,31,0:00:08,8,,11,248
20150324-ccc_priority_script,2015/03/24,ccc_priority_script,26,25,0:00:08,8,,1,200
20150324-ccc_tax_script,2015/03/24,ccc_tax_script,18,18,0:00:05,5,,0,90
20150325-ccc_311_calgary_combined,2015/03/25,ccc_311_calgary_combined,2974,2926,0:00:12,12,,48,35112
20150325-ccc_help_script,2015/03/25,ccc_help_script,1,1,0:00:07,7,,0,7
20150325-ccc_priority_script,2015/03/25,ccc_priority_script,26,26,0:00:05,5,,0,130
20150325-ccc_tax_script,2015/03/25,ccc_tax_script,24,24,0:00:11,11,,0,264
20150326-ccc_311_calgary_combined,2015/03/26,ccc_311_calgary_combined,3090,2938,0:00:39,39,,152,114582
20150326-ccc_help_script,2015/03/26,ccc_help_script,11,11,0:00:08,8,,0,88
20150326-ccc_priority_script,2015/03/26,ccc_priority_script,34,34,0:00:08,8,,0,272
20150326-ccc_tax_script,2015/03/26,ccc_tax_script,16,16,0:00:11,11,,0,176
20150327-ccc_311_calgary_combined,2015/03/27,ccc_311_calgary_combined,3038,2792,0:01:01,61,,246,170312
20150327-ccc_help_script,2015/03/27,ccc_help_script,14,14,0:00:05,5,,0,70
20150327-ccc_priority_script,2015/03/27,ccc_priority_script,31,30,0:00:19,19,,1,570
20150327-ccc_tax_script,2015/03/27,ccc_tax_script,12,11,0:01:10,70,,1,770
20150328-ccc_311_calgary_combined,2015/03/28,ccc_311_calgary_combined,1057,1025,0:00:17,17,,32,17425
20150328-ccc_help_script,2015/03/28,ccc_help_script,1,1,0:00:02,2,,0,2
20150328-ccc_priority_script,2015/03/28,ccc_priority_script,34,32,0:00:13,13,,2,416
20150329-ccc_311_calgary_combined,2015/03/29,ccc_311_calgary_combined,1169,1145,0:00:18,18,,24,20610
20150329-ccc_help_script,2015/03/29,ccc_help_script,1,1,0:00:08,8,,0,8
20150329-ccc_priority_script,2015/03/29,ccc_priority_script,13,13,0:00:10,10,,0,130
20150329-ccc_tax_script,2015/03/29,ccc_tax_script,1,1,0:00:03,3,,0,3
20150330-ccc_311_calgary_combined,2015/03/30,ccc_311_calgary_combined,3623,3561,0:00:16,16,,62,56976
20150330-ccc_help_script,2015/03/30,ccc_help_script,7,7,0:00:05,5,,0,35
20150330-ccc_priority_script,2015/03/30,ccc_priority_script,33,28,0:00:06,6,,5,168
20150330-ccc_tax_script,2015/03/30,ccc_tax_script,26,25,0:00:13,13,,1,325
20150331-ccc_311_calgary_combined,2015/03/31,ccc_311_calgary_combined,3558,3400,0:00:35,35,,158,119000
20150331-ccc_help_script,2015/03/31,ccc_help_script,8,8,0:00:09,9,,0,72
20150331-ccc_priority_script,2015/03/31,ccc_priority_script,28,28,0:00:13,13,,0,364
20150331-ccc_tax_script,2015/03/31,ccc_tax_script,21,21,0:00:06,6,,0,126
20150401-ccc_311_calgary_combined,2015/04/01,ccc_311_calgary_combined,3328,3236,0:00:19,19,,92,61484
20150401-ccc_help_script,2015/04/01,ccc_help_script,3,3,0:00:03,3,,0,9
20150401-ccc_priority_script,2015/04/01,ccc_priority_script,32,31,0:00:12,12,,1,372
20150401-ccc_tax_script,2015/04/01,ccc_tax_script,17,17,0:00:07,7,,0,119
20150402-ccc_311_calgary_combined,2015/04/02,ccc_311_calgary_combined,3441,3338,0:00:24,24,,103,80112
20150402-ccc_help_script,2015/04/02,ccc_help_script,13,12,0:00:08,8,,1,96
20150402-ccc_priority_script,2015/04/02,ccc_priority_script,33,32,0:00:13,13,,1,416
20150402-ccc_tax_script,2015/04/02,ccc_tax_script,9,9,0:00:10,10,,0,90
20150403-ccc_311_calgary_combined,2015/04/03,ccc_311_calgary_combined,1399,1367,0:00:12,12,,32,16404
20150403-ccc_help_script,2015/04/03,ccc_help_script,2,2,0:00:03,3,,0,6
20150403-ccc_priority_script,2015/04/03,ccc_priority_script,17,15,0:00:05,5,,2,75
20150404-ccc_311_calgary_combined,2015/04/04,ccc_311_calgary_combined,1068,1043,0:00:13,13,,25,13559
20150404-ccc_help_script,2015/04/04,ccc_help_script,1,1,0:00:04,4,,0,4
20150404-ccc_priority_script,2015/04/04,ccc_priority_script,13,12,0:00:06,6,,1,72
20150405-ccc_311_calgary_combined,2015/04/05,ccc_311_calgary_combined,741,732,0:00:08,8,,9,5856
20150405-ccc_priority_script,2015/04/05,ccc_priority_script,17,17,0:00:07,7,,0,119
20150405-ccc_tax_script,2015/04/05,ccc_tax_script,2,2,0:00:05,5,,0,10
20150406-ccc_311_calgary_combined,2015/04/06,ccc_311_calgary_combined,2999,2978,0:00:07,7,,21,20846
20150406-ccc_help_script,2015/04/06,ccc_help_script,4,4,0:00:06,6,,0,24
20150406-ccc_priority_script,2015/04/06,ccc_priority_script,36,36,0:00:07,7,,0,252
20150406-ccc_tax_script,2015/04/06,ccc_tax_script,2,2,0:00:03,3,,0,6
20150407-ccc_311_calgary_combined,2015/04/07,ccc_311_calgary_combined,3298,3114,0:00:43,43,,184,133902
20150407-ccc_help_script,2015/04/07,ccc_help_script,9,9,0:00:05,5,,0,45
20150407-ccc_priority_script,2015/04/07,ccc_priority_script,14,14,0:00:10,10,,0,140
20150407-ccc_tax_script,2015/04/07,ccc_tax_script,12,12,0:00:56,56,,0,672
20150408-ccc_311_calgary_combined,2015/04/08,ccc_311_calgary_combined,3380,3257,0:00:20,20,,123,65140
20150408-ccc_help_script,2015/04/08,ccc_help_script,4,4,0:00:08,8,,0,32
20150408-ccc_priority_script,2015/04/08,ccc_priority_script,36,36,0:00:07,7,,0,252
20150408-ccc_tax_script,2015/04/08,ccc_tax_script,20,20,0:00:08,8,,0,160
20150409-ccc_311_calgary_combined,2015/04/09,ccc_311_calgary_combined,3420,3101,0:01:14,74,,319,229474
20150409-ccc_help_script,2015/04/09,ccc_help_script,10,8,0:00:10,10,,2,80
20150409-ccc_priority_script,2015/04/09,ccc_priority_script,27,25,0:00:08,8,,2,200
20150409-ccc_tax_script,2015/04/09,ccc_tax_script,20,19,0:01:05,65,,1,1235
20150410-ccc_311_calgary_combined,2015/04/10,ccc_311_calgary_combined,3175,2928,0:01:00,60,,247,175680
20150410-ccc_help_script,2015/04/10,ccc_help_script,12,11,0:00:11,11,,1,121
20150410-ccc_priority_script,2015/04/10,ccc_priority_script,25,24,0:00:12,12,,1,288
20150410-ccc_tax_script,2015/04/10,ccc_tax_script,16,15,0:01:35,95,,1,1425
20150411-ccc_311_calgary_combined,2015/04/11,ccc_311_calgary_combined,1398,1346,0:00:21,21,,52,28266
20150411-ccc_help_script,2015/04/11,ccc_help_script,2,2,0:00:06,6,,0,12
20150411-ccc_priority_script,2015/04/11,ccc_priority_script,31,31,0:00:10,10,,0,310
20150411-ccc_tax_script,2015/04/11,ccc_tax_script,1,1,0:00:03,3,,0,3
20150412-ccc_311_calgary_combined,2015/04/12,ccc_311_calgary_combined,983,951,0:00:10,10,,32,9510
20150412-ccc_priority_script,2015/04/12,ccc_priority_script,22,19,0:00:06,6,,3,114
20150413-ccc_311_calgary_combined,2015/04/13,ccc_311_calgary_combined,4010,3889,0:00:18,18,,121,70002
20150413-ccc_help_script,2015/04/13,ccc_help_script,9,9,0:00:06,6,,0,54
20150413-ccc_priority_script,2015/04/13,ccc_priority_script,17,17,0:00:08,8,,0,136
20150413-ccc_tax_script,2015/04/13,ccc_tax_script,22,21,0:00:18,18,,1,378
20150414-ccc_311_calgary_combined,2015/04/14,ccc_311_calgary_combined,3652,3524,0:00:20,20,,128,70480
20150414-ccc_help_script,2015/04/14,ccc_help_script,7,7,0:00:08,8,,0,56
20150414-ccc_priority_script,2015/04/14,ccc_priority_script,31,30,0:00:08,8,,1,240
20150414-ccc_tax_script,2015/04/14,ccc_tax_script,22,22,0:00:17,17,,0,374
20150415-ccc_311_calgary_combined,2015/04/15,ccc_311_calgary_combined,3497,3332,0:00:33,33,,165,109956
20150415-ccc_help_script,2015/04/15,ccc_help_script,6,6,0:00:10,10,,0,60
20150415-ccc_priority_script,2015/04/15,ccc_priority_script,20,20,0:00:07,7,,0,140
20150415-ccc_tax_script,2015/04/15,ccc_tax_script,13,12,0:00:39,39,,1,468
20150416-ccc_311_calgary_combined,2015/04/16,ccc_311_calgary_combined,3283,3072,0:00:39,39,,211,119808
20150416-ccc_help_script,2015/04/16,ccc_help_script,7,7,0:00:04,4,,0,28
20150416-ccc_priority_script,2015/04/16,ccc_priority_script,24,24,0:00:24,24,,0,576
20150416-ccc_tax_script,2015/04/16,ccc_tax_script,18,16,0:00:07,7,,2,112
20150417-ccc_311_calgary_combined,2015/04/17,ccc_311_calgary_combined,3244,3102,0:00:33,33,,142,102366
20150417-ccc_help_script,2015/04/17,ccc_help_script,12,10,0:00:10,10,,2,100
20150417-ccc_priority_script,2015/04/17,ccc_priority_script,27,27,0:00:10,10,,0,270
20150417-ccc_tax_script,2015/04/17,ccc_tax_script,18,16,0:00:15,15,,2,240
20150418-ccc_311_calgary_combined,2015/04/18,ccc_311_calgary_combined,1276,1186,0:00:46,46,,90,54556
20150418-ccc_priority_script,2015/04/18,ccc_priority_script,25,25,0:00:21,21,,0,525
20150418-ccc_tax_script,2015/04/18,ccc_tax_script,2,2,0:01:25,85,,0,170
20150419-ccc_311_calgary_combined,2015/04/19,ccc_311_calgary_combined,1068,1000,0:00:31,31,,68,31000
20150419-ccc_priority_script,2015/04/19,ccc_priority_script,18,18,0:00:09,9,,0,162
20150419-ccc_tax_script,2015/04/19,ccc_tax_script,4,3,0:01:22,82,,1,246
20150420-ccc_311_calgary_combined,2015/04/20,ccc_311_calgary_combined,4121,3844,0:00:52,52,,277,199888
20150420-ccc_help_script,2015/04/20,ccc_help_script,3,3,0:00:04,4,,0,12
20150420-ccc_priority_script,2015/04/20,ccc_priority_script,25,23,0:00:07,7,,2,161
20150420-ccc_tax_script,2015/04/20,ccc_tax_script,8,8,0:00:09,9,,0,72
20150421-ccc_311_calgary_combined,2015/04/21,ccc_311_calgary_combined,3711,3584,0:00:27,27,,127,96768
20150421-ccc_help_script,2015/04/21,ccc_help_script,7,6,0:00:05,5,,1,30
20150421-ccc_priority_script,2015/04/21,ccc_priority_script,11,10,0:00:12,12,,1,120
20150421-ccc_tax_script,2015/04/21,ccc_tax_script,19,18,0:00:14,14,,1,252
20150422-ccc_311_calgary_combined,2015/04/22,ccc_311_calgary_combined,3770,3539,0:00:41,41,,231,145099
20150422-ccc_help_script,2015/04/22,ccc_help_script,9,7,0:00:08,8,,2,56
20150422-ccc_priority_script,2015/04/22,ccc_priority_script,24,23,0:00:16,16,,1,368
20150422-ccc_tax_script,2015/04/22,ccc_tax_script,23,22,0:00:52,52,,1,1144
20150423-ccc_311_calgary_combined,2015/04/23,ccc_311_calgary_combined,3649,3516,0:00:25,25,,133,87900
20150423-ccc_help_script,2015/04/23,ccc_help_script,11,11,0:00:08,8,,0,88
20150423-ccc_priority_script,2015/04/23,ccc_priority_script,20,19,0:00:09,9,,1,171
20150423-ccc_tax_script,2015/04/23,ccc_tax_script,20,19,0:00:13,13,,1,247
20150424-ccc_311_calgary_combined,2015/04/24,ccc_311_calgary_combined,3221,3033,0:00:45,45,,188,136485
20150424-ccc_help_script,2015/04/24,ccc_help_script,10,10,0:00:07,7,,0,70
20150424-ccc_priority_script,2015/04/24,ccc_priority_script,30,29,0:00:10,10,,1,290
20150424-ccc_tax_script,2015/04/24,ccc_tax_script,14,14,0:01:38,98,,0,1372
20150425-ccc_311_calgary_combined,2015/04/25,ccc_311_calgary_combined,1245,1214,0:00:11,11,,31,13354
20150425-ccc_help_script,2015/04/25,ccc_help_script,3,2,0:00:06,6,,1,12
20150425-ccc_priority_script,2015/04/25,ccc_priority_script,13,12,0:00:06,6,,1,72
20150425-ccc_tax_script,2015/04/25,ccc_tax_script,2,2,0:02:07,127,,0,254
20150426-ccc_311_calgary_combined,2015/04/26,ccc_311_calgary_combined,1102,1061,0:00:17,17,,41,18037
20150426-ccc_priority_script,2015/04/26,ccc_priority_script,11,11,0:00:08,8,,0,88
20150426-ccc_tax_script,2015/04/26,ccc_tax_script,1,1,0:00:04,4,,0,4
20150427-ccc_311_calgary_combined,2015/04/27,ccc_311_calgary_combined,4119,3995,0:00:20,20,,124,79900
20150427-ccc_help_script,2015/04/27,ccc_help_script,6,6,0:00:07,7,,0,42
20150427-ccc_priority_script,2015/04/27,ccc_priority_script,27,26,0:00:07,7,,1,182
20150427-ccc_tax_script,2015/04/27,ccc_tax_script,10,10,0:00:07,7,,0,70
20150428-ccc_311_calgary_combined,2015/04/28,ccc_311_calgary_combined,4020,3617,0:01:12,72,,403,260424
20150428-ccc_help_script,2015/04/28,ccc_help_script,8,7,0:00:11,11,,1,77
20150428-ccc_priority_script,2015/04/28,ccc_priority_script,31,30,0:00:13,13,,1,390
20150428-ccc_tax_script,2015/04/28,ccc_tax_script,12,11,0:00:56,56,,1,616
20150429-ccc_311_calgary_combined,2015/04/29,ccc_311_calgary_combined,3597,3283,0:01:06,66,,314,216678
20150429-ccc_help_script,2015/04/29,ccc_help_script,8,8,0:00:09,9,,0,72
20150429-ccc_priority_script,2015/04/29,ccc_priority_script,19,19,0:00:10,10,,0,190
20150429-ccc_tax_script,2015/04/29,ccc_tax_script,26,21,0:01:29,89,,5,1869
20150430-ccc_311_calgary_combined,2015/04/30,ccc_311_calgary_combined,3700,3376,0:01:10,70,,324,236320
20150430-ccc_help_script,2015/04/30,ccc_help_script,17,15,0:00:17,17,,2,255
20150430-ccc_priority_script,2015/04/30,ccc_priority_script,26,25,0:00:13,13,,1,325
20150430-ccc_tax_script,2015/04/30,ccc_tax_script,23,21,0:01:11,71,,2,1491
20150501-ccc_311_calgary_combined,2015/05/01,ccc_311_calgary_combined,3647,3173,0:01:40,100,,474,317300
20150501-ccc_help_script,2015/05/01,ccc_help_script,4,4,0:00:26,26,,0,104
20150501-ccc_priority_script,2015/05/01,ccc_priority_script,35,33,0:00:19,19,,2,627
20150501-ccc_tax_script,2015/05/01,ccc_tax_script,12,12,0:01:57,117,,0,1404
20150502-ccc_311_calgary_combined,2015/05/02,ccc_311_calgary_combined,1442,1398,0:00:14,14,,44,19572
20150502-ccc_help_script,2015/05/02,ccc_help_script,2,2,0:00:03,3,,0,6
20150502-ccc_priority_script,2015/05/02,ccc_priority_script,37,35,0:00:17,17,,2,595
20150502-ccc_tax_script,2015/05/02,ccc_tax_script,1,1,0:05:58,358,,0,358
20150503-ccc_311_calgary_combined,2015/05/03,ccc_311_calgary_combined,1168,1127,0:00:28,28,,41,31556
20150503-ccc_priority_script,2015/05/03,ccc_priority_script,26,24,0:00:22,22,,2,528
20150503-ccc_tax_script,2015/05/03,ccc_tax_script,4,1,0:00:04,4,,3,4
20150504-ccc_311_calgary_combined,2015/05/04,ccc_311_calgary_combined,4510,3935,0:01:39,99,,575,389565
20150504-ccc_help_script,2015/05/04,ccc_help_script,22,20,0:00:07,7,,2,140
20150504-ccc_priority_script,2015/05/04,ccc_priority_script,34,32,0:00:13,13,,2,416
20150504-ccc_tax_script,2015/05/04,ccc_tax_script,25,20,0:01:34,94,,5,1880
20150505-ccc_311_calgary_combined,2015/05/05,ccc_311_calgary_combined,4294,3691,0:01:50,110,,603,406010
20150505-ccc_help_script,2015/05/05,ccc_help_script,6,6,0:00:10,10,,0,60
20150505-ccc_priority_script,2015/05/05,ccc_priority_script,37,35,0:00:11,11,,2,385
20150505-ccc_tax_script,2015/05/05,ccc_tax_script,17,15,0:02:40,160,,2,2400
20150506-ccc_311_calgary_combined,2015/05/06,ccc_311_calgary_combined,3586,3438,0:00:25,25,,148,85950
20150506-ccc_help_script,2015/05/06,ccc_help_script,10,8,0:00:08,8,,2,64
20150506-ccc_priority_script,2015/05/06,ccc_priority_script,34,34,0:00:11,11,,0,374
20150506-ccc_tax_script,2015/05/06,ccc_tax_script,14,14,0:00:17,17,,0,238
20150507-ccc_311_calgary_combined,2015/05/07,ccc_311_calgary_combined,3643,3265,0:01:12,72,,378,235080
20150507-ccc_help_script,2015/05/07,ccc_help_script,9,8,0:00:15,15,,1,120
20150507-ccc_priority_script,2015/05/07,ccc_priority_script,43,42,0:00:16,16,,1,672
20150507-ccc_tax_script,2015/05/07,ccc_tax_script,22,21,0:00:51,51,,1,1071
20150508-ccc_311_calgary_combined,2015/05/08,ccc_311_calgary_combined,3416,3069,0:01:22,82,,347,251658
20150508-ccc_help_script,2015/05/08,ccc_help_script,12,11,0:00:07,7,,1,77
20150508-ccc_priority_script,2015/05/08,ccc_priority_script,17,17,0:00:08,8,,0,136
20150508-ccc_tax_script,2015/05/08,ccc_tax_script,14,13,0:01:59,119,,1,1547
20150509-ccc_311_calgary_combined,2015/05/09,ccc_311_calgary_combined,1359,1327,0:00:15,15,,32,19905
20150509-ccc_priority_script,2015/05/09,ccc_priority_script,18,16,0:00:10,10,,2,160
20150510-ccc_311_calgary_combined,2015/05/10,ccc_311_calgary_combined,1040,1010,0:00:22,22,,30,22220
20150510-ccc_priority_script,2015/05/10,ccc_priority_script,13,13,0:00:37,37,,0,481
20150511-ccc_311_calgary_combined,2015/05/11,ccc_311_calgary_combined,4379,4084,0:00:36,36,,295,147024
20150511-ccc_help_script,2015/05/11,ccc_help_script,11,11,0:00:06,6,,0,66
20150511-ccc_priority_script,2015/05/11,ccc_priority_script,21,20,0:00:12,12,,1,240
20150511-ccc_tax_script,2015/05/11,ccc_tax_script,27,26,0:00:25,25,,1,650
20150512-ccc_311_calgary_combined,2015/05/12,ccc_311_calgary_combined,3794,3541,0:00:53,53,,253,187673
20150512-ccc_help_script,2015/05/12,ccc_help_script,7,7,0:00:14,14,,0,98
20150512-ccc_priority_script,2015/05/12,ccc_priority_script,28,26,0:00:14,14,,2,364
20150512-ccc_tax_script,2015/05/12,ccc_tax_script,20,18,0:00:48,48,,2,864
20150513-ccc_311_calgary_combined,2015/05/13,ccc_311_calgary_combined,3746,3433,0:01:21,81,,313,278073
20150513-ccc_help_script,2015/05/13,ccc_help_script,9,9,0:00:07,7,,0,63
20150513-ccc_priority_script,2015/05/13,ccc_priority_script,30,27,0:00:10,10,,3,270
20150513-ccc_tax_script,2015/05/13,ccc_tax_script,24,24,0:01:20,80,,0,1920
20150514-ccc_311_calgary_combined,2015/05/14,ccc_311_calgary_combined,3467,3101,0:01:14,74,,366,229474
20150514-ccc_help_script,2015/05/14,ccc_help_script,24,19,0:00:07,7,,5,133
20150514-ccc_priority_script,2015/05/14,ccc_priority_script,34,29,0:00:20,20,,5,580
20150514-ccc_tax_script,2015/05/14,ccc_tax_script,22,20,0:01:14,74,,2,1480
20150515-ccc_311_calgary_combined,2015/05/15,ccc_311_calgary_combined,3123,3047,0:00:20,20,,76,60940
20150515-ccc_help_script,2015/05/15,ccc_help_script,4,4,0:00:03,3,,0,12
20150515-ccc_priority_script,2015/05/15,ccc_priority_script,21,20,0:00:14,14,,1,280
20150515-ccc_tax_script,2015/05/15,ccc_tax_script,18,18,0:00:09,9,,0,162
20150516-ccc_311_calgary_combined,2015/05/16,ccc_311_calgary_combined,1153,1132,0:00:09,9,,21,10188
20150516-ccc_help_script,2015/05/16,ccc_help_script,1,1,0:00:02,2,,0,2
20150516-ccc_priority_script,2015/05/16,ccc_priority_script,24,24,0:00:26,26,,0,624
20150517-ccc_311_calgary_combined,2015/05/17,ccc_311_calgary_combined,1086,1072,0:00:09,9,,14,9648
20150517-ccc_priority_script,2015/05/17,ccc_priority_script,20,18,0:00:07,7,,2,126
20150518-ccc_311_calgary_combined,2015/05/18,ccc_311_calgary_combined,1265,1257,0:00:08,8,,8,10056
20150518-ccc_priority_script,2015/05/18,ccc_priority_script,11,11,0:00:06,6,,0,66
20150518-ccc_tax_script,2015/05/18,ccc_tax_script,1,1,0:00:06,6,,0,6
20150519-ccc_311_calgary_combined,2015/05/19,ccc_311_calgary_combined,4534,4163,0:01:10,70,,371,291410
20150519-ccc_help_script,2015/05/19,ccc_help_script,7,6,0:00:08,8,,1,48
20150519-ccc_priority_script,2015/05/19,ccc_priority_script,36,34,0:00:08,8,,2,272
20150519-ccc_tax_script,2015/05/19,ccc_tax_script,21,21,0:00:56,56,,0,1176
20150520-ccc_311_calgary_combined,2015/05/20,ccc_311_calgary_combined,4593,3207,0:05:39,339,,1386,1087173
20150520-ccc_help_script,2015/05/20,ccc_help_script,7,6,0:00:04,4,,1,24
20150520-ccc_priority_script,2015/05/20,ccc_priority_script,44,42,0:00:22,22,,2,924
20150520-ccc_tax_script,2015/05/20,ccc_tax_script,22,12,0:07:47,467,,10,5604
20150521-ccc_311_calgary_combined,2015/05/21,ccc_311_calgary_combined,4522,3128,0:05:33,333,,1394,1041624
20150521-ccc_help_script,2015/05/21,ccc_help_script,9,8,0:00:31,31,,1,248
20150521-ccc_priority_script,2015/05/21,ccc_priority_script,23,23,0:00:14,14,,0,322
20150521-ccc_tax_script,2015/05/21,ccc_tax_script,32,25,0:04:22,262,,7,6550
20150522-ccc_311_calgary_combined,2015/05/22,ccc_311_calgary_combined,4605,3178,0:05:27,327,,1427,1039206
20150522-ccc_help_script,2015/05/22,ccc_help_script,16,14,0:00:12,12,,2,168
20150522-ccc_priority_script,2015/05/22,ccc_priority_script,18,18,0:00:21,21,,0,378
20150522-ccc_tax_script,2015/05/22,ccc_tax_script,11,9,0:05:51,351,,2,3159
20150523-ccc_311_calgary_combined,2015/05/23,ccc_311_calgary_combined,1762,1627,0:00:49,49,,135,79723
20150523-ccc_priority_script,2015/05/23,ccc_priority_script,31,31,0:00:11,11,,0,341
20150523-ccc_tax_script,2015/05/23,ccc_tax_script,1,1,0:06:20,380,,0,380
20150524-ccc_311_calgary_combined,2015/05/24,ccc_311_calgary_combined,1378,1264,0:01:01,61,,114,77104
20150524-ccc_help_script,2015/05/24,ccc_help_script,2,2,0:00:11,11,,0,22
20150524-ccc_priority_script,2015/05/24,ccc_priority_script,25,23,0:00:26,26,,2,598
20150524-ccc_tax_script,2015/05/24,ccc_tax_script,1,1,0:00:35,35,,0,35
20150525-ccc_311_calgary_combined,2015/05/25,ccc_311_calgary_combined,5021,3700,0:05:25,325,,1321,1202500
20150525-ccc_help_script,2015/05/25,ccc_help_script,11,7,0:00:15,15,,4,105
20150525-ccc_priority_script,2015/05/25,ccc_priority_script,35,34,0:00:20,20,,1,680
20150525-ccc_tax_script,2015/05/25,ccc_tax_script,29,29,0:06:07,367,,0,10643
20150526-ccc_311_calgary_combined,2015/05/26,ccc_311_calgary_combined,4346,3347,0:03:59,239,,999,799933
20150526-ccc_help_script,2015/05/26,ccc_help_script,22,17,0:00:13,13,,5,221
20150526-ccc_priority_script,2015/05/26,ccc_priority_script,42,37,0:00:17,17,,5,629
20150526-ccc_tax_script,2015/05/26,ccc_tax_script,24,21,0:05:10,310,,3,6510
20150527-ccc_311_calgary_combined,2015/05/27,ccc_311_calgary_combined,4737,2888,0:07:40,460,,1848,1328480
20150527-ccc_help_script,2015/05/27,ccc_help_script,9,6,0:00:10,10,,3,60
20150527-ccc_priority_script,2015/05/27,ccc_priority_script,29,29,0:00:17,17,,0,493
20150527-ccc_tax_script,2015/05/27,ccc_tax_script,21,14,0:07:11,431,,7,6034
20150528-ccc_311_calgary_combined,2015/05/28,ccc_311_calgary_combined,5202,2931,0:08:31,511,,2271,1497741
20150528-ccc_help_script,2015/05/28,ccc_help_script,14,10,0:00:12,12,,4,120
20150528-ccc_priority_script,2015/05/28,ccc_priority_script,25,25,0:00:13,13,,0,325
20150528-ccc_tax_script,2015/05/28,ccc_tax_script,24,16,0:07:12,432,,8,6912
20150529-ccc_311_calgary_combined,2015/05/29,ccc_311_calgary_combined,5540,3514,0:07:43,463,,2026,1626982
20150529-ccc_help_script,2015/05/29,ccc_help_script,6,6,0:00:14,14,,0,84
20150529-ccc_priority_script,2015/05/29,ccc_priority_script,23,22,0:00:14,14,,1,308
20150529-ccc_tax_script,2015/05/29,ccc_tax_script,17,12,0:09:21,561,,5,6732
20150530-ccc_311_calgary_combined,2015/05/30,ccc_311_calgary_combined,1862,1787,0:00:24,24,,75,42888
20150530-ccc_help_script,2015/05/30,ccc_help_script,2,2,0:00:10,10,,0,20
20150530-ccc_priority_script,2015/05/30,ccc_priority_script,18,17,0:00:12,12,,1,204
20150531-ccc_311_calgary_combined,2015/05/31,ccc_311_calgary_combined,1532,1436,0:00:43,43,,96,61748
20150531-ccc_help_script,2015/05/31,ccc_help_script,3,3,0:00:04,4,,0,12
20150531-ccc_priority_script,2015/05/31,ccc_priority_script,23,20,0:00:15,15,,3,300
20150601-ccc_311_calgary_combined,2015/06/01,ccc_311_calgary_combined,6235,3974,0:07:01,421,,2261,1673054
20150601-ccc_help_script,2015/06/01,ccc_help_script,5,4,0:00:03,3,,1,12
20150601-ccc_priority_script,2015/06/01,ccc_priority_script,28,28,0:00:35,35,,0,980
20150601-ccc_tax_script,2015/06/01,ccc_tax_script,18,11,0:11:14,674,,7,7414
20150602-ccc_311_calgary_combined,2015/06/02,ccc_311_calgary_combined,5686,3342,0:08:35,515,,2344,1721130
20150602-ccc_help_script,2015/06/02,ccc_help_script,25,21,0:00:20,20,,4,420
20150602-ccc_priority_script,2015/06/02,ccc_priority_script,43,41,0:00:19,19,,2,779
20150602-ccc_tax_script,2015/06/02,ccc_tax_script,16,7,0:09:40,580,,9,4060
20150603-ccc_311_calgary_combined,2015/06/03,ccc_311_calgary_combined,5226,3269,0:07:54,474,,1957,1549506
20150603-ccc_help_script,2015/06/03,ccc_help_script,7,5,0:00:28,28,,2,140
20150603-ccc_priority_script,2015/06/03,ccc_priority_script,36,35,0:00:19,19,,1,665
20150603-ccc_tax_script,2015/06/03,ccc_tax_script,19,12,0:08:28,508,,7,6096
20150604-ccc_311_calgary_combined,2015/06/04,ccc_311_calgary_combined,5267,3397,0:07:08,428,,1870,1453916
20150604-ccc_help_script,2015/06/04,ccc_help_script,14,13,0:00:13,13,,1,169
20150604-ccc_priority_script,2015/06/04,ccc_priority_script,29,27,0:00:28,28,,2,756
20150604-ccc_tax_script,2015/06/04,ccc_tax_script,24,17,0:08:27,507,,7,8619
20150605-ccc_311_calgary_combined,2015/06/05,ccc_311_calgary_combined,4848,3505,0:05:27,327,,1343,1146135
20150605-ccc_help_script,2015/06/05,ccc_help_script,6,5,0:00:11,11,,1,55
20150605-ccc_priority_script,2015/06/05,ccc_priority_script,29,28,0:00:21,21,,1,588
20150605-ccc_tax_script,2015/06/05,ccc_tax_script,31,16,0:06:53,413,,15,6608
20150606-ccc_311_calgary_combined,2015/06/06,ccc_311_calgary_combined,1799,1608,0:01:17,77,,191,123816
20150606-ccc_help_script,2015/06/06,ccc_help_script,1,1,0:00:21,21,,0,21
20150606-ccc_priority_script,2015/06/06,ccc_priority_script,34,33,0:00:19,19,,1,627
20150607-ccc_311_calgary_combined,2015/06/07,ccc_311_calgary_combined,1696,1486,0:01:26,86,,210,127796
20150607-ccc_help_script,2015/06/07,ccc_help_script,3,3,0:00:23,23,,0,69
20150607-ccc_priority_script,2015/06/07,ccc_priority_script,32,28,0:00:13,13,,4,364
20150608-ccc_311_calgary_combined,2015/06/08,ccc_311_calgary_combined,6036,3822,0:07:24,444,,2214,1696968
20150608-ccc_help_script,2015/06/08,ccc_help_script,16,14,0:00:20,20,,2,280
20150608-ccc_priority_script,2015/06/08,ccc_priority_script,48,45,0:00:20,20,,3,900
20150608-ccc_tax_script,2015/06/08,ccc_tax_script,25,14,0:08:26,506,,11,7084
20150609-ccc_311_calgary_combined,2015/06/09,ccc_311_calgary_combined,5516,3473,0:07:28,448,,2043,1555904
20150609-ccc_help_script,2015/06/09,ccc_help_script,12,12,0:00:10,10,,0,120
20150609-ccc_priority_script,2015/06/09,ccc_priority_script,37,35,0:00:24,24,,2,840
20150609-ccc_tax_script,2015/06/09,ccc_tax_script,27,13,0:07:47,467,,14,6071
20150610-ccc_311_calgary_combined,2015/06/10,ccc_311_calgary_combined,5063,3525,0:06:17,377,,1538,1328925
20150610-ccc_help_script,2015/06/10,ccc_help_script,13,12,0:00:13,13,,1,156
20150610-ccc_priority_script,2015/06/10,ccc_priority_script,31,28,0:00:17,17,,3,476
20150610-ccc_tax_script,2015/06/10,ccc_tax_script,17,11,0:08:41,521,,6,5731
20150611-ccc_311_calgary_combined,2015/06/11,ccc_311_calgary_combined,5165,3090,0:08:12,492,,2075,1520280
20150611-ccc_help_script,2015/06/11,ccc_help_script,15,14,0:00:22,22,,1,308
20150611-ccc_priority_script,2015/06/11,ccc_priority_script,35,34,0:00:24,24,,1,816
20150611-ccc_tax_script,2015/06/11,ccc_tax_script,32,20,0:09:56,596,,12,11920
20150612-ccc_311_calgary_combined,2015/06/12,ccc_311_calgary_combined,4205,3120,0:05:40,340,,1085,1060800
20150612-ccc_help_script,2015/06/12,ccc_help_script,4,3,0:00:06,6,,1,18
20150612-ccc_priority_script,2015/06/12,ccc_priority_script,32,31,0:00:29,29,,1,899
20150612-ccc_tax_script,2015/06/12,ccc_tax_script,21,14,0:06:47,407,,7,5698
20150613-ccc_311_calgary_combined,2015/06/13,ccc_311_calgary_combined,1444,1366,0:00:38,38,,78,51908
20150613-ccc_priority_script,2015/06/13,ccc_priority_script,27,27,0:00:10,10,,0,270
20150614-ccc_311_calgary_combined,2015/06/14,ccc_311_calgary_combined,1155,1112,0:00:26,26,,43,28912
20150614-ccc_priority_script,2015/06/14,ccc_priority_script,33,32,0:00:12,12,,1,384
20150614-ccc_tax_script,2015/06/14,ccc_tax_script,1,1,0:00:04,4,,0,4
20150615-ccc_311_calgary_combined,2015/06/15,ccc_311_calgary_combined,5280,3644,0:06:25,385,,1636,1402940
20150615-ccc_help_script,2015/06/15,ccc_help_script,6,6,0:00:13,13,,0,78
20150615-ccc_priority_script,2015/06/15,ccc_priority_script,33,32,0:00:23,23,,1,736
20150615-ccc_tax_script,2015/06/15,ccc_tax_script,33,17,0:07:53,473,,16,8041
20150616-ccc_311_calgary_combined,2015/06/16,ccc_311_calgary_combined,5129,3236,0:07:50,470,,1893,1520920
20150616-ccc_help_script,2015/06/16,ccc_help_script,8,7,0:00:09,9,,1,63
20150616-ccc_priority_script,2015/06/16,ccc_priority_script,35,31,0:00:14,14,,4,434
20150616-ccc_tax_script,2015/06/16,ccc_tax_script,20,10,0:08:36,516,,10,5160
20150617-ccc_311_calgary_combined,2015/06/17,ccc_311_calgary_combined,4615,3066,0:07:07,427,,1549,1309182
20150617-ccc_help_script,2015/06/17,ccc_help_script,6,6,0:00:08,8,,0,48
20150617-ccc_priority_script,2015/06/17,ccc_priority_script,29,29,0:00:13,13,,0,377
20150617-ccc_tax_script,2015/06/17,ccc_tax_script,18,10,0:08:59,539,,8,5390
20150618-ccc_311_calgary_combined,2015/06/18,ccc_311_calgary_combined,4524,3149,0:06:27,387,,1375,1218663
20150618-ccc_help_script,2015/06/18,ccc_help_script,11,9,0:00:14,14,,2,126
20150618-ccc_priority_script,2015/06/18,ccc_priority_script,34,30,0:00:18,18,,4,540
20150618-ccc_tax_script,2015/06/18,ccc_tax_script,15,10,0:08:05,485,,5,4850
20150619-ccc_311_calgary_combined,2015/06/19,ccc_311_calgary_combined,4321,3244,0:05:16,316,,1077,1025104
20150619-ccc_help_script,2015/06/19,ccc_help_script,10,7,0:00:08,8,,3,56
20150619-ccc_priority_script,2015/06/19,ccc_priority_script,42,40,0:00:21,21,,2,840
20150619-ccc_tax_script,2015/06/19,ccc_tax_script,13,8,0:05:58,358,,5,2864
20150620-ccc_311_calgary_combined,2015/06/20,ccc_311_calgary_combined,1438,1389,0:00:22,22,,49,30558
20150620-ccc_help_script,2015/06/20,ccc_help_script,1,1,0:00:04,4,,0,4
20150620-ccc_priority_script,2015/06/20,ccc_priority_script,32,32,0:00:15,15,,0,480
20150621-ccc_311_calgary_combined,2015/06/21,ccc_311_calgary_combined,1072,1044,0:00:16,16,,28,16704
20150621-ccc_help_script,2015/06/21,ccc_help_script,3,3,0:00:05,5,,0,15
20150621-ccc_priority_script,2015/06/21,ccc_priority_script,28,28,0:00:09,9,,0,252
20150622-ccc_311_calgary_combined,2015/06/22,ccc_311_calgary_combined,5729,3651,0:06:03,363,,1932,1325313
20150622-ccc_help_script,2015/06/22,ccc_help_script,12,9,0:00:11,11,,3,99
20150622-ccc_priority_script,2015/06/22,ccc_priority_script,30,26,0:00:15,15,,4,390
20150622-ccc_tax_script,2015/06/22,ccc_tax_script,18,11,0:08:10,490,,7,5390
20150623-ccc_311_calgary_combined,2015/06/23,ccc_311_calgary_combined,5241,3130,0:08:42,522,,2111,1633860
20150623-ccc_help_script,2015/06/23,ccc_help_script,17,16,0:00:16,16,,1,256
20150623-ccc_priority_script,2015/06/23,ccc_priority_script,39,38,0:00:23,23,,1,874
20150623-ccc_tax_script,2015/06/23,ccc_tax_script,31,17,0:09:48,588,,14,9996
20150624-ccc_311_calgary_combined,2015/06/24,ccc_311_calgary_combined,5274,3380,0:07:23,443,,1894,1497340
20150624-ccc_help_script,2015/06/24,ccc_help_script,8,7,0:00:16,16,,1,112
20150624-ccc_priority_script,2015/06/24,ccc_priority_script,24,24,0:00:13,13,,0,312
20150624-ccc_tax_script,2015/06/24,ccc_tax_script,19,15,0:08:03,483,,4,7245
20150625-ccc_311_calgary_combined,2015/06/25,ccc_311_calgary_combined,5039,3447,0:07:05,425,,1592,1464975
20150625-ccc_help_script,2015/06/25,ccc_help_script,8,7,0:00:13,13,,1,91
20150625-ccc_priority_script,2015/06/25,ccc_priority_script,32,32,0:00:18,18,,0,576
20150625-ccc_tax_script,2015/06/25,ccc_tax_script,17,9,0:07:47,467,,8,4203
20150626-ccc_311_calgary_combined,2015/06/26,ccc_311_calgary_combined,4435,3480,0:04:32,272,,952,946560
20150626-ccc_help_script,2015/06/26,ccc_help_script,3,3,0:00:07,7,,0,21
20150626-ccc_priority_script,2015/06/26,ccc_priority_script,33,32,0:00:24,24,,1,768
20150626-ccc_tax_script,2015/06/26,ccc_tax_script,17,13,0:04:40,280,,4,3640
20150627-ccc_311_calgary_combined,2015/06/27,ccc_311_calgary_combined,1855,1673,0:01:17,77,,180,128821
20150627-ccc_help_script,2015/06/27,ccc_help_script,1,1,0:02:01,121,,0,121
20150627-ccc_priority_script,2015/06/27,ccc_priority_script,29,28,0:00:16,16,,1,448
20150628-ccc_311_calgary_combined,2015/06/28,ccc_311_calgary_combined,1526,1349,0:01:27,87,,182,117363
20150628-ccc_help_script,2015/06/28,ccc_help_script,1,1,0:00:02,2,,0,2
20150628-ccc_priority_script,2015/06/28,ccc_priority_script,32,30,0:00:26,26,,2,780
20150628-ccc_tax_script,2015/06/28,ccc_tax_script,2,1,0:00:03,3,,1,3
20150629-ccc_311_calgary_combined,2015/06/29,ccc_311_calgary_combined,6005,4219,0:06:37,397,,1786,1674943
20150629-ccc_help_script,2015/06/29,ccc_help_script,9,9,0:00:17,17,,0,153
20150629-ccc_priority_script,2015/06/29,ccc_priority_script,40,40,0:00:21,21,,0,840
20150629-ccc_tax_script,2015/06/29,ccc_tax_script,21,15,0:06:23,383,,6,5745
20150630-ccc_311_calgary_combined,2015/06/30,ccc_311_calgary_combined,6559,4734,0:05:25,325,,1822,1538550
20150630-ccc_help_script,2015/06/30,ccc_help_script,15,11,0:00:12,12,,4,132
20150630-ccc_priority_script,2015/06/30,ccc_priority_script,46,45,0:00:15,15,,1,675
20150630-ccc_tax_script,2015/06/30,ccc_tax_script,16,11,0:04:49,289,,5,3179
20150701-ccc_311_calgary_combined,2015/07/01,ccc_311_calgary_combined,2115,1991,0:00:38,38,,127,75658
20150701-ccc_help_script,2015/07/01,ccc_help_script,3,3,0:00:32,32,,0,96
20150701-ccc_priority_script,2015/07/01,ccc_priority_script,36,32,0:00:13,13,,4,416
20150702-ccc_311_calgary_combined,2015/07/02,ccc_311_calgary_combined,4857,3538,0:05:44,344,,1319,1217072
20150702-ccc_help_script,2015/07/02,ccc_help_script,17,16,0:00:12,12,,1,192
20150702-ccc_priority_script,2015/07/02,ccc_priority_script,58,54,0:00:29,29,,4,1566
20150702-ccc_tax_script,2015/07/02,ccc_tax_script,19,11,0:06:15,375,,8,4125
20150703-ccc_311_calgary_combined,2015/07/03,ccc_311_calgary_combined,3871,3233,0:02:56,176,,638,569008
20150703-ccc_help_script,2015/07/03,ccc_help_script,6,6,0:00:17,17,,0,102
20150703-ccc_priority_script,2015/07/03,ccc_priority_script,38,37,0:00:29,29,,1,1073
20150703-ccc_tax_script,2015/07/03,ccc_tax_script,9,7,0:03:56,236,,2,1652
20150704-ccc_311_calgary_combined,2015/07/04,ccc_311_calgary_combined,1732,1457,0:01:52,112,,275,163184
20150704-ccc_help_script,2015/07/04,ccc_help_script,2,2,0:00:46,46,,0,92
20150704-ccc_priority_script,2015/07/04,ccc_priority_script,69,68,0:00:25,25,,1,1700
20150705-ccc_311_calgary_combined,2015/07/05,ccc_311_calgary_combined,1272,1215,0:00:35,35,,57,42525
20150705-ccc_help_script,2015/07/05,ccc_help_script,1,1,0:00:04,4,,0,4
20150705-ccc_priority_script,2015/07/05,ccc_priority_script,27,25,0:00:17,17,,2,425
20150706-ccc_311_calgary_combined,2015/07/06,ccc_311_calgary_combined,5047,3050,0:08:13,493,,1998,1503650
20150706-ccc_help_script,2015/07/06,ccc_help_script,18,16,0:00:22,22,,2,352
20150706-ccc_priority_script,2015/07/06,ccc_priority_script,28,27,0:00:18,18,,1,486
20150706-ccc_tax_script,2015/07/06,ccc_tax_script,13,8,0:09:12,552,,5,4416
20150707-ccc_311_calgary_combined,2015/07/07,ccc_311_calgary_combined,4726,3042,0:07:31,451,,1683,1371942
20150707-ccc_help_script,2015/07/07,ccc_help_script,13,10,0:00:13,13,,3,130
20150707-ccc_priority_script,2015/07/07,ccc_priority_script,44,44,0:00:22,22,,0,968
20150707-ccc_tax_script,2015/07/07,ccc_tax_script,13,10,0:08:15,495,,3,4950
20150708-ccc_311_calgary_combined,2015/07/08,ccc_311_calgary_combined,4765,3123,0:06:38,398,,1641,1242954
20150708-ccc_help_script,2015/07/08,ccc_help_script,20,16,0:00:19,19,,4,304
20150708-ccc_priority_script,2015/07/08,ccc_priority_script,50,47,0:00:28,28,,3,1316
20150708-ccc_tax_script,2015/07/08,ccc_tax_script,18,15,0:06:04,364,,3,5460
20150709-ccc_311_calgary_combined,2015/07/09,ccc_311_calgary_combined,4156,3035,0:05:21,321,,1121,974235
20150709-ccc_help_script,2015/07/09,ccc_help_script,9,7,0:00:21,21,,2,147
20150709-ccc_priority_script,2015/07/09,ccc_priority_script,36,35,0:00:23,23,,1,805
20150709-ccc_tax_script,2015/07/09,ccc_tax_script,16,13,0:05:52,352,,3,4576
20150710-ccc_311_calgary_combined,2015/07/10,ccc_311_calgary_combined,3802,3015,0:03:51,231,,786,696465
20150710-ccc_help_script,2015/07/10,ccc_help_script,12,10,0:00:29,29,,2,290
20150710-ccc_priority_script,2015/07/10,ccc_priority_script,43,40,0:00:21,21,,3,840
20150710-ccc_tax_script,2015/07/10,ccc_tax_script,16,9,0:02:27,147,,7,1323
20150711-ccc_311_calgary_combined,2015/07/11,ccc_311_calgary_combined,1705,1485,0:01:13,73,,219,108405
20150711-ccc_help_script,2015/07/11,ccc_help_script,4,3,0:00:23,23,,1,69
20150711-ccc_priority_script,2015/07/11,ccc_priority_script,58,53,0:00:28,28,,5,1484
20150712-ccc_311_calgary_combined,2015/07/12,ccc_311_calgary_combined,1639,1340,0:01:43,103,,300,138020
20150712-ccc_help_script,2015/07/12,ccc_help_script,4,2,0:00:04,4,,2,8
20150712-ccc_priority_script,2015/07/12,ccc_priority_script,56,51,0:00:31,31,,5,1581
20150713-ccc_311_calgary_combined,2015/07/13,ccc_311_calgary_combined,4790,3068,0:07:13,433,,1722,1328444
20150713-ccc_help_script,2015/07/13,ccc_help_script,9,9,0:00:21,21,,0,189
20150713-ccc_priority_script,2015/07/13,ccc_priority_script,39,37,0:00:27,27,,2,999
20150713-ccc_tax_script,2015/07/13,ccc_tax_script,22,15,0:07:02,422,,7,6330
20150714-ccc_311_calgary_combined,2015/07/14,ccc_311_calgary_combined,4430,2864,0:07:22,442,,1565,1265888
20150714-ccc_help_script,2015/07/14,ccc_help_script,14,10,0:00:12,12,,4,120
20150714-ccc_priority_script,2015/07/14,ccc_priority_script,51,51,0:00:26,26,,0,1326
20150714-ccc_tax_script,2015/07/14,ccc_tax_script,20,11,0:08:02,482,,9,5302
20150715-ccc_311_calgary_combined,2015/07/15,ccc_311_calgary_combined,4242,2841,0:06:34,394,,1400,1119354
20150715-ccc_help_script,2015/07/15,ccc_help_script,13,11,0:00:17,17,,2,187
20150715-ccc_priority_script,2015/07/15,ccc_priority_script,21,20,0:00:20,20,,1,400
20150715-ccc_tax_script,2015/07/15,ccc_tax_script,26,15,0:06:00,360,,11,5400
20150716-ccc_311_calgary_combined,2015/07/16,ccc_311_calgary_combined,3601,2827,0:03:27,207,,774,585189
20150716-ccc_help_script,2015/07/16,ccc_help_script,14,13,0:00:09,9,,1,117
20150716-ccc_priority_script,2015/07/16,ccc_priority_script,27,27,0:00:17,17,,0,459
20150716-ccc_tax_script,2015/07/16,ccc_tax_script,12,8,0:03:42,222,,4,1776
20150717-ccc_311_calgary_combined,2015/07/17,ccc_311_calgary_combined,3510,2528,0:04:41,281,,981,710368
20150717-ccc_help_script,2015/07/17,ccc_help_script,9,7,0:00:43,43,,2,301
20150717-ccc_priority_script,2015/07/17,ccc_priority_script,54,54,0:00:28,28,,0,1512
20150717-ccc_tax_script,2015/07/17,ccc_tax_script,18,14,0:03:35,215,,4,3010
20150718-ccc_311_calgary_combined,2015/07/18,ccc_311_calgary_combined,1525,1402,0:00:51,51,,123,71502
20150718-ccc_help_script,2015/07/18,ccc_help_script,5,5,0:00:18,18,,0,90
20150718-ccc_priority_script,2015/07/18,ccc_priority_script,28,28,0:00:15,15,,0,420
20150718-ccc_tax_script,2015/07/18,ccc_tax_script,1,1,0:00:09,9,,0,9
20150719-ccc_311_calgary_combined,2015/07/19,ccc_311_calgary_combined,1230,1172,0:00:30,30,,58,35160
20150719-ccc_help_script,2015/07/19,ccc_help_script,1,1,0:00:22,22,,0,22
20150719-ccc_priority_script,2015/07/19,ccc_priority_script,27,27,0:00:28,28,,0,756
20150719-ccc_tax_script,2015/07/19,ccc_tax_script,4,4,0:03:26,206,,0,824
20150720-ccc_311_calgary_combined,2015/07/20,ccc_311_calgary_combined,4682,3038,0:07:25,445,,1641,1351910
20150720-ccc_help_script,2015/07/20,ccc_help_script,15,15,0:00:12,12,,0,180
20150720-ccc_priority_script,2015/07/20,ccc_priority_script,30,28,0:00:15,15,,2,420
20150720-ccc_tax_script,2015/07/20,ccc_tax_script,16,11,0:08:00,480,,5,5280
20150721-ccc_311_calgary_combined,2015/07/21,ccc_311_calgary_combined,4620,3053,0:06:19,379,,1567,1157087
20150721-ccc_help_script,2015/07/21,ccc_help_script,22,22,0:00:17,17,,0,374
20150721-ccc_priority_script,2015/07/21,ccc_priority_script,30,26,0:00:26,26,,4,676
20150721-ccc_tax_script,2015/07/21,ccc_tax_script,22,16,0:04:39,279,,6,4464
20150722-ccc_311_calgary_combined,2015/07/22,ccc_311_calgary_combined,4301,2916,0:06:18,378,,1384,1102248
20150722-ccc_help_script,2015/07/22,ccc_help_script,11,10,0:00:21,21,,1,210
20150722-ccc_priority_script,2015/07/22,ccc_priority_script,35,32,0:00:45,45,,3,1440
20150722-ccc_tax_script,2015/07/22,ccc_tax_script,14,13,0:07:57,477,,1,6201
20150723-ccc_311_calgary_combined,2015/07/23,ccc_311_calgary_combined,4014,2821,0:05:28,328,,1193,925288
20150723-ccc_help_script,2015/07/23,ccc_help_script,17,15,0:00:15,15,,2,225
20150723-ccc_priority_script,2015/07/23,ccc_priority_script,26,24,0:00:33,33,,2,792
20150723-ccc_tax_script,2015/07/23,ccc_tax_script,11,4,0:01:50,110,,7,440
20150724-ccc_311_calgary_combined,2015/07/24,ccc_311_calgary_combined,4153,2572,0:08:16,496,,1581,1275712
20150724-ccc_help_script,2015/07/24,ccc_help_script,9,8,0:00:24,24,,1,192
20150724-ccc_priority_script,2015/07/24,ccc_priority_script,36,34,0:00:23,23,,2,782
20150724-ccc_tax_script,2015/07/24,ccc_tax_script,18,8,0:08:57,537,,10,4296
20150725-ccc_311_calgary_combined,2015/07/25,ccc_311_calgary_combined,1397,1301,0:00:40,40,,96,52040
20150725-ccc_priority_script,2015/07/25,ccc_priority_script,27,27,0:00:20,20,,0,540
20150725-ccc_tax_script,2015/07/25,ccc_tax_script,2,2,0:01:37,97,,0,194
20150726-ccc_311_calgary_combined,2015/07/26,ccc_311_calgary_combined,1202,1063,0:01:09,69,,139,73347
20150726-ccc_help_script,2015/07/26,ccc_help_script,3,2,0:00:54,54,,1,108
20150726-ccc_priority_script,2015/07/26,ccc_priority_script,26,24,0:00:16,16,,2,384
20150727-ccc_311_calgary_combined,2015/07/27,ccc_311_calgary_combined,4578,3367,0:05:13,313,,1210,1053871
20150727-ccc_help_script,2015/07/27,ccc_help_script,10,10,0:00:46,46,,0,460
20150727-ccc_priority_script,2015/07/27,ccc_priority_script,25,23,0:00:14,14,,2,322
20150727-ccc_tax_script,2015/07/27,ccc_tax_script,10,9,0:06:47,407,,1,3663
20150728-ccc_311_calgary_combined,2015/07/28,ccc_311_calgary_combined,4153,3305,0:03:34,214,,848,707270
20150728-ccc_help_script,2015/07/28,ccc_help_script,16,16,0:00:43,43,,0,688
20150728-ccc_priority_script,2015/07/28,ccc_priority_script,36,33,0:00:24,24,,3,792
20150728-ccc_tax_script,2015/07/28,ccc_tax_script,15,12,0:04:59,299,,3,3588
20150729-ccc_311_calgary_combined,2015/07/29,ccc_311_calgary_combined,4060,2843,0:05:30,330,,1197,938190
20150729-ccc_help_script,2015/07/29,ccc_help_script,6,5,0:00:13,13,,1,65
20150729-ccc_priority_script,2015/07/29,ccc_priority_script,48,41,0:00:19,19,,7,779
20150729-ccc_tax_script,2015/07/29,ccc_tax_script,11,7,0:05:39,339,,4,2373
20150730-ccc_311_calgary_combined,2015/07/30,ccc_311_calgary_combined,4080,2884,0:05:20,320,,1193,922880
20150730-ccc_help_script,2015/07/30,ccc_help_script,18,17,0:00:19,19,,1,323
20150730-ccc_priority_script,2015/07/30,ccc_priority_script,43,40,0:00:21,21,,3,840
20150730-ccc_tax_script,2015/07/30,ccc_tax_script,17,12,0:07:11,431,,5,5172
20150731-ccc_311_calgary_combined,2015/07/31,ccc_311_calgary_combined,3701,2890,0:03:34,214,,808,618460
20150731-ccc_help_script,2015/07/31,ccc_help_script,9,7,0:00:09,9,,2,63
20150731-ccc_priority_script,2015/07/31,ccc_priority_script,19,17,0:00:15,15,,2,255
20150731-ccc_tax_script,2015/07/31,ccc_tax_script,18,15,0:03:41,221,,3,3315
20150801-ccc_311_calgary_combined,2015/08/01,ccc_311_calgary_combined,1433,1359,0:00:36,36,,74,48924
20150801-ccc_priority_script,2015/08/01,ccc_priority_script,31,31,0:00:19,19,,0,589
20150802-ccc_311_calgary_combined,2015/08/02,ccc_311_calgary_combined,1213,1122,0:00:39,39,,91,43758
20150802-ccc_help_script,2015/08/02,ccc_help_script,4,4,0:00:27,27,,0,108
20150802-ccc_priority_script,2015/08/02,ccc_priority_script,26,26,0:00:33,33,,0,858
20150803-ccc_311_calgary_combined,2015/08/03,ccc_311_calgary_combined,1486,1419,0:00:30,30,,67,42570
20150803-ccc_help_script,2015/08/03,ccc_help_script,1,1,0:00:46,46,,0,46
20150803-ccc_priority_script,2015/08/03,ccc_priority_script,18,18,0:00:17,17,,0,306
20150804-ccc_311_calgary_combined,2015/08/04,ccc_311_calgary_combined,5979,3439,0:06:38,398,,2540,1368722
20150804-ccc_help_script,2015/08/04,ccc_help_script,21,17,0:00:15,15,,4,255
20150804-ccc_priority_script,2015/08/04,ccc_priority_script,98,95,0:00:22,22,,3,2090
20150804-ccc_tax_script,2015/08/04,ccc_tax_script,19,13,0:07:16,436,,6,5668
20150805-ccc_311_calgary_combined,2015/08/05,ccc_311_calgary_combined,4427,3222,0:04:05,245,,1205,789390
20150805-ccc_help_script,2015/08/05,ccc_help_script,20,20,0:00:13,13,,0,260
20150805-ccc_priority_script,2015/08/05,ccc_priority_script,51,49,0:00:19,19,,2,931
20150805-ccc_tax_script,2015/08/05,ccc_tax_script,24,19,0:04:51,291,,5,5529
20150806-ccc_311_calgary_combined,2015/08/06,ccc_311_calgary_combined,4240,3231,0:03:46,226,,1009,730206
20150806-ccc_help_script,2015/08/06,ccc_help_script,11,10,0:02:19,139,,1,1390
20150806-ccc_priority_script,2015/08/06,ccc_priority_script,40,37,0:00:17,17,,3,629
20150806-ccc_tax_script,2015/08/06,ccc_tax_script,12,10,0:05:12,312,,2,3120
20150807-ccc_311_calgary_combined,2015/08/07,ccc_311_calgary_combined,3849,2949,0:03:44,224,,899,660576
20150807-ccc_help_script,2015/08/07,ccc_help_script,4,4,0:00:06,6,,0,24
20150807-ccc_priority_script,2015/08/07,ccc_priority_script,43,42,0:00:26,26,,1,1092
20150807-ccc_tax_script,2015/08/07,ccc_tax_script,17,12,0:05:20,320,,5,3840
20150808-ccc_311_calgary_combined,2015/08/08,ccc_311_calgary_combined,1653,1368,0:02:03,123,,285,168264
20150808-ccc_help_script,2015/08/08,ccc_help_script,4,3,0:00:18,18,,1,54
20150808-ccc_priority_script,2015/08/08,ccc_priority_script,30,30,0:00:34,34,,0,1020
20150809-ccc_311_calgary_combined,2015/08/09,ccc_311_calgary_combined,1290,1174,0:00:54,54,,115,63396
20150809-ccc_help_script,2015/08/09,ccc_help_script,2,1,0:00:06,6,,1,6
20150809-ccc_priority_script,2015/08/09,ccc_priority_script,36,34,0:00:14,14,,2,476
20150810-ccc_311_calgary_combined,2015/08/10,ccc_311_calgary_combined,4621,3402,0:04:36,276,,1219,938952
20150810-ccc_help_script,2015/08/10,ccc_help_script,9,8,0:00:11,11,,1,88
20150810-ccc_priority_script,2015/08/10,ccc_priority_script,31,28,0:00:12,12,,3,336
20150810-ccc_tax_script,2015/08/10,ccc_tax_script,20,15,0:04:25,265,,5,3975
20150811-ccc_311_calgary_combined,2015/08/11,ccc_311_calgary_combined,4176,3340,0:03:22,202,,836,674680
20150811-ccc_help_script,2015/08/11,ccc_help_script,11,11,0:00:13,13,,0,143
20150811-ccc_priority_script,2015/08/11,ccc_priority_script,28,28,0:00:30,30,,0,840
20150811-ccc_tax_script,2015/08/11,ccc_tax_script,11,11,0:03:30,210,,0,2310
20150812-ccc_311_calgary_combined,2015/08/12,ccc_311_calgary_combined,4182,2978,0:04:54,294,,1204,875532
20150812-ccc_help_script,2015/08/12,ccc_help_script,7,7,0:00:27,27,,0,189
20150812-ccc_priority_script,2015/08/12,ccc_priority_script,24,23,0:00:15,15,,1,345
20150812-ccc_tax_script,2015/08/12,ccc_tax_script,16,12,0:07:24,444,,4,5328
20150813-ccc_311_calgary_combined,2015/08/13,ccc_311_calgary_combined,3994,3025,0:04:19,259,,969,783475
20150813-ccc_help_script,2015/08/13,ccc_help_script,15,12,0:00:13,13,,3,156
20150813-ccc_priority_script,2015/08/13,ccc_priority_script,35,32,0:00:19,19,,3,608
20150813-ccc_tax_script,2015/08/13,ccc_tax_script,7,5,0:06:54,414,,2,2070
20150814-ccc_311_calgary_combined,2015/08/14,ccc_311_calgary_combined,3910,2629,0:05:47,347,,1274,912263
20150814-ccc_help_script,2015/08/14,ccc_help_script,12,10,0:00:22,22,,2,220
20150814-ccc_priority_script,2015/08/14,ccc_priority_script,24,24,0:00:14,14,,0,336
20150814-ccc_tax_script,2015/08/14,ccc_tax_script,13,11,0:06:02,362,,2,3982
20150815-ccc_311_calgary_combined,2015/08/15,ccc_311_calgary_combined,1300,1206,0:00:45,45,,94,54270
20150815-ccc_help_script,2015/08/15,ccc_help_script,1,1,0:00:02,2,,0,2
20150815-ccc_priority_script,2015/08/15,ccc_priority_script,30,30,0:00:19,19,,0,570
20150815-ccc_tax_script,2015/08/15,ccc_tax_script,2,1,0:00:05,5,,1,5
20150816-ccc_311_calgary_combined,2015/08/16,ccc_311_calgary_combined,1142,1088,0:00:25,25,,54,27200
20150816-ccc_help_script,2015/08/16,ccc_help_script,2,2,0:00:27,27,,0,54
20150816-ccc_priority_script,2015/08/16,ccc_priority_script,21,21,0:00:06,6,,0,126
20150817-ccc_311_calgary_combined,2015/08/17,ccc_311_calgary_combined,5011,3580,0:05:11,311,,1431,1113380
20150817-ccc_help_script,2015/08/17,ccc_help_script,12,12,0:00:12,12,,0,144
20150817-ccc_priority_script,2015/08/17,ccc_priority_script,42,41,0:00:12,12,,1,492
20150817-ccc_tax_script,2015/08/17,ccc_tax_script,14,13,0:08:04,484,,1,6292
20150818-ccc_311_calgary_combined,2015/08/18,ccc_311_calgary_combined,4203,3321,0:03:26,206,,882,684126
20150818-ccc_help_script,2015/08/18,ccc_help_script,9,8,0:00:09,9,,1,72
20150818-ccc_priority_script,2015/08/18,ccc_priority_script,31,30,0:00:20,20,,1,600
20150818-ccc_tax_script,2015/08/18,ccc_tax_script,22,22,0:03:14,194,,0,4268
20150819-ccc_311_calgary_combined,2015/08/19,ccc_311_calgary_combined,4035,3249,0:02:53,173,,786,562077
20150819-ccc_help_script,2015/08/19,ccc_help_script,12,9,0:00:15,15,,3,135
20150819-ccc_priority_script,2015/08/19,ccc_priority_script,39,38,0:00:23,23,,1,874
20150819-ccc_tax_script,2015/08/19,ccc_tax_script,17,16,0:03:17,197,,1,3152
20150820-ccc_311_calgary_combined,2015/08/20,ccc_311_calgary_combined,4009,3234,0:02:58,178,,775,575652
20150820-ccc_help_script,2015/08/20,ccc_help_script,19,14,0:00:15,15,,5,210
20150820-ccc_priority_script,2015/08/20,ccc_priority_script,39,33,0:00:13,13,,6,429
20150820-ccc_tax_script,2015/08/20,ccc_tax_script,17,14,0:02:51,171,,3,2394
20150821-ccc_311_calgary_combined,2015/08/21,ccc_311_calgary_combined,3276,2798,0:01:59,119,,478,332962
20150821-ccc_help_script,2015/08/21,ccc_help_script,9,7,0:00:22,22,,2,154
20150821-ccc_priority_script,2015/08/21,ccc_priority_script,38,37,0:00:15,15,,1,555
20150821-ccc_tax_script,2015/08/21,ccc_tax_script,15,11,0:01:16,76,,4,836
20150822-ccc_311_calgary_combined,2015/08/22,ccc_311_calgary_combined,1505,1357,0:01:02,62,,148,84134
20150822-ccc_help_script,2015/08/22,ccc_help_script,1,0,0:00:00,0,,1,0
20150822-ccc_priority_script,2015/08/22,ccc_priority_script,25,24,0:00:22,22,,1,528
20150823-ccc_311_calgary_combined,2015/08/23,ccc_311_calgary_combined,1157,1133,0:00:14,14,,24,15862
20150823-ccc_help_script,2015/08/23,ccc_help_script,3,3,0:00:07,7,,0,21
20150823-ccc_priority_script,2015/08/23,ccc_priority_script,20,19,0:00:05,5,,1,95
20150824-ccc_311_calgary_combined,2015/08/24,ccc_311_calgary_combined,4052,3671,0:01:15,75,,381,275325
20150824-ccc_help_script,2015/08/24,ccc_help_script,7,7,0:00:11,11,,0,77
20150824-ccc_priority_script,2015/08/24,ccc_priority_script,37,34,0:00:12,12,,3,408
20150824-ccc_tax_script,2015/08/24,ccc_tax_script,18,17,0:01:16,76,,1,1292
20150825-ccc_311_calgary_combined,2015/08/25,ccc_311_calgary_combined,4126,3278,0:03:07,187,,848,612986
20150825-ccc_help_script,2015/08/25,ccc_help_script,10,10,0:00:10,10,,0,100
20150825-ccc_priority_script,2015/08/25,ccc_priority_script,32,28,0:00:14,14,,4,392
20150825-ccc_tax_script,2015/08/25,ccc_tax_script,15,9,0:03:07,187,,6,1683
20150826-ccc_311_calgary_combined,2015/08/26,ccc_311_calgary_combined,3775,3101,0:02:42,162,,674,502362
20150826-ccc_help_script,2015/08/26,ccc_help_script,8,8,0:00:11,11,,0,88
20150826-ccc_priority_script,2015/08/26,ccc_priority_script,35,31,0:00:19,19,,4,589
20150826-ccc_tax_script,2015/08/26,ccc_tax_script,10,10,0:01:52,112,,0,1120
20150827-ccc_311_calgary_combined,2015/08/27,ccc_311_calgary_combined,3775,3377,0:01:22,82,,398,276914
20150827-ccc_help_script,2015/08/27,ccc_help_script,12,11,0:00:09,9,,1,99
20150827-ccc_priority_script,2015/08/27,ccc_priority_script,28,26,0:00:13,13,,2,338
20150827-ccc_tax_script,2015/08/27,ccc_tax_script,13,12,0:01:21,81,,1,972
20150828-ccc_311_calgary_combined,2015/08/28,ccc_311_calgary_combined,3649,3159,0:02:03,123,,490,388557
20150828-ccc_help_script,2015/08/28,ccc_help_script,5,5,0:00:13,13,,0,65
20150828-ccc_priority_script,2015/08/28,ccc_priority_script,31,28,0:01:48,108,,3,3024
20150828-ccc_tax_script,2015/08/28,ccc_tax_script,19,13,0:03:03,183,,6,2379
20150829-ccc_311_calgary_combined,2015/08/29,ccc_311_calgary_combined,1777,1456,0:01:57,117,,321,170352
20150829-ccc_help_script,2015/08/29,ccc_help_script,1,1,0:00:05,5,,0,5
20150829-ccc_priority_script,2015/08/29,ccc_priority_script,38,35,0:00:31,31,,3,1085
20150830-ccc_311_calgary_combined,2015/08/30,ccc_311_calgary_combined,1369,1285,0:00:44,44,,83,56540
20150830-ccc_help_script,2015/08/30,ccc_help_script,8,8,0:00:11,11,,0,88
20150830-ccc_priority_script,2015/08/30,ccc_priority_script,18,18,0:00:10,10,,0,180
20150831-ccc_311_calgary_combined,2015/08/31,ccc_311_calgary_combined,4224,3820,0:01:20,80,,403,305600
20150831-ccc_help_script,2015/08/31,ccc_help_script,13,12,0:00:11,11,,1,132
20150831-ccc_priority_script,2015/08/31,ccc_priority_script,16,16,0:00:10,10,,0,160
20150831-ccc_tax_script,2015/08/31,ccc_tax_script,15,14,0:01:31,91,,1,1274
20150901-ccc_311_calgary_combined,2015/09/01,ccc_311_calgary_combined,4223,3516,0:02:41,161,,704,566076
20150901-ccc_help_script,2015/09/01,ccc_help_script,12,11,0:00:16,16,,1,176
20150901-ccc_priority_script,2015/09/01,ccc_priority_script,37,36,0:00:12,12,,1,432
20150901-ccc_tax_script,2015/09/01,ccc_tax_script,13,11,0:03:19,199,,2,2189
20150902-ccc_311_calgary_combined,2015/09/02,ccc_311_calgary_combined,4257,3253,0:04:17,257,,1002,836021
20150902-ccc_help_script,2015/09/02,ccc_help_script,25,19,0:00:13,13,,6,247
20150902-ccc_priority_script,2015/09/02,ccc_priority_script,37,37,0:00:15,15,,0,555
20150902-ccc_tax_script,2015/09/02,ccc_tax_script,17,17,0:06:09,369,,0,6273
20150903-ccc_311_calgary_combined,2015/09/03,ccc_311_calgary_combined,3838,3227,0:02:41,161,,610,519547
20150903-ccc_help_script,2015/09/03,ccc_help_script,14,11,0:00:08,8,,3,88
20150903-ccc_priority_script,2015/09/03,ccc_priority_script,44,42,0:00:14,14,,2,588
20150903-ccc_tax_script,2015/09/03,ccc_tax_script,19,17,0:03:35,215,,2,3655
20150904-ccc_311_calgary_combined,2015/09/04,ccc_311_calgary_combined,3256,2971,0:01:10,70,,285,207970
20150904-ccc_help_script,2015/09/04,ccc_help_script,17,12,0:00:24,24,,5,288
20150904-ccc_priority_script,2015/09/04,ccc_priority_script,22,22,0:00:28,28,,0,616
20150904-ccc_tax_script,2015/09/04,ccc_tax_script,14,13,0:01:17,77,,1,1001
20150905-ccc_311_calgary_combined,2015/09/05,ccc_311_calgary_combined,1143,1097,0:00:17,17,,46,18649
20150905-ccc_help_script,2015/09/05,ccc_help_script,1,0,0:00:00,0,,0,0
20150905-ccc_priority_script,2015/09/05,ccc_priority_script,26,25,0:00:07,7,,1,175
20150906-ccc_311_calgary_combined,2015/09/06,ccc_311_calgary_combined,1038,973,0:00:31,31,,65,30163
20150906-ccc_help_script,2015/09/06,ccc_help_script,5,5,0:00:07,7,,0,35
20150906-ccc_priority_script,2015/09/06,ccc_priority_script,20,20,0:00:15,15,,0,300
20150906-ccc_tax_script,2015/09/06,ccc_tax_script,1,1,0:00:03,3,,0,3
20150907-ccc_311_calgary_combined,2015/09/07,ccc_311_calgary_combined,1347,1308,0:00:20,20,,39,26160
20150907-ccc_help_script,2015/09/07,ccc_help_script,4,4,0:00:03,3,,0,12
20150907-ccc_priority_script,2015/09/07,ccc_priority_script,20,20,0:00:27,27,,0,540
20150907-ccc_tax_script,2015/09/07,ccc_tax_script,1,1,0:00:02,2,,0,2
20150908-ccc_311_calgary_combined,2015/09/08,ccc_311_calgary_combined,4610,3441,0:04:18,258,,1168,887778
20150908-ccc_help_script,2015/09/08,ccc_help_script,10,7,0:00:13,13,,3,91
20150908-ccc_priority_script,2015/09/08,ccc_priority_script,26,25,0:00:18,18,,1,450
20150908-ccc_tax_script,2015/09/08,ccc_tax_script,15,12,0:02:47,167,,3,2004
20150909-ccc_311_calgary_combined,2015/09/09,ccc_311_calgary_combined,3797,3406,0:01:27,87,,391,296322
20150909-ccc_help_script,2015/09/09,ccc_help_script,11,10,0:00:13,13,,1,130
20150909-ccc_priority_script,2015/09/09,ccc_priority_script,29,29,0:00:14,14,,0,406
20150909-ccc_tax_script,2015/09/09,ccc_tax_script,9,8,0:01:21,81,,1,648
20150910-ccc_311_calgary_combined,2015/09/10,ccc_311_calgary_combined,3915,3126,0:03:15,195,,788,609570
20150910-ccc_help_script,2015/09/10,ccc_help_script,15,13,0:01:24,84,,2,1092
20150910-ccc_priority_script,2015/09/10,ccc_priority_script,41,40,0:00:26,26,,1,1040
20150910-ccc_tax_script,2015/09/10,ccc_tax_script,16,14,0:03:56,236,,2,3304
20150911-ccc_311_calgary_combined,2015/09/11,ccc_311_calgary_combined,3729,3158,0:02:17,137,,571,432646
20150911-ccc_help_script,2015/09/11,ccc_help_script,8,5,0:00:17,17,,3,85
20150911-ccc_priority_script,2015/09/11,ccc_priority_script,24,23,0:00:14,14,,1,322
20150911-ccc_tax_script,2015/09/11,ccc_tax_script,10,6,0:02:45,165,,4,990
20150912-ccc_311_calgary_combined,2015/09/12,ccc_311_calgary_combined,1689,1329,0:02:16,136,,360,180744
20150912-ccc_priority_script,2015/09/12,ccc_priority_script,35,30,0:00:43,43,,5,1290
20150912-ccc_tax_script,2015/09/12,ccc_tax_script,1,1,0:00:04,4,,0,4
20150913-ccc_311_calgary_combined,2015/09/13,ccc_311_calgary_combined,1114,1058,0:00:29,29,,56,30682
20150913-ccc_priority_script,2015/09/13,ccc_priority_script,19,18,0:00:16,16,,1,288
20150914-ccc_311_calgary_script,2015/09/14,ccc_311_calgary_script,3663,3392,0:01:01,61,0:09:15,271,206912
20150914-ccc_311_lobby_ph_script,2015/09/14,ccc_311_lobby_ph_script,1,1,0:00:12,12,0:00:12,0,12
20150914-ccc_aserv_info_script,2015/09/14,ccc_aserv_info_script,0,0,0:00:00,0,0:00:00,0,0
20150914-ccc_bylaw_script,2015/09/14,ccc_bylaw_script,0,0,0:00:00,0,0:00:00,0,0
20150914-ccc_city_script,2015/09/14,ccc_city_script,19,19,0:00:11,11,0:01:08,0,209
20150914-ccc_cty_online_script,2015/09/14,ccc_cty_online_script,0,0,0:00:00,0,0:00:00,0,0
20150914-ccc_feedback_script,2015/09/14,ccc_feedback_script,1,0,0:00:00,0,0:00:00,0,0
20150914-ccc_fpb_script,2015/09/14,ccc_fpb_script,0,0,0:00:00,0,0:00:00,0,0
20150914-ccc_help_script,2015/09/14,ccc_help_script,3,3,0:00:04,4,0:00:05,0,12
20150914-ccc_link_script,2015/09/14,ccc_link_script,0,0,0:00:00,0,0:00:00,0,0
20150914-ccc_media_line_script,2015/09/14,ccc_media_line_script,2,2,0:00:09,9,0:00:14,0,18
20150914-ccc_priority_script,2015/09/14,ccc_priority_script,30,30,0:00:14,14,0:00:54,0,420
20150914-ccc_tax_script,2015/09/14,ccc_tax_script,12,10,0:00:44,44,0:03:33,2,440
20150914-ccc_waste_recycling_script,2015/09/14,ccc_waste_recycling_script,0,0,0:00:00,0,0:00:00,0,0
20150915-ccc_311_calgary_script,2015/09/15,ccc_311_calgary_script,3777,3124,0:02:37,157,0:16:19,653,490468
20150915-ccc_311_lobby_ph_script,2015/09/15,ccc_311_lobby_ph_script,3,3,0:00:19,19,0:00:47,0,57
20150915-ccc_aserv_info_script,2015/09/15,ccc_aserv_info_script,0,0,0:00:00,0,0:00:00,0,0
20150915-ccc_bylaw_script,2015/09/15,ccc_bylaw_script,0,0,0:00:00,0,0:00:00,0,0
20150915-ccc_city_script,2015/09/15,ccc_city_script,21,21,0:00:34,34,0:03:49,0,714
20150915-ccc_cty_online_script,2015/09/15,ccc_cty_online_script,0,0,0:00:00,0,0:00:00,0,0
20150915-ccc_feedback_script,2015/09/15,ccc_feedback_script,0,0,0:00:00,0,0:00:00,0,0
20150915-ccc_fpb_script,2015/09/15,ccc_fpb_script,0,0,0:00:00,0,0:00:00,0,0
20150915-ccc_help_script,2015/09/15,ccc_help_script,7,7,0:00:16,16,0:00:47,0,112
20150915-ccc_link_script,2015/09/15,ccc_link_script,0,0,0:00:00,0,0:00:00,0,0
20150915-ccc_media_line_script,2015/09/15,ccc_media_line_script,0,0,0:00:00,0,0:00:00,0,0
20150915-ccc_priority_script,2015/09/15,ccc_priority_script,35,31,0:00:17,17,0:01:28,4,527
20150915-ccc_tax_script,2015/09/15,ccc_tax_script,16,13,0:02:32,152,0:06:09,3,1976
20150915-ccc_waste_recycling_script,2015/09/15,ccc_waste_recycling_script,0,0,0:00:00,0,0:00:00,0,0
20150916-ccc_311_calgary_script,2015/09/16,ccc_311_calgary_script,3469,3039,0:01:46,106,0:11:28,430,322134
20150916-ccc_311_lobby_ph_script,2015/09/16,ccc_311_lobby_ph_script,3,2,0:00:13,13,0:00:18,1,26
20150916-ccc_aserv_info_script,2015/09/16,ccc_aserv_info_script,0,0,0:00:00,0,0:00:00,0,0
20150916-ccc_bylaw_script,2015/09/16,ccc_bylaw_script,0,0,0:00:00,0,0:00:00,0,0
20150916-ccc_city_script,2015/09/16,ccc_city_script,23,23,0:01:06,66,0:05:21,0,1518
20150916-ccc_cty_online_script,2015/09/16,ccc_cty_online_script,0,0,0:00:00,0,0:00:00,0,0
20150916-ccc_feedback_script,2015/09/16,ccc_feedback_script,0,0,0:00:00,0,0:00:00,0,0
20150916-ccc_fpb_script,2015/09/16,ccc_fpb_script,2,0,0:00:00,0,0:00:00,2,0
20150916-ccc_help_script,2015/09/16,ccc_help_script,14,12,0:00:18,18,0:01:16,2,216
20150916-ccc_link_script,2015/09/16,ccc_link_script,0,0,0:00:00,0,0:00:00,0,0
20150916-ccc_media_line_script,2015/09/16,ccc_media_line_script,3,2,0:00:23,23,0:00:41,1,46
20150916-ccc_priority_script,2015/09/16,ccc_priority_script,14,14,0:00:08,8,0:00:40,0,112
20150916-ccc_tax_script,2015/09/16,ccc_tax_script,9,7,0:01:36,96,0:03:35,2,672
20150916-ccc_waste_recycling_script,2015/09/16,ccc_waste_recycling_script,0,0,0:00:00,0,0:00:00,0,0
20150917-ccc_311_calgary_script,2015/09/17,ccc_311_calgary_script,3336,3166,0:00:39,39,0:04:53,170,123474
20150917-ccc_311_lobby_ph_script,2015/09/17,ccc_311_lobby_ph_script,5,5,0:00:07,7,0:00:11,0,35
20150917-ccc_aserv_info_script,2015/09/17,ccc_aserv_info_script,0,0,0:00:00,0,0:00:00,0,0
20150917-ccc_bylaw_script,2015/09/17,ccc_bylaw_script,0,0,0:00:00,0,0:00:00,0,0
20150917-ccc_city_script,2015/09/17,ccc_city_script,21,20,0:00:15,15,0:01:45,1,300
20150917-ccc_cty_online_script,2015/09/17,ccc_cty_online_script,0,0,0:00:00,0,0:00:00,0,0
20150917-ccc_feedback_script,2015/09/17,ccc_feedback_script,0,0,0:00:00,0,0:00:00,0,0
20150917-ccc_fpb_script,2015/09/17,ccc_fpb_script,1,1,0:00:05,5,0:00:05,0,5
20150917-ccc_help_script,2015/09/17,ccc_help_script,14,13,0:00:06,6,0:00:14,1,78
20150917-ccc_link_script,2015/09/17,ccc_link_script,0,0,0:00:00,0,0:00:00,0,0
20150917-ccc_media_line_script,2015/09/17,ccc_media_line_script,1,1,0:00:10,10,0:00:10,0,10
20150917-ccc_priority_script,2015/09/17,ccc_priority_script,35,35,0:00:13,13,0:01:19,0,455
20150917-ccc_tax_script,2015/09/17,ccc_tax_script,9,7,0:00:47,47,0:02:10,2,329
20150917-ccc_waste_recycling_script,2015/09/17,ccc_waste_recycling_script,0,0,0:00:00,0,0:00:00,0,0
20150918-ccc_311_calgary_script,2015/09/18,ccc_311_calgary_script,3157,2984,0:00:38,38,0:08:10,173,113392
20150918-ccc_311_lobby_ph_script,2015/09/18,ccc_311_lobby_ph_script,5,5,0:00:10,10,0:00:16,0,50
20150918-ccc_aserv_info_script,2015/09/18,ccc_aserv_info_script,0,0,0:00:00,0,0:00:00,0,0
20150918-ccc_bylaw_script,2015/09/18,ccc_bylaw_script,0,0,0:00:00,0,0:00:00,0,0
20150918-ccc_city_script,2015/09/18,ccc_city_script,13,13,0:00:07,7,0:00:21,0,91
20150918-ccc_cty_online_script,2015/09/18,ccc_cty_online_script,0,0,0:00:00,0,0:00:00,0,0
20150918-ccc_feedback_script,2015/09/18,ccc_feedback_script,0,0,0:00:00,0,0:00:00,0,0
20150918-ccc_fpb_script,2015/09/18,ccc_fpb_script,2,1,0:00:01,1,0:00:01,1,1
20150918-ccc_help_script,2015/09/18,ccc_help_script,4,4,0:00:13,13,0:00:32,0,52
20150918-ccc_link_script,2015/09/18,ccc_link_script,0,0,0:00:00,0,0:00:00,0,0
20150918-ccc_media_line_script,2015/09/18,ccc_media_line_script,1,1,0:00:05,5,0:00:05,0,5
20150918-ccc_priority_script,2015/09/18,ccc_priority_script,42,41,0:00:16,16,0:01:47,1,656
20150918-ccc_tax_script,2015/09/18,ccc_tax_script,7,7,0:01:06,66,0:02:51,0,462
20150918-ccc_waste_recycling_script,2015/09/18,ccc_waste_recycling_script,0,0,0:00:00,0,0:00:00,0,0
20150919-ccc_311_calgary_script,2015/09/19,ccc_311_calgary_script,1362,1103,0:02:06,126,0:11:38,259,138978
20150919-ccc_311_lobby_ph_script,2015/09/19,ccc_311_lobby_ph_script,0,0,0:00:00,0,0:00:00,0,0
20150919-ccc_aserv_info_script,2015/09/19,ccc_aserv_info_script,0,0,0:00:00,0,0:00:00,0,0
20150919-ccc_bylaw_script,2015/09/19,ccc_bylaw_script,0,0,0:00:00,0,0:00:00,0,0
20150919-ccc_city_script,2015/09/19,ccc_city_script,0,0,0:00:00,0,0:00:00,0,0
20150919-ccc_cty_online_script,2015/09/19,ccc_cty_online_script,0,0,0:00:00,0,0:00:00,0,0
20150919-ccc_feedback_script,2015/09/19,ccc_feedback_script,0,0,0:00:00,0,0:00:00,0,0
20150919-ccc_fpb_script,2015/09/19,ccc_fpb_script,0,0,0:00:00,0,0:00:00,0,0
20150919-ccc_help_script,2015/09/19,ccc_help_script,2,1,0:00:38,38,0:00:38,1,38
20150919-ccc_link_script,2015/09/19,ccc_link_script,0,0,0:00:00,0,0:00:00,0,0
20150919-ccc_media_line_script,2015/09/19,ccc_media_line_script,1,1,0:00:01,1,0:00:01,0,1
20150919-ccc_priority_script,2015/09/19,ccc_priority_script,24,20,0:00:20,20,0:01:25,4,400
20150919-ccc_tax_script,2015/09/19,ccc_tax_script,2,0,0:00:00,0,0:00:00,2,0
20150919-ccc_waste_recycling_script,2015/09/19,ccc_waste_recycling_script,0,0,0:00:00,0,0:00:00,0,0
20150920-ccc_311_calgary_script,2015/09/20,ccc_311_calgary_script,1153,1085,0:00:42,42,0:11:32,68,45570
20150920-ccc_311_lobby_ph_script,2015/09/20,ccc_311_lobby_ph_script,0,0,0:00:00,0,0:00:00,0,0
20150920-ccc_aserv_info_script,2015/09/20,ccc_aserv_info_script,0,0,0:00:00,0,0:00:00,0,0
20150920-ccc_bylaw_script,2015/09/20,ccc_bylaw_script,0,0,0:00:00,0,0:00:00,0,0
20150920-ccc_city_script,2015/09/20,ccc_city_script,0,0,0:00:00,0,0:00:00,0,0
20150920-ccc_cty_online_script,2015/09/20,ccc_cty_online_script,0,0,0:00:00,0,0:00:00,0,0
20150920-ccc_feedback_script,2015/09/20,ccc_feedback_script,0,0,0:00:00,0,0:00:00,0,0
20150920-ccc_fpb_script,2015/09/20,ccc_fpb_script,0,0,0:00:00,0,0:00:00,0,0
20150920-ccc_help_script,2015/09/20,ccc_help_script,0,0,0:00:00,0,0:00:00,0,0
20150920-ccc_link_script,2015/09/20,ccc_link_script,0,0,0:00:00,0,0:00:00,0,0
20150920-ccc_media_line_script,2015/09/20,ccc_media_line_script,3,3,0:00:07,7,0:00:10,0,21
20150920-ccc_priority_script,2015/09/20,ccc_priority_script,16,14,0:00:14,14,0:01:07,2,196
20150920-ccc_tax_script,2015/09/20,ccc_tax_script,2,2,0:00:03,3,0:00:03,0,6
20150920-ccc_waste_recycling_script,2015/09/20,ccc_waste_recycling_script,0,0,0:00:00,0,0:00:00,0,0
20150921-ccc_311_calgary_script,2015/09/21,ccc_311_calgary_script,3472,3194,0:01:03,63,0:10:27,278,201222
20150921-ccc_311_lobby_ph_script,2015/09/21,ccc_311_lobby_ph_script,1,1,0:00:10,10,0:00:10,0,10
20150921-ccc_aserv_info_script,2015/09/21,ccc_aserv_info_script,0,0,0:00:00,0,0:00:00,0,0
20150921-ccc_bylaw_script,2015/09/21,ccc_bylaw_script,0,0,0:00:00,0,0:00:00,0,0
20150921-ccc_city_script,2015/09/21,ccc_city_script,15,15,0:00:21,21,0:01:06,0,315
20150921-ccc_cty_online_script,2015/09/21,ccc_cty_online_script,0,0,0:00:00,0,0:00:00,0,0
20150921-ccc_feedback_script,2015/09/21,ccc_feedback_script,0,0,0:00:00,0,0:00:00,0,0
20150921-ccc_fpb_script,2015/09/21,ccc_fpb_script,0,0,0:00:00,0,0:00:00,0,0
20150921-ccc_help_script,2015/09/21,ccc_help_script,15,15,0:00:11,11,0:01:07,0,165
20150921-ccc_link_script,2015/09/21,ccc_link_script,0,0,0:00:00,0,0:00:00,0,0
20150921-ccc_media_line_script,2015/09/21,ccc_media_line_script,0,0,0:00:00,0,0:00:00,0,0
20150921-ccc_priority_script,2015/09/21,ccc_priority_script,22,22,0:00:08,8,0:00:36,0,176
20150921-ccc_tax_script,2015/09/21,ccc_tax_script,9,8,0:00:33,33,0:02:30,1,264
20150921-ccc_waste_recycling_script,2015/09/21,ccc_waste_recycling_script,0,0,0:00:00,0,0:00:00,0,0
20150922-ccc_311_calgary_script,2015/09/22,ccc_311_calgary_script,3467,3311,0:00:34,34,0:06:23,156,112574
20150922-ccc_311_lobby_ph_script,2015/09/22,ccc_311_lobby_ph_script,10,10,0:00:11,11,0:00:25,0,110
20150922-ccc_aserv_info_script,2015/09/22,ccc_aserv_info_script,0,0,0:00:00,0,0:00:00,0,0
20150922-ccc_bylaw_script,2015/09/22,ccc_bylaw_script,0,0,0:00:00,0,0:00:00,0,0
20150922-ccc_city_script,2015/09/22,ccc_city_script,11,11,0:00:06,6,0:00:24,0,66
20150922-ccc_cty_online_script,2015/09/22,ccc_cty_online_script,0,0,0:00:00,0,0:00:00,0,0
20150922-ccc_feedback_script,2015/09/22,ccc_feedback_script,1,0,0:00:00,0,0:00:00,0,0
20150922-ccc_fpb_script,2015/09/22,ccc_fpb_script,0,0,0:00:00,0,0:00:00,0,0
20150922-ccc_help_script,2015/09/22,ccc_help_script,8,8,0:00:11,11,0:00:34,0,88
20150922-ccc_link_script,2015/09/22,ccc_link_script,0,0,0:00:00,0,0:00:00,0,0
20150922-ccc_media_line_script,2015/09/22,ccc_media_line_script,0,0,0:00:00,0,0:00:00,0,0
20150922-ccc_priority_script,2015/09/22,ccc_priority_script,26,25,0:00:07,7,0:00:37,1,175
20150922-ccc_tax_script,2015/09/22,ccc_tax_script,13,13,0:00:36,36,0:03:48,0,468
20150922-ccc_waste_recycling_script,2015/09/22,ccc_waste_recycling_script,0,0,0:00:00,0,0:00:00,0,0
20150923-ccc_311_calgary_script,2015/09/23,ccc_311_calgary_script,3611,3230,0:01:15,75,0:13:50,381,242250
20150923-ccc_311_lobby_ph_script,2015/09/23,ccc_311_lobby_ph_script,5,4,0:00:12,12,0:00:16,1,48
20150923-ccc_aserv_info_script,2015/09/23,ccc_aserv_info_script,0,0,0:00:00,0,0:00:00,0,0
20150923-ccc_bylaw_script,2015/09/23,ccc_bylaw_script,0,0,0:00:00,0,0:00:00,0,0
20150923-ccc_city_script,2015/09/23,ccc_city_script,22,22,0:00:15,15,0:01:25,0,330
20150923-ccc_cty_online_script,2015/09/23,ccc_cty_online_script,0,0,0:00:00,0,0:00:00,0,0
20150923-ccc_feedback_script,2015/09/23,ccc_feedback_script,0,0,0:00:00,0,0:00:00,0,0
20150923-ccc_fpb_script,2015/09/23,ccc_fpb_script,0,0,0:00:00,0,0:00:00,0,0
20150923-ccc_help_script,2015/09/23,ccc_help_script,7,5,0:00:15,15,0:00:34,2,75
20150923-ccc_link_script,2015/09/23,ccc_link_script,0,0,0:00:00,0,0:00:00,0,0
20150923-ccc_media_line_script,2015/09/23,ccc_media_line_script,1,1,0:00:04,4,0:00:04,0,4
20150923-ccc_priority_script,2015/09/23,ccc_priority_script,17,17,0:00:16,16,0:01:18,0,272
20150923-ccc_tax_script,2015/09/23,ccc_tax_script,20,18,0:01:03,63,0:03:26,2,1134
20150923-ccc_waste_recycling_script,2015/09/23,ccc_waste_recycling_script,0,0,0:00:00,0,0:00:00,0,0
20150924-ccc_311_calgary_script,2015/09/24,ccc_311_calgary_script,3611,3230,0:01:15,75,0:13:50,381,242250
20150924-ccc_311_lobby_ph_script,2015/09/24,ccc_311_lobby_ph_script,5,4,0:00:12,12,0:00:16,1,48
20150924-ccc_aserv_info_script,2015/09/24,ccc_aserv_info_script,0,0,0:00:00,0,0:00:00,0,0
20150924-ccc_bylaw_script,2015/09/24,ccc_bylaw_script,0,0,0:00:00,0,0:00:00,0,0
20150924-ccc_city_script,2015/09/24,ccc_city_script,22,22,0:00:15,15,0:01:25,0,330
20150924-ccc_cty_online_script,2015/09/24,ccc_cty_online_script,0,0,0:00:00,0,0:00:00,0,0
20150924-ccc_feedback_script,2015/09/24,ccc_feedback_script,0,0,0:00:00,0,0:00:00,0,0
20150924-ccc_fpb_script,2015/09/24,ccc_fpb_script,0,0,0:00:00,0,0:00:00,0,0
20150924-ccc_help_script,2015/09/24,ccc_help_script,7,5,0:00:15,15,0:00:34,2,75
20150924-ccc_link_script,2015/09/24,ccc_link_script,0,0,0:00:00,0,0:00:00,0,0
20150924-ccc_media_line_script,2015/09/24,ccc_media_line_script,1,1,0:00:04,4,0:00:04,0,4
20150924-ccc_priority_script,2015/09/24,ccc_priority_script,17,17,0:00:16,16,0:01:18,0,272
20150924-ccc_tax_script,2015/09/24,ccc_tax_script,20,18,0:01:03,63,0:03:26,2,1134
20150924-ccc_waste_recycling_script,2015/09/24,ccc_waste_recycling_script,0,0,0:00:00,0,0:00:00,0,0
20150925-ccc_311_calgary_script,2015/09/25,ccc_311_calgary_script,3611,3230,0:01:15,75,0:13:50,381,242250
20150925-ccc_311_lobby_ph_script,2015/09/25,ccc_311_lobby_ph_script,5,4,0:00:12,12,0:00:16,1,48
20150925-ccc_aserv_info_script,2015/09/25,ccc_aserv_info_script,0,0,0:00:00,0,0:00:00,0,0
20150925-ccc_bylaw_script,2015/09/25,ccc_bylaw_script,0,0,0:00:00,0,0:00:00,0,0
20150925-ccc_city_script,2015/09/25,ccc_city_script,22,22,0:00:15,15,0:01:25,0,330
20150925-ccc_cty_online_script,2015/09/25,ccc_cty_online_script,0,0,0:00:00,0,0:00:00,0,0
20150925-ccc_feedback_script,2015/09/25,ccc_feedback_script,0,0,0:00:00,0,0:00:00,0,0
20150925-ccc_fpb_script,2015/09/25,ccc_fpb_script,0,0,0:00:00,0,0:00:00,0,0
20150925-ccc_help_script,2015/09/25,ccc_help_script,7,5,0:00:15,15,0:00:34,2,75
20150925-ccc_link_script,2015/09/25,ccc_link_script,0,0,0:00:00,0,0:00:00,0,0
20150925-ccc_media_line_script,2015/09/25,ccc_media_line_script,1,1,0:00:04,4,0:00:04,0,4
20150925-ccc_priority_script,2015/09/25,ccc_priority_script,17,17,0:00:16,16,0:01:18,0,272
20150925-ccc_tax_script,2015/09/25,ccc_tax_script,20,18,0:01:03,63,0:03:26,2,1134
20150925-ccc_waste_recycling_script,2015/09/25,ccc_waste_recycling_script,0,0,0:00:00,0,0:00:00,0,0
20150926-ccc_311_calgary_script,2015/09/26,ccc_311_calgary_script,3611,3230,0:01:15,75,0:13:50,381,242250
20150926-ccc_311_lobby_ph_script,2015/09/26,ccc_311_lobby_ph_script,5,4,0:00:12,12,0:00:16,1,48
20150926-ccc_aserv_info_script,2015/09/26,ccc_aserv_info_script,0,0,0:00:00,0,0:00:00,0,0
20150926-ccc_bylaw_script,2015/09/26,ccc_bylaw_script,0,0,0:00:00,0,0:00:00,0,0
20150926-ccc_city_script,2015/09/26,ccc_city_script,22,22,0:00:15,15,0:01:25,0,330
20150926-ccc_cty_online_script,2015/09/26,ccc_cty_online_script,0,0,0:00:00,0,0:00:00,0,0
20150926-ccc_feedback_script,2015/09/26,ccc_feedback_script,0,0,0:00:00,0,0:00:00,0,0
20150926-ccc_fpb_script,2015/09/26,ccc_fpb_script,0,0,0:00:00,0,0:00:00,0,0
20150926-ccc_help_script,2015/09/26,ccc_help_script,7,5,0:00:15,15,0:00:34,2,75
20150926-ccc_link_script,2015/09/26,ccc_link_script,0,0,0:00:00,0,0:00:00,0,0
20150926-ccc_media_line_script,2015/09/26,ccc_media_line_script,1,1,0:00:04,4,0:00:04,0,4
20150926-ccc_priority_script,2015/09/26,ccc_priority_script,17,17,0:00:16,16,0:01:18,0,272
20150926-ccc_tax_script,2015/09/26,ccc_tax_script,20,18,0:01:03,63,0:03:26,2,1134
20150926-ccc_waste_recycling_script,2015/09/26,ccc_waste_recycling_script,0,0,0:00:00,0,0:00:00,0,0
20150927-ccc_311_calgary_script,2015/09/27,ccc_311_calgary_script,966,923,0:00:27,27,0:08:21,43,24921
20150927-ccc_311_lobby_ph_script,2015/09/27,ccc_311_lobby_ph_script,0,0,0:00:00,0,0:00:00,0,0
20150927-ccc_aserv_info_script,2015/09/27,ccc_aserv_info_script,0,0,0:00:00,0,0:00:00,0,0
20150927-ccc_bylaw_script,2015/09/27,ccc_bylaw_script,0,0,0:00:00,0,0:00:00,0,0
20150927-ccc_city_script,2015/09/27,ccc_city_script,0,0,0:00:00,0,0:00:00,0,0
20150927-ccc_cty_online_script,2015/09/27,ccc_cty_online_script,0,0,0:00:00,0,0:00:00,0,0
20150927-ccc_feedback_script,2015/09/27,ccc_feedback_script,1,0,0:00:00,0,0:00:00,0,0
20150927-ccc_fpb_script,2015/09/27,ccc_fpb_script,0,0,0:00:00,0,0:00:00,0,0
20150927-ccc_help_script,2015/09/27,ccc_help_script,1,1,0:00:03,3,0:00:03,0,3
20150927-ccc_link_script,2015/09/27,ccc_link_script,0,0,0:00:00,0,0:00:00,0,0
20150927-ccc_media_line_script,2015/09/27,ccc_media_line_script,0,0,0:00:00,0,0:00:00,0,0
20150927-ccc_priority_script,2015/09/27,ccc_priority_script,24,23,0:00:17,17,0:02:04,1,391
20150927-ccc_tax_script,2015/09/27,ccc_tax_script,0,0,0:00:00,0,0:00:00,0,0
20150927-ccc_waste_recycling_script,2015/09/27,ccc_waste_recycling_script,0,0,0:00:00,0,0:00:00,0,0
20150928-ccc_311_calgary_script,2015/09/28,ccc_311_calgary_script,3743,3387,0:01:16,76,0:07:39,356,257412
20150928-ccc_311_lobby_ph_script,2015/09/28,ccc_311_lobby_ph_script,4,4,0:00:05,5,0:00:07,0,20
20150928-ccc_aserv_info_script,2015/09/28,ccc_aserv_info_script,0,0,0:00:00,0,0:00:00,0,0
20150928-ccc_bylaw_script,2015/09/28,ccc_bylaw_script,0,0,0:00:00,0,0:00:00,0,0
20150928-ccc_city_script,2015/09/28,ccc_city_script,32,29,0:00:09,9,0:00:55,3,261
20150928-ccc_cty_online_script,2015/09/28,ccc_cty_online_script,0,0,0:00:00,0,0:00:00,0,0
20150928-ccc_feedback_script,2015/09/28,ccc_feedback_script,0,0,0:00:00,0,0:00:00,0,0
20150928-ccc_fpb_script,2015/09/28,ccc_fpb_script,0,0,0:00:00,0,0:00:00,0,0
20150928-ccc_help_script,2015/09/28,ccc_help_script,8,6,0:00:19,19,0:01:26,2,114
20150928-ccc_link_script,2015/09/28,ccc_link_script,0,0,0:00:00,0,0:00:00,0,0
20150928-ccc_media_line_script,2015/09/28,ccc_media_line_script,1,1,0:00:12,12,0:00:12,0,12
20150928-ccc_priority_script,2015/09/28,ccc_priority_script,24,24,0:00:16,16,0:00:59,0,384
20150928-ccc_tax_script,2015/09/28,ccc_tax_script,17,17,0:00:40,40,0:04:22,0,680
20150928-ccc_waste_recycling_script,2015/09/28,ccc_waste_recycling_script,0,0,0:00:00,0,0:00:00,0,0
20150929-ccc_311_calgary_script,2015/09/29,ccc_311_calgary_script,3557,3123,0:01:47,107,0:09:17,434,334161
20150929-ccc_311_lobby_ph_script,2015/09/29,ccc_311_lobby_ph_script,4,3,0:00:04,4,0:00:07,1,12
20150929-ccc_aserv_info_script,2015/09/29,ccc_aserv_info_script,0,0,0:00:00,0,0:00:00,0,0
20150929-ccc_bylaw_script,2015/09/29,ccc_bylaw_script,0,0,0:00:00,0,0:00:00,0,0
20150929-ccc_city_script,2015/09/29,ccc_city_script,18,18,0:01:00,60,0:06:19,0,1080
20150929-ccc_cty_online_script,2015/09/29,ccc_cty_online_script,0,0,0:00:00,0,0:00:00,0,0
20150929-ccc_feedback_script,2015/09/29,ccc_feedback_script,1,0,0:00:00,0,0:00:00,0,0
20150929-ccc_fpb_script,2015/09/29,ccc_fpb_script,0,0,0:00:00,0,0:00:00,0,0
20150929-ccc_help_script,2015/09/29,ccc_help_script,13,13,0:00:07,7,0:00:21,0,91
20150929-ccc_link_script,2015/09/29,ccc_link_script,1,0,0:00:00,0,0:00:00,0,0
20150929-ccc_media_line_script,2015/09/29,ccc_media_line_script,0,0,0:00:00,0,0:00:00,0,0
20150929-ccc_priority_script,2015/09/29,ccc_priority_script,23,23,0:00:10,10,0:00:39,0,230
20150929-ccc_tax_script,2015/09/29,ccc_tax_script,22,20,0:02:49,169,0:08:23,2,3380
20150929-ccc_waste_recycling_script,2015/09/29,ccc_waste_recycling_script,0,0,0:00:00,0,0:00:00,0,0
20150930-ccc_311_calgary_script,2015/09/30,ccc_311_calgary_script,3785,2977,0:03:04,184,0:10:57,808,547768
20150930-ccc_311_lobby_ph_script,2015/09/30,ccc_311_lobby_ph_script,7,6,0:00:17,17,0:00:30,1,102
20150930-ccc_aserv_info_script,2015/09/30,ccc_aserv_info_script,0,0,0:00:00,0,0:00:00,0,0
20150930-ccc_bylaw_script,2015/09/30,ccc_bylaw_script,0,0,0:00:00,0,0:00:00,0,0
20150930-ccc_city_script,2015/09/30,ccc_city_script,29,25,0:00:49,49,0:07:07,4,1225
20150930-ccc_cty_online_script,2015/09/30,ccc_cty_online_script,0,0,0:00:00,0,0:00:00,0,0
20150930-ccc_feedback_script,2015/09/30,ccc_feedback_script,0,0,0:00:00,0,0:00:00,0,0
20150930-ccc_fpb_script,2015/09/30,ccc_fpb_script,0,0,0:00:00,0,0:00:00,0,0
20150930-ccc_help_script,2015/09/30,ccc_help_script,8,8,0:00:11,11,0:00:39,0,88
20150930-ccc_link_script,2015/09/30,ccc_link_script,0,0,0:00:00,0,0:00:00,0,0
20150930-ccc_media_line_script,2015/09/30,ccc_media_line_script,0,0,0:00:00,0,0:00:00,0,0
20150930-ccc_priority_script,2015/09/30,ccc_priority_script,40,39,0:00:18,18,0:01:30,1,702
20150930-ccc_tax_script,2015/09/30,ccc_tax_script,14,9,0:03:59,239,0:07:32,5,2151
20150930-ccc_waste_recycling_script,2015/09/30,ccc_waste_recycling_script,0,0,0:00:00,0,0:00:00,0,0
20151001-ccc_311_calgary_script,2015/10/01,ccc_311_calgary_script,3607,2979,0:02:37,157,0:10:31,627,467703
20151001-ccc_311_lobby_ph_script,2015/10/01,ccc_311_lobby_ph_script,3,3,0:00:14,14,0:00:21,0,42
20151001-ccc_aserv_info_script,2015/10/01,ccc_aserv_info_script,0,0,0:00:00,0,0:00:00,0,0
20151001-ccc_bylaw_script,2015/10/01,ccc_bylaw_script,0,0,0:00:00,0,0:00:00,0,0
20151001-ccc_city_script,2015/10/01,ccc_city_script,22,20,0:01:07,67,0:05:51,2,1340
20151001-ccc_cty_online_script,2015/10/01,ccc_cty_online_script,0,0,0:00:00,0,0:00:00,0,0
20151001-ccc_feedback_script,2015/10/01,ccc_feedback_script,0,0,0:00:00,0,0:00:00,0,0
20151001-ccc_fpb_script,2015/10/01,ccc_fpb_script,0,0,0:00:00,0,0:00:00,0,0
20151001-ccc_help_script,2015/10/01,ccc_help_script,10,10,0:00:10,10,0:00:26,0,100
20151001-ccc_link_script,2015/10/01,ccc_link_script,0,0,0:00:00,0,0:00:00,0,0
20151001-ccc_media_line_script,2015/10/01,ccc_media_line_script,0,0,0:00:00,0,0:00:00,0,0
20151001-ccc_priority_script,2015/10/01,ccc_priority_script,27,26,0:00:21,21,0:02:58,1,546
20151001-ccc_tax_script,2015/10/01,ccc_tax_script,13,10,0:03:04,184,0:05:41,3,1840
20151001-ccc_waste_recycling_script,2015/10/01,ccc_waste_recycling_script,0,0,0:00:00,0,0:00:00,0,0
20151002-ccc_311_calgary_script,2015/10/02,ccc_311_calgary_script,3651,3000,0:02:47,167,0:13:09,652,501000
20151002-ccc_311_lobby_ph_script,2015/10/02,ccc_311_lobby_ph_script,4,3,0:00:18,18,0:00:25,1,54
20151002-ccc_aserv_info_script,2015/10/02,ccc_aserv_info_script,0,0,0:00:00,0,0:00:00,0,0
20151002-ccc_bylaw_script,2015/10/02,ccc_bylaw_script,0,0,0:00:00,0,0:00:00,0,0
20151002-ccc_city_script,2015/10/02,ccc_city_script,22,21,0:01:24,84,0:06:20,1,1764
20151002-ccc_cty_online_script,2015/10/02,ccc_cty_online_script,0,0,0:00:00,0,0:00:00,0,0
20151002-ccc_feedback_script,2015/10/02,ccc_feedback_script,0,0,0:00:00,0,0:00:00,0,0
20151002-ccc_fpb_script,2015/10/02,ccc_fpb_script,0,0,0:00:00,0,0:00:00,0,0
20151002-ccc_help_script,2015/10/02,ccc_help_script,5,5,0:00:12,12,0:00:29,0,60
20151002-ccc_link_script,2015/10/02,ccc_link_script,0,0,0:00:00,0,0:00:00,0,0
20151002-ccc_media_line_script,2015/10/02,ccc_media_line_script,0,0,0:00:00,0,0:00:00,0,0
20151002-ccc_priority_script,2015/10/02,ccc_priority_script,45,43,0:00:20,20,0:01:28,2,860
20151002-ccc_tax_script,2015/10/02,ccc_tax_script,26,21,0:02:46,166,0:08:11,5,3486
20151002-ccc_waste_recycling_script,2015/10/02,ccc_waste_recycling_script,0,0,0:00:00,0,0:00:00,0,0
20151003-ccc_311_calgary_script,2015/10/03,ccc_311_calgary_script,1063,1014,0:00:28,28,0:07:52,49,28392
20151003-ccc_311_lobby_ph_script,2015/10/03,ccc_311_lobby_ph_script,0,0,0:00:00,0,0:00:00,0,0
20151003-ccc_aserv_info_script,2015/10/03,ccc_aserv_info_script,0,0,0:00:00,0,0:00:00,0,0
20151003-ccc_bylaw_script,2015/10/03,ccc_bylaw_script,0,0,0:00:00,0,0:00:00,0,0
20151003-ccc_city_script,2015/10/03,ccc_city_script,0,0,0:00:00,0,0:00:00,0,0
20151003-ccc_cty_online_script,2015/10/03,ccc_cty_online_script,0,0,0:00:00,0,0:00:00,0,0
20151003-ccc_feedback_script,2015/10/03,ccc_feedback_script,0,0,0:00:00,0,0:00:00,0,0
20151003-ccc_fpb_script,2015/10/03,ccc_fpb_script,0,0,0:00:00,0,0:00:00,0,0
20151003-ccc_help_script,2015/10/03,ccc_help_script,4,3,0:00:10,10,0:00:22,1,30
20151003-ccc_link_script,2015/10/03,ccc_link_script,0,0,0:00:00,0,0:00:00,0,0
20151003-ccc_media_line_script,2015/10/03,ccc_media_line_script,1,1,0:00:05,5,0:00:05,0,5
20151003-ccc_priority_script,2015/10/03,ccc_priority_script,36,33,0:00:22,22,0:02:46,3,726
20151003-ccc_tax_script,2015/10/03,ccc_tax_script,4,4,0:00:19,19,0:00:48,0,76
20151003-ccc_waste_recycling_script,2015/10/03,ccc_waste_recycling_script,0,0,0:00:00,0,0:00:00,0,0
20151004-ccc_311_calgary_script,2015/10/04,ccc_311_calgary_script,984,952,0:00:18,18,0:06:05,32,17136
20151004-ccc_311_lobby_ph_script,2015/10/04,ccc_311_lobby_ph_script,0,0,0:00:00,0,0:00:00,0,0
20151004-ccc_aserv_info_script,2015/10/04,ccc_aserv_info_script,0,0,0:00:00,0,0:00:00,0,0
20151004-ccc_bylaw_script,2015/10/04,ccc_bylaw_script,0,0,0:00:00,0,0:00:00,0,0
20151004-ccc_city_script,2015/10/04,ccc_city_script,0,0,0:00:00,0,0:00:00,0,0
20151004-ccc_cty_online_script,2015/10/04,ccc_cty_online_script,0,0,0:00:00,0,0:00:00,0,0
20151004-ccc_feedback_script,2015/10/04,ccc_feedback_script,0,0,0:00:00,0,0:00:00,0,0
20151004-ccc_fpb_script,2015/10/04,ccc_fpb_script,0,0,0:00:00,0,0:00:00,0,0
20151004-ccc_help_script,2015/10/04,ccc_help_script,1,1,0:00:04,4,0:00:04,0,4
20151004-ccc_link_script,2015/10/04,ccc_link_script,0,0,0:00:00,0,0:00:00,0,0
20151004-ccc_media_line_script,2015/10/04,ccc_media_line_script,2,1,0:00:07,7,0:00:07,1,7
20151004-ccc_priority_script,2015/10/04,ccc_priority_script,31,28,0:00:22,22,0:03:08,3,616
20151004-ccc_tax_script,2015/10/04,ccc_tax_script,3,3,0:00:08,8,0:00:13,0,24
20151004-ccc_waste_recycling_script,2015/10/04,ccc_waste_recycling_script,0,0,0:00:00,0,0:00:00,0,0
20151005-ccc_311_calgary_script,2015/10/05,ccc_311_calgary_script,3640,3490,0:00:30,30,0:05:54,150,104700
20151005-ccc_311_lobby_ph_script,2015/10/05,ccc_311_lobby_ph_script,3,2,0:00:04,4,0:00:04,1,8
20151005-ccc_aserv_info_script,2015/10/05,ccc_aserv_info_script,0,0,0:00:00,0,0:00:00,0,0
20151005-ccc_bylaw_script,2015/10/05,ccc_bylaw_script,0,0,0:00:00,0,0:00:00,0,0
20151005-ccc_city_script,2015/10/05,ccc_city_script,14,14,0:00:11,11,0:00:42,0,154
20151005-ccc_cty_online_script,2015/10/05,ccc_cty_online_script,0,0,0:00:00,0,0:00:00,0,0
20151005-ccc_feedback_script,2015/10/05,ccc_feedback_script,0,0,0:00:00,0,0:00:00,0,0
20151005-ccc_fpb_script,2015/10/05,ccc_fpb_script,0,0,0:00:00,0,0:00:00,0,0
20151005-ccc_help_script,2015/10/05,ccc_help_script,3,3,0:00:04,4,0:00:07,0,12
20151005-ccc_link_script,2015/10/05,ccc_link_script,0,0,0:00:00,0,0:00:00,0,0
20151005-ccc_media_line_script,2015/10/05,ccc_media_line_script,1,1,0:00:08,8,0:00:08,0,8
20151005-ccc_priority_script,2015/10/05,ccc_priority_script,25,24,0:00:09,9,0:00:27,1,216
20151005-ccc_tax_script,2015/10/05,ccc_tax_script,22,22,0:00:25,25,0:01:07,0,550
20151005-ccc_waste_recycling_script,2015/10/05,ccc_waste_recycling_script,0,0,0:00:00,0,0:00:00,0,0
20151006-ccc_311_calgary_script,2015/10/06,ccc_311_calgary_script,3495,2875,0:03:03,183,0:10:14,620,526125
20151006-ccc_311_lobby_ph_script,2015/10/06,ccc_311_lobby_ph_script,3,3,0:00:10,10,0:00:19,0,30
20151006-ccc_aserv_info_script,2015/10/06,ccc_aserv_info_script,0,0,0:00:00,0,0:00:00,0,0
20151006-ccc_bylaw_script,2015/10/06,ccc_bylaw_script,0,0,0:00:00,0,0:00:00,0,0
20151006-ccc_city_script,2015/10/06,ccc_city_script,14,14,0:00:42,42,0:02:07,0,588
20151006-ccc_cty_online_script,2015/10/06,ccc_cty_online_script,0,0,0:00:00,0,0:00:00,0,0
20151006-ccc_feedback_script,2015/10/06,ccc_feedback_script,1,0,0:00:00,0,0:00:00,0,0
20151006-ccc_fpb_script,2015/10/06,ccc_fpb_script,0,0,0:00:00,0,0:00:00,0,0
20151006-ccc_help_script,2015/10/06,ccc_help_script,11,11,0:00:10,10,0:00:28,0,110
20151006-ccc_link_script,2015/10/06,ccc_link_script,0,0,0:00:00,0,0:00:00,0,0
20151006-ccc_media_line_script,2015/10/06,ccc_media_line_script,1,1,0:00:09,9,0:00:09,0,9
20151006-ccc_priority_script,2015/10/06,ccc_priority_script,48,46,0:00:20,20,0:02:00,2,920
20151006-ccc_tax_script,2015/10/06,ccc_tax_script,22,16,0:03:31,211,0:06:59,6,3376
20151006-ccc_waste_recycling_script,2015/10/06,ccc_waste_recycling_script,0,0,0:00:00,0,0:00:00,0,0
20151007-ccc_311_calgary_script,2015/10/07,ccc_311_calgary_script,3477,3245,0:00:53,53,0:08:03,232,171985
20151007-ccc_311_lobby_ph_script,2015/10/07,ccc_311_lobby_ph_script,5,5,0:00:05,5,0:00:07,0,25
20151007-ccc_aserv_info_script,2015/10/07,ccc_aserv_info_script,0,0,0:00:00,0,0:00:00,0,0
20151007-ccc_bylaw_script,2015/10/07,ccc_bylaw_script,0,0,0:00:00,0,0:00:00,0,0
20151007-ccc_city_script,2015/10/07,ccc_city_script,9,9,0:00:08,8,0:00:31,0,72
20151007-ccc_cty_online_script,2015/10/07,ccc_cty_online_script,0,0,0:00:00,0,0:00:00,0,0
20151007-ccc_feedback_script,2015/10/07,ccc_feedback_script,0,0,0:00:00,0,0:00:00,0,0
20151007-ccc_fpb_script,2015/10/07,ccc_fpb_script,1,0,0:00:00,0,0:00:00,1,0
20151007-ccc_help_script,2015/10/07,ccc_help_script,9,8,0:00:08,8,0:00:15,1,64
20151007-ccc_link_script,2015/10/07,ccc_link_script,0,0,0:00:00,0,0:00:00,0,0
20151007-ccc_media_line_script,2015/10/07,ccc_media_line_script,1,1,0:00:05,5,0:00:05,0,5
20151007-ccc_priority_script,2015/10/07,ccc_priority_script,32,30,0:00:16,16,0:01:35,2,480
20151007-ccc_tax_script,2015/10/07,ccc_tax_script,16,16,0:00:55,55,0:05:16,0,880
20151007-ccc_waste_recycling_script,2015/10/07,ccc_waste_recycling_script,0,0,0:00:00,0,0:00:00,0,0
20151008-ccc_311_calgary_script,2015/10/08,ccc_311_calgary_script,3292,2764,0:02:13,133,0:13:01,528,367612
20151008-ccc_311_lobby_ph_script,2015/10/08,ccc_311_lobby_ph_script,4,2,0:00:10,10,0:00:14,2,20
20151008-ccc_aserv_info_script,2015/10/08,ccc_aserv_info_script,0,0,0:00:00,0,0:00:00,0,0
20151008-ccc_bylaw_script,2015/10/08,ccc_bylaw_script,0,0,0:00:00,0,0:00:00,0,0
20151008-ccc_city_script,2015/10/08,ccc_city_script,18,15,0:00:24,24,0:01:37,3,360
20151008-ccc_cty_online_script,2015/10/08,ccc_cty_online_script,0,0,0:00:00,0,0:00:00,0,0
20151008-ccc_feedback_script,2015/10/08,ccc_feedback_script,0,0,0:00:00,0,0:00:00,0,0
20151008-ccc_fpb_script,2015/10/08,ccc_fpb_script,0,0,0:00:00,0,0:00:00,0,0
20151008-ccc_help_script,2015/10/08,ccc_help_script,14,13,0:00:22,22,0:01:02,1,286
20151008-ccc_link_script,2015/10/08,ccc_link_script,0,0,0:00:00,0,0:00:00,0,0
20151008-ccc_media_line_script,2015/10/08,ccc_media_line_script,1,0,0:00:00,0,0:00:00,1,0
20151008-ccc_priority_script,2015/10/08,ccc_priority_script,22,21,0:00:13,13,0:00:53,1,273
20151008-ccc_tax_script,2015/10/08,ccc_tax_script,10,9,0:02:08,128,0:06:31,1,1152
20151008-ccc_waste_recycling_script,2015/10/08,ccc_waste_recycling_script,0,0,0:00:00,0,0:00:00,0,0
20151009-ccc_311_calgary_script,2015/10/09,ccc_311_calgary_script,3018,2767,0:01:18,78,0:06:58,251,215826
20151009-ccc_311_lobby_ph_script,2015/10/09,ccc_311_lobby_ph_script,1,1,0:00:12,12,0:00:12,0,12
20151009-ccc_aserv_info_script,2015/10/09,ccc_aserv_info_script,0,0,0:00:00,0,0:00:00,0,0
20151009-ccc_bylaw_script,2015/10/09,ccc_bylaw_script,0,0,0:00:00,0,0:00:00,0,0
20151009-ccc_city_script,2015/10/09,ccc_city_script,13,12,0:00:37,37,0:03:10,1,444
20151009-ccc_cty_online_script,2015/10/09,ccc_cty_online_script,0,0,0:00:00,0,0:00:00,0,0
20151009-ccc_feedback_script,2015/10/09,ccc_feedback_script,0,0,0:00:00,0,0:00:00,0,0
20151009-ccc_fpb_script,2015/10/09,ccc_fpb_script,2,0,0:00:00,0,0:00:00,2,0
20151009-ccc_help_script,2015/10/09,ccc_help_script,8,5,0:00:07,7,0:00:19,3,35
20151009-ccc_link_script,2015/10/09,ccc_link_script,0,0,0:00:00,0,0:00:00,0,0
20151009-ccc_media_line_script,2015/10/09,ccc_media_line_script,0,0,0:00:00,0,0:00:00,0,0
20151009-ccc_priority_script,2015/10/09,ccc_priority_script,27,27,0:00:12,12,0:00:37,0,324
20151009-ccc_tax_script,2015/10/09,ccc_tax_script,9,9,0:01:51,111,0:03:28,0,999
20151009-ccc_waste_recycling_script,2015/10/09,ccc_waste_recycling_script,0,0,0:00:00,0,0:00:00,0,0
20151010-ccc_311_calgary_script,2015/10/10,ccc_311_calgary_script,1179,1091,0:00:45,45,0:08:51,88,49095
20151010-ccc_311_lobby_ph_script,2015/10/10,ccc_311_lobby_ph_script,0,0,0:00:00,0,0:00:00,0,0
20151010-ccc_aserv_info_script,2015/10/10,ccc_aserv_info_script,0,0,0:00:00,0,0:00:00,0,0
20151010-ccc_bylaw_script,2015/10/10,ccc_bylaw_script,0,0,0:00:00,0,0:00:00,0,0
20151010-ccc_city_script,2015/10/10,ccc_city_script,0,0,0:00:00,0,0:00:00,0,0
20151010-ccc_cty_online_script,2015/10/10,ccc_cty_online_script,0,0,0:00:00,0,0:00:00,0,0
20151010-ccc_feedback_script,2015/10/10,ccc_feedback_script,0,0,0:00:00,0,0:00:00,0,0
20151010-ccc_fpb_script,2015/10/10,ccc_fpb_script,0,0,0:00:00,0,0:00:00,0,0
20151010-ccc_help_script,2015/10/10,ccc_help_script,0,0,0:00:00,0,0:00:00,0,0
20151010-ccc_link_script,2015/10/10,ccc_link_script,0,0,0:00:00,0,0:00:00,0,0
20151010-ccc_media_line_script,2015/10/10,ccc_media_line_script,0,0,0:00:00,0,0:00:00,0,0
20151010-ccc_priority_script,2015/10/10,ccc_priority_script,20,18,0:00:22,22,0:01:36,1,396
20151010-ccc_tax_script,2015/10/10,ccc_tax_script,0,0,0:00:00,0,0:00:00,0,0
20151010-ccc_waste_recycling_script,2015/10/10,ccc_waste_recycling_script,0,0,0:00:00,0,0:00:00,0,0
20151011-ccc_311_calgary_script,2015/10/11,ccc_311_calgary_script,455,437,0:00:27,27,0:04:25,18,11799
20151011-ccc_311_lobby_ph_script,2015/10/11,ccc_311_lobby_ph_script,0,0,0:00:00,0,0:00:00,0,0
20151011-ccc_aserv_info_script,2015/10/11,ccc_aserv_info_script,0,0,0:00:00,0,0:00:00,0,0
20151011-ccc_bylaw_script,2015/10/11,ccc_bylaw_script,0,0,0:00:00,0,0:00:00,0,0
20151011-ccc_city_script,2015/10/11,ccc_city_script,0,0,0:00:00,0,0:00:00,0,0
20151011-ccc_cty_online_script,2015/10/11,ccc_cty_online_script,0,0,0:00:00,0,0:00:00,0,0
20151011-ccc_feedback_script,2015/10/11,ccc_feedback_script,0,0,0:00:00,0,0:00:00,0,0
20151011-ccc_fpb_script,2015/10/11,ccc_fpb_script,0,0,0:00:00,0,0:00:00,0,0
20151011-ccc_help_script,2015/10/11,ccc_help_script,0,0,0:00:00,0,0:00:00,0,0
20151011-ccc_link_script,2015/10/11,ccc_link_script,0,0,0:00:00,0,0:00:00,0,0
20151011-ccc_media_line_script,2015/10/11,ccc_media_line_script,0,0,0:00:00,0,0:00:00,0,0
20151011-ccc_priority_script,2015/10/11,ccc_priority_script,16,16,0:00:09,9,0:00:26,1,144
20151011-ccc_tax_script,2015/10/11,ccc_tax_script,0,0,0:00:00,0,0:00:00,0,0
20151011-ccc_waste_recycling_script,2015/10/11,ccc_waste_recycling_script,0,0,0:00:00,0,0:00:00,0,0
20151012-ccc_311_calgary_script,2015/10/12,ccc_311_calgary_script,1020,1007,0:00:06,6,0:04:18,13,6042
20151012-ccc_311_lobby_ph_script,2015/10/12,ccc_311_lobby_ph_script,0,0,0:00:00,0,0:00:00,0,0
20151012-ccc_aserv_info_script,2015/10/12,ccc_aserv_info_script,0,0,0:00:00,0,0:00:00,0,0
20151012-ccc_bylaw_script,2015/10/12,ccc_bylaw_script,0,0,0:00:00,0,0:00:00,0,0
20151012-ccc_city_script,2015/10/12,ccc_city_script,0,0,0:00:00,0,0:00:00,0,0
20151012-ccc_cty_online_script,2015/10/12,ccc_cty_online_script,0,0,0:00:00,0,0:00:00,0,0
20151012-ccc_feedback_script,2015/10/12,ccc_feedback_script,0,0,0:00:00,0,0:00:00,0,0
20151012-ccc_fpb_script,2015/10/12,ccc_fpb_script,0,0,0:00:00,0,0:00:00,0,0
20151012-ccc_help_script,2015/10/12,ccc_help_script,2,2,0:00:04,4,0:00:05,0,8
20151012-ccc_link_script,2015/10/12,ccc_link_script,0,0,0:00:00,0,0:00:00,0,0
20151012-ccc_media_line_script,2015/10/12,ccc_media_line_script,1,1,0:00:06,6,0:00:06,0,6
20151012-ccc_priority_script,2015/10/12,ccc_priority_script,7,7,0:00:04,4,0:00:08,0,28
20151012-ccc_tax_script,2015/10/12,ccc_tax_script,0,0,0:00:00,0,0:00:00,0,0
20151012-ccc_waste_recycling_script,2015/10/12,ccc_waste_recycling_script,0,0,0:00:00,0,0:00:00,0,0
20151013-ccc_311_calgary_script,2015/10/13,ccc_311_calgary_script,3720,3344,0:01:46,106,0:07:52,376,354464
20151013-ccc_311_lobby_ph_script,2015/10/13,ccc_311_lobby_ph_script,6,5,0:00:10,10,0:00:22,1,50
20151013-ccc_aserv_info_script,2015/10/13,ccc_aserv_info_script,0,0,0:00:00,0,0:00:00,0,0
20151013-ccc_bylaw_script,2015/10/13,ccc_bylaw_script,0,0,0:00:00,0,0:00:00,0,0
20151013-ccc_city_script,2015/10/13,ccc_city_script,25,25,0:00:11,11,0:00:43,0,275
20151013-ccc_cty_online_script,2015/10/13,ccc_cty_online_script,0,0,0:00:00,0,0:00:00,0,0
20151013-ccc_feedback_script,2015/10/13,ccc_feedback_script,0,0,0:00:00,0,0:00:00,0,0
20151013-ccc_fpb_script,2015/10/13,ccc_fpb_script,0,0,0:00:00,0,0:00:00,0,0
20151013-ccc_help_script,2015/10/13,ccc_help_script,12,10,0:00:06,6,0:00:18,2,60
20151013-ccc_link_script,2015/10/13,ccc_link_script,0,0,0:00:00,0,0:00:00,0,0
20151013-ccc_media_line_script,2015/10/13,ccc_media_line_script,0,0,0:00:00,0,0:00:00,0,0
20151013-ccc_priority_script,2015/10/13,ccc_priority_script,31,28,0:00:09,9,0:00:21,3,252
20151013-ccc_tax_script,2015/10/13,ccc_tax_script,12,11,0:01:28,88,0:05:00,1,968
20151013-ccc_waste_recycling_script,2015/10/13,ccc_waste_recycling_script,0,0,0:00:00,0,0:00:00,0,0
20151014-ccc_311_calgary_script,2015/10/14,ccc_311_calgary_script,3365,3157,0:00:44,44,0:09:23,208,138908
20151014-ccc_311_lobby_ph_script,2015/10/14,ccc_311_lobby_ph_script,5,5,0:00:16,16,0:00:53,0,80
20151014-ccc_aserv_info_script,2015/10/14,ccc_aserv_info_script,0,0,0:00:00,0,0:00:00,0,0
20151014-ccc_bylaw_script,2015/10/14,ccc_bylaw_script,0,0,0:00:00,0,0:00:00,0,0
20151014-ccc_city_script,2015/10/14,ccc_city_script,14,14,0:00:11,11,0:00:47,0,154
20151014-ccc_cty_online_script,2015/10/14,ccc_cty_online_script,0,0,0:00:00,0,0:00:00,0,0
20151014-ccc_feedback_script,2015/10/14,ccc_feedback_script,1,0,0:00:00,0,0:00:00,0,0
20151014-ccc_fpb_script,2015/10/14,ccc_fpb_script,1,0,0:00:00,0,0:00:00,1,0
20151014-ccc_help_script,2015/10/14,ccc_help_script,9,6,0:00:13,13,0:00:31,3,78
20151014-ccc_link_script,2015/10/14,ccc_link_script,0,0,0:00:00,0,0:00:00,0,0
20151014-ccc_media_line_script,2015/10/14,ccc_media_line_script,0,0,0:00:00,0,0:00:00,0,0
20151014-ccc_priority_script,2015/10/14,ccc_priority_script,31,29,0:00:06,6,0:00:39,2,174
20151014-ccc_tax_script,2015/10/14,ccc_tax_script,15,14,0:01:13,73,0:03:56,1,1022
20151014-ccc_waste_recycling_script,2015/10/14,ccc_waste_recycling_script,0,0,0:00:00,0,0:00:00,0,0
20151015-ccc_311_calgary_script,2015/10/15,ccc_311_calgary_script,3296,2847,0:02:00,120,0:14:50,449,341640
20151015-ccc_311_lobby_ph_script,2015/10/15,ccc_311_lobby_ph_script,5,5,0:00:11,11,0:00:25,0,55
20151015-ccc_aserv_info_script,2015/10/15,ccc_aserv_info_script,0,0,0:00:00,0,0:00:00,0,0
20151015-ccc_bylaw_script,2015/10/15,ccc_bylaw_script,0,0,0:00:00,0,0:00:00,0,0
20151015-ccc_city_script,2015/10/15,ccc_city_script,26,25,0:00:19,19,0:01:44,1,475
20151015-ccc_cty_online_script,2015/10/15,ccc_cty_online_script,0,0,0:00:00,0,0:00:00,0,0
20151015-ccc_feedback_script,2015/10/15,ccc_feedback_script,0,0,0:00:00,0,0:00:00,0,0
20151015-ccc_fpb_script,2015/10/15,ccc_fpb_script,1,1,0:01:45,105,0:01:45,0,105
20151015-ccc_help_script,2015/10/15,ccc_help_script,11,9,0:00:09,9,0:00:29,2,81
20151015-ccc_link_script,2015/10/15,ccc_link_script,0,0,0:00:00,0,0:00:00,0,0
20151015-ccc_media_line_script,2015/10/15,ccc_media_line_script,5,5,0:00:33,33,0:01:15,0,165
20151015-ccc_priority_script,2015/10/15,ccc_priority_script,41,41,0:00:29,29,0:02:16,0,1189
20151015-ccc_tax_script,2015/10/15,ccc_tax_script,17,14,0:02:35,155,0:06:53,3,2170
20151015-ccc_waste_recycling_script,2015/10/15,ccc_waste_recycling_script,0,0,0:00:00,0,0:00:00,0,0
20151016-ccc_311_calgary_script,2015/10/16,ccc_311_calgary_script,3010,2779,0:01:11,71,0:08:04,231,197309
20151016-ccc_311_lobby_ph_script,2015/10/16,ccc_311_lobby_ph_script,4,1,0:00:01,1,0:00:01,3,1
20151016-ccc_aserv_info_script,2015/10/16,ccc_aserv_info_script,0,0,0:00:00,0,0:00:00,0,0
20151016-ccc_bylaw_script,2015/10/16,ccc_bylaw_script,0,0,0:00:00,0,0:00:00,0,0
20151016-ccc_city_script,2015/10/16,ccc_city_script,24,24,0:00:30,30,0:02:25,0,720
20151016-ccc_cty_online_script,2015/10/16,ccc_cty_online_script,0,0,0:00:00,0,0:00:00,0,0
20151016-ccc_feedback_script,2015/10/16,ccc_feedback_script,1,0,0:00:00,0,0:00:00,0,0
20151016-ccc_fpb_script,2015/10/16,ccc_fpb_script,0,0,0:00:00,0,0:00:00,0,0
20151016-ccc_help_script,2015/10/16,ccc_help_script,5,4,0:00:08,8,0:00:10,1,32
20151016-ccc_link_script,2015/10/16,ccc_link_script,1,0,0:00:00,0,0:00:00,0,0
20151016-ccc_media_line_script,2015/10/16,ccc_media_line_script,0,0,0:00:00,0,0:00:00,0,0
20151016-ccc_priority_script,2015/10/16,ccc_priority_script,24,22,0:00:18,18,0:00:55,2,396
20151016-ccc_tax_script,2015/10/16,ccc_tax_script,11,10,0:00:25,25,0:01:55,1,250
20151016-ccc_waste_recycling_script,2015/10/16,ccc_waste_recycling_script,0,0,0:00:00,0,0:00:00,0,0
20151017-ccc_311_calgary_script,2015/10/17,ccc_311_calgary_script,1241,1146,0:00:46,46,0:10:57,95,52716
20151017-ccc_311_lobby_ph_script,2015/10/17,ccc_311_lobby_ph_script,0,0,0:00:00,0,0:00:00,0,0
20151017-ccc_aserv_info_script,2015/10/17,ccc_aserv_info_script,0,0,0:00:00,0,0:00:00,0,0
20151017-ccc_bylaw_script,2015/10/17,ccc_bylaw_script,0,0,0:00:00,0,0:00:00,0,0
20151017-ccc_city_script,2015/10/17,ccc_city_script,0,0,0:00:00,0,0:00:00,0,0
20151017-ccc_cty_online_script,2015/10/17,ccc_cty_online_script,0,0,0:00:00,0,0:00:00,0,0
20151017-ccc_feedback_script,2015/10/17,ccc_feedback_script,0,0,0:00:00,0,0:00:00,0,0
20151017-ccc_fpb_script,2015/10/17,ccc_fpb_script,0,0,0:00:00,0,0:00:00,0,0
20151017-ccc_help_script,2015/10/17,ccc_help_script,0,0,0:00:00,0,0:00:00,0,0
20151017-ccc_link_script,2015/10/17,ccc_link_script,0,0,0:00:00,0,0:00:00,0,0
20151017-ccc_media_line_script,2015/10/17,ccc_media_line_script,4,4,0:00:06,6,0:00:12,0,24
20151017-ccc_priority_script,2015/10/17,ccc_priority_script,19,19,0:00:14,14,0:00:42,0,266
20151017-ccc_tax_script,2015/10/17,ccc_tax_script,1,1,0:00:03,3,0:00:03,0,3
20151017-ccc_waste_recycling_script,2015/10/17,ccc_waste_recycling_script,0,0,0:00:00,0,0:00:00,0,0
20151018-ccc_311_calgary_script,2015/10/18,ccc_311_calgary_script,978,933,0:00:27,27,0:06:26,45,25191
20151018-ccc_311_lobby_ph_script,2015/10/18,ccc_311_lobby_ph_script,0,0,0:00:00,0,0:00:00,0,0
20151018-ccc_aserv_info_script,2015/10/18,ccc_aserv_info_script,0,0,0:00:00,0,0:00:00,0,0
20151018-ccc_bylaw_script,2015/10/18,ccc_bylaw_script,0,0,0:00:00,0,0:00:00,0,0
20151018-ccc_city_script,2015/10/18,ccc_city_script,0,0,0:00:00,0,0:00:00,0,0
20151018-ccc_cty_online_script,2015/10/18,ccc_cty_online_script,0,0,0:00:00,0,0:00:00,0,0
20151018-ccc_feedback_script,2015/10/18,ccc_feedback_script,0,0,0:00:00,0,0:00:00,0,0
20151018-ccc_fpb_script,2015/10/18,ccc_fpb_script,0,0,0:00:00,0,0:00:00,0,0
20151018-ccc_help_script,2015/10/18,ccc_help_script,1,1,0:00:52,52,0:00:52,0,52
20151018-ccc_link_script,2015/10/18,ccc_link_script,0,0,0:00:00,0,0:00:00,0,0
20151018-ccc_media_line_script,2015/10/18,ccc_media_line_script,3,3,0:00:04,4,0:00:08,0,12
20151018-ccc_priority_script,2015/10/18,ccc_priority_script,25,24,0:00:17,17,0:01:32,1,408
20151018-ccc_tax_script,2015/10/18,ccc_tax_script,0,0,0:00:00,0,0:00:00,0,0
20151018-ccc_waste_recycling_script,2015/10/18,ccc_waste_recycling_script,0,0,0:00:00,0,0:00:00,0,0
20151019-ccc_311_calgary_script,2015/10/19,ccc_311_calgary_script,3496,3266,0:00:53,53,0:05:05,230,173098
20151019-ccc_311_lobby_ph_script,2015/10/19,ccc_311_lobby_ph_script,3,3,0:00:09,9,0:00:24,0,27
20151019-ccc_aserv_info_script,2015/10/19,ccc_aserv_info_script,0,0,0:00:00,0,0:00:00,0,0
20151019-ccc_bylaw_script,2015/10/19,ccc_bylaw_script,0,0,0:00:00,0,0:00:00,0,0
20151019-ccc_city_script,2015/10/19,ccc_city_script,20,20,0:00:10,10,0:00:23,0,200
20151019-ccc_cty_online_script,2015/10/19,ccc_cty_online_script,0,0,0:00:00,0,0:00:00,0,0
20151019-ccc_feedback_script,2015/10/19,ccc_feedback_script,0,0,0:00:00,0,0:00:00,0,0
20151019-ccc_fpb_script,2015/10/19,ccc_fpb_script,1,1,0:00:08,8,0:00:08,0,8
20151019-ccc_help_script,2015/10/19,ccc_help_script,4,3,0:00:04,4,0:00:05,1,12
20151019-ccc_link_script,2015/10/19,ccc_link_script,0,0,0:00:00,0,0:00:00,0,0
20151019-ccc_media_line_script,2015/10/19,ccc_media_line_script,0,0,0:00:00,0,0:00:00,0,0
20151019-ccc_priority_script,2015/10/19,ccc_priority_script,28,27,0:00:11,11,0:00:56,1,297
20151019-ccc_tax_script,2015/10/19,ccc_tax_script,18,18,0:00:45,45,0:02:09,0,810
20151019-ccc_waste_recycling_script,2015/10/19,ccc_waste_recycling_script,0,0,0:00:00,0,0:00:00,0,0
20151020-ccc_311_calgary_script,2015/10/20,ccc_311_calgary_script,3386,2783,0:02:57,177,0:09:05,603,492591
20151020-ccc_311_lobby_ph_script,2015/10/20,ccc_311_lobby_ph_script,5,3,0:00:13,13,0:00:20,2,39
20151020-ccc_aserv_info_script,2015/10/20,ccc_aserv_info_script,0,0,0:00:00,0,0:00:00,0,0
20151020-ccc_bylaw_script,2015/10/20,ccc_bylaw_script,0,0,0:00:00,0,0:00:00,0,0
20151020-ccc_city_script,2015/10/20,ccc_city_script,10,10,0:00:35,35,0:02:44,0,350
20151020-ccc_cty_online_script,2015/10/20,ccc_cty_online_script,0,0,0:00:00,0,0:00:00,0,0
20151020-ccc_feedback_script,2015/10/20,ccc_feedback_script,0,0,0:00:00,0,0:00:00,0,0
20151020-ccc_fpb_script,2015/10/20,ccc_fpb_script,3,0,0:00:00,0,0:00:00,3,0
20151020-ccc_help_script,2015/10/20,ccc_help_script,9,9,0:00:15,15,0:00:36,0,135
20151020-ccc_link_script,2015/10/20,ccc_link_script,0,0,0:00:00,0,0:00:00,0,0
20151020-ccc_media_line_script,2015/10/20,ccc_media_line_script,1,1,0:00:23,23,0:00:23,0,23
20151020-ccc_priority_script,2015/10/20,ccc_priority_script,31,30,0:00:18,18,0:01:16,1,540
20151020-ccc_tax_script,2015/10/20,ccc_tax_script,19,13,0:03:51,231,0:07:02,6,3003
20151020-ccc_waste_recycling_script,2015/10/20,ccc_waste_recycling_script,0,0,0:00:00,0,0:00:00,0,0
20151021-ccc_311_calgary_script,2015/10/21,ccc_311_calgary_script,3566,2910,0:02:53,173,0:10:47,656,503430
20151021-ccc_311_lobby_ph_script,2015/10/21,ccc_311_lobby_ph_script,2,2,0:00:12,12,0:00:18,0,24
20151021-ccc_aserv_info_script,2015/10/21,ccc_aserv_info_script,0,0,0:00:00,0,0:00:00,0,0
20151021-ccc_bylaw_script,2015/10/21,ccc_bylaw_script,0,0,0:00:00,0,0:00:00,0,0
20151021-ccc_city_script,2015/10/21,ccc_city_script,12,12,0:00:57,57,0:05:16,0,684
20151021-ccc_cty_online_script,2015/10/21,ccc_cty_online_script,0,0,0:00:00,0,0:00:00,0,0
20151021-ccc_feedback_script,2015/10/21,ccc_feedback_script,0,0,0:00:00,0,0:00:00,0,0
20151021-ccc_fpb_script,2015/10/21,ccc_fpb_script,0,0,0:00:00,0,0:00:00,0,0
20151021-ccc_help_script,2015/10/21,ccc_help_script,6,6,0:00:14,14,0:00:30,0,84
20151021-ccc_link_script,2015/10/21,ccc_link_script,0,0,0:00:00,0,0:00:00,0,0
20151021-ccc_media_line_script,2015/10/21,ccc_media_line_script,1,1,0:00:48,48,0:00:48,0,48
20151021-ccc_priority_script,2015/10/21,ccc_priority_script,37,32,0:00:13,13,0:00:53,5,416
20151021-ccc_tax_script,2015/10/21,ccc_tax_script,17,11,0:03:30,210,0:08:15,6,2310
20151021-ccc_waste_recycling_script,2015/10/21,ccc_waste_recycling_script,0,0,0:00:00,0,0:00:00,0,0
20151022-ccc_311_calgary_script,2015/10/22,ccc_311_calgary_script,3460,2778,0:02:51,171,0:09:51,682,475038
20151022-ccc_311_lobby_ph_script,2015/10/22,ccc_311_lobby_ph_script,4,3,0:00:15,15,0:00:26,1,45
20151022-ccc_aserv_info_script,2015/10/22,ccc_aserv_info_script,0,0,0:00:00,0,0:00:00,0,0
20151022-ccc_bylaw_script,2015/10/22,ccc_bylaw_script,0,0,0:00:00,0,0:00:00,0,0
20151022-ccc_city_script,2015/10/22,ccc_city_script,9,9,0:01:11,71,0:04:28,0,639
20151022-ccc_cty_online_script,2015/10/22,ccc_cty_online_script,0,0,0:00:00,0,0:00:00,0,0
20151022-ccc_feedback_script,2015/10/22,ccc_feedback_script,0,0,0:00:00,0,0:00:00,0,0
20151022-ccc_fpb_script,2015/10/22,ccc_fpb_script,0,0,0:00:00,0,0:00:00,0,0
20151022-ccc_help_script,2015/10/22,ccc_help_script,17,15,0:00:12,12,0:00:24,2,180
20151022-ccc_link_script,2015/10/22,ccc_link_script,0,0,0:00:00,0,0:00:00,0,0
20151022-ccc_media_line_script,2015/10/22,ccc_media_line_script,2,1,0:00:23,23,0:00:23,1,23
20151022-ccc_priority_script,2015/10/22,ccc_priority_script,35,34,0:00:16,16,0:02:06,1,544
20151022-ccc_tax_script,2015/10/22,ccc_tax_script,16,13,0:04:24,264,0:07:17,3,3432
20151022-ccc_waste_recycling_script,2015/10/22,ccc_waste_recycling_script,0,0,0:00:00,0,0:00:00,0,0
20151023-ccc_311_calgary_script,2015/10/23,ccc_311_calgary_script,2999,2662,0:01:38,98,0:12:54,337,260876
20151023-ccc_311_lobby_ph_script,2015/10/23,ccc_311_lobby_ph_script,4,3,0:00:07,7,0:00:16,1,21
20151023-ccc_aserv_info_script,2015/10/23,ccc_aserv_info_script,0,0,0:00:00,0,0:00:00,0,0
20151023-ccc_bylaw_script,2015/10/23,ccc_bylaw_script,0,0,0:00:00,0,0:00:00,0,0
20151023-ccc_city_script,2015/10/23,ccc_city_script,13,13,0:00:17,17,0:01:27,0,221
20151023-ccc_cty_online_script,2015/10/23,ccc_cty_online_script,0,0,0:00:00,0,0:00:00,0,0
20151023-ccc_feedback_script,2015/10/23,ccc_feedback_script,0,0,0:00:00,0,0:00:00,0,0
20151023-ccc_fpb_script,2015/10/23,ccc_fpb_script,0,0,0:00:00,0,0:00:00,0,0
20151023-ccc_help_script,2015/10/23,ccc_help_script,5,2,0:00:16,16,0:00:24,3,32
20151023-ccc_link_script,2015/10/23,ccc_link_script,0,0,0:00:00,0,0:00:00,0,0
20151023-ccc_media_line_script,2015/10/23,ccc_media_line_script,0,0,0:00:00,0,0:00:00,0,0
20151023-ccc_priority_script,2015/10/23,ccc_priority_script,34,33,0:00:12,12,0:00:46,1,396
20151023-ccc_tax_script,2015/10/23,ccc_tax_script,11,10,0:03:06,186,0:05:54,1,1860
20151023-ccc_waste_recycling_script,2015/10/23,ccc_waste_recycling_script,0,0,0:00:00,0,0:00:00,0,0
20151024-ccc_311_calgary_script,2015/10/24,ccc_311_calgary_script,1035,1011,0:00:16,16,0:05:11,24,16176
20151024-ccc_311_lobby_ph_script,2015/10/24,ccc_311_lobby_ph_script,0,0,0:00:00,0,0:00:00,0,0
20151024-ccc_aserv_info_script,2015/10/24,ccc_aserv_info_script,0,0,0:00:00,0,0:00:00,0,0
20151024-ccc_bylaw_script,2015/10/24,ccc_bylaw_script,0,0,0:00:00,0,0:00:00,0,0
20151024-ccc_city_script,2015/10/24,ccc_city_script,0,0,0:00:00,0,0:00:00,0,0
20151024-ccc_cty_online_script,2015/10/24,ccc_cty_online_script,0,0,0:00:00,0,0:00:00,0,0
20151024-ccc_feedback_script,2015/10/24,ccc_feedback_script,0,0,0:00:00,0,0:00:00,0,0
20151024-ccc_fpb_script,2015/10/24,ccc_fpb_script,0,0,0:00:00,0,0:00:00,0,0
20151024-ccc_help_script,2015/10/24,ccc_help_script,7,7,0:00:06,6,0:00:13,0,42
20151024-ccc_link_script,2015/10/24,ccc_link_script,0,0,0:00:00,0,0:00:00,0,0
20151024-ccc_media_line_script,2015/10/24,ccc_media_line_script,1,1,0:00:16,16,0:00:16,0,16
20151024-ccc_priority_script,2015/10/24,ccc_priority_script,24,23,0:00:08,8,0:00:33,1,184
20151024-ccc_tax_script,2015/10/24,ccc_tax_script,0,0,0:00:00,0,0:00:00,0,0
20151024-ccc_waste_recycling_script,2015/10/24,ccc_waste_recycling_script,0,0,0:00:00,0,0:00:00,0,0
20151025-ccc_311_calgary_script,2015/10/25,ccc_311_calgary_script,964,862,0:00:48,48,0:12:22,102,41376
20151025-ccc_311_lobby_ph_script,2015/10/25,ccc_311_lobby_ph_script,0,0,0:00:00,0,0:00:00,0,0
20151025-ccc_aserv_info_script,2015/10/25,ccc_aserv_info_script,0,0,0:00:00,0,0:00:00,0,0
20151025-ccc_bylaw_script,2015/10/25,ccc_bylaw_script,0,0,0:00:00,0,0:00:00,0,0
20151025-ccc_city_script,2015/10/25,ccc_city_script,0,0,0:00:00,0,0:00:00,0,0
20151025-ccc_cty_online_script,2015/10/25,ccc_cty_online_script,0,0,0:00:00,0,0:00:00,0,0
20151025-ccc_feedback_script,2015/10/25,ccc_feedback_script,0,0,0:00:00,0,0:00:00,0,0
20151025-ccc_fpb_script,2015/10/25,ccc_fpb_script,0,0,0:00:00,0,0:00:00,0,0
20151025-ccc_help_script,2015/10/25,ccc_help_script,1,1,0:00:04,4,0:00:04,0,4
20151025-ccc_link_script,2015/10/25,ccc_link_script,0,0,0:00:00,0,0:00:00,0,0
20151025-ccc_media_line_script,2015/10/25,ccc_media_line_script,0,0,0:00:00,0,0:00:00,0,0
20151025-ccc_priority_script,2015/10/25,ccc_priority_script,12,12,0:00:06,6,0:00:12,0,72
20151025-ccc_tax_script,2015/10/25,ccc_tax_script,0,0,0:00:00,0,0:00:00,0,0
20151025-ccc_waste_recycling_script,2015/10/25,ccc_waste_recycling_script,0,0,0:00:00,0,0:00:00,0,0
20151026-ccc_311_calgary_script,2015/10/26,ccc_311_calgary_script,3478,3074,0:02:02,122,0:09:00,404,375028
20151026-ccc_311_lobby_ph_script,2015/10/26,ccc_311_lobby_ph_script,2,2,0:00:04,4,0:00:05,0,8
20151026-ccc_aserv_info_script,2015/10/26,ccc_aserv_info_script,0,0,0:00:00,0,0:00:00,0,0
20151026-ccc_bylaw_script,2015/10/26,ccc_bylaw_script,0,0,0:00:00,0,0:00:00,0,0
20151026-ccc_city_script,2015/10/26,ccc_city_script,26,25,0:00:08,8,0:00:29,1,200
20151026-ccc_cty_online_script,2015/10/26,ccc_cty_online_script,0,0,0:00:00,0,0:00:00,0,0
20151026-ccc_feedback_script,2015/10/26,ccc_feedback_script,0,0,0:00:00,0,0:00:00,0,0
20151026-ccc_fpb_script,2015/10/26,ccc_fpb_script,0,0,0:00:00,0,0:00:00,0,0
20151026-ccc_help_script,2015/10/26,ccc_help_script,8,8,0:00:11,11,0:00:26,0,88
20151026-ccc_link_script,2015/10/26,ccc_link_script,0,0,0:00:00,0,0:00:00,0,0
20151026-ccc_media_line_script,2015/10/26,ccc_media_line_script,1,0,0:00:00,0,0:00:00,1,0
20151026-ccc_priority_script,2015/10/26,ccc_priority_script,28,26,0:00:13,13,0:00:41,2,338
20151026-ccc_tax_script,2015/10/26,ccc_tax_script,14,12,0:03:55,235,0:07:46,2,2820
20151026-ccc_waste_recycling_script,2015/10/26,ccc_waste_recycling_script,0,0,0:00:00,0,0:00:00,0,0
20151027-ccc_311_calgary_script,2015/10/27,ccc_311_calgary_script,3271,2840,0:02:06,126,0:09:56,431,357840
20151027-ccc_311_lobby_ph_script,2015/10/27,ccc_311_lobby_ph_script,2,1,0:00:20,20,0:00:20,1,20
20151027-ccc_aserv_info_script,2015/10/27,ccc_aserv_info_script,0,0,0:00:00,0,0:00:00,0,0
20151027-ccc_bylaw_script,2015/10/27,ccc_bylaw_script,0,0,0:00:00,0,0:00:00,0,0
20151027-ccc_city_script,2015/10/27,ccc_city_script,11,11,0:00:19,19,0:00:55,0,209
20151027-ccc_cty_online_script,2015/10/27,ccc_cty_online_script,0,0,0:00:00,0,0:00:00,0,0
20151027-ccc_feedback_script,2015/10/27,ccc_feedback_script,0,0,0:00:00,0,0:00:00,0,0
20151027-ccc_fpb_script,2015/10/27,ccc_fpb_script,0,0,0:00:00,0,0:00:00,0,0
20151027-ccc_help_script,2015/10/27,ccc_help_script,10,9,0:00:30,30,0:01:34,1,270
20151027-ccc_link_script,2015/10/27,ccc_link_script,0,0,0:00:00,0,0:00:00,0,0
20151027-ccc_media_line_script,2015/10/27,ccc_media_line_script,3,3,0:00:14,14,0:00:27,0,42
20151027-ccc_priority_script,2015/10/27,ccc_priority_script,39,38,0:00:14,14,0:00:44,1,532
20151027-ccc_tax_script,2015/10/27,ccc_tax_script,24,22,0:02:41,161,0:07:40,2,3542
20151027-ccc_waste_recycling_script,2015/10/27,ccc_waste_recycling_script,0,0,0:00:00,0,0:00:00,0,0
20151028-ccc_311_calgary_script,2015/10/28,ccc_311_calgary_script,3089,2699,0:01:21,81,0:05:51,390,218619
20151028-ccc_311_lobby_ph_script,2015/10/28,ccc_311_lobby_ph_script,3,3,0:00:10,10,0:00:16,0,30
20151028-ccc_aserv_info_script,2015/10/28,ccc_aserv_info_script,0,0,0:00:00,0,0:00:00,0,0
20151028-ccc_bylaw_script,2015/10/28,ccc_bylaw_script,0,0,0:00:00,0,0:00:00,0,0
20151028-ccc_city_script,2015/10/28,ccc_city_script,14,14,0:00:14,14,0:00:54,0,196
20151028-ccc_cty_online_script,2015/10/28,ccc_cty_online_script,0,0,0:00:00,0,0:00:00,0,0
20151028-ccc_feedback_script,2015/10/28,ccc_feedback_script,0,0,0:00:00,0,0:00:00,0,0
20151028-ccc_fpb_script,2015/10/28,ccc_fpb_script,0,0,0:00:00,0,0:00:00,0,0
20151028-ccc_help_script,2015/10/28,ccc_help_script,11,10,0:00:23,23,0:01:19,1,230
20151028-ccc_link_script,2015/10/28,ccc_link_script,0,0,0:00:00,0,0:00:00,0,0
20151028-ccc_media_line_script,2015/10/28,ccc_media_line_script,1,1,0:00:03,3,0:00:03,0,3
20151028-ccc_priority_script,2015/10/28,ccc_priority_script,35,35,0:00:11,11,0:00:40,0,385
20151028-ccc_tax_script,2015/10/28,ccc_tax_script,24,19,0:02:13,133,0:04:29,5,2527
20151028-ccc_waste_recycling_script,2015/10/28,ccc_waste_recycling_script,0,0,0:00:00,0,0:00:00,0,0
20151029-ccc_311_calgary_script,2015/10/29,ccc_311_calgary_script,3089,2699,0:01:21,81,0:05:51,390,218619
20151029-ccc_311_lobby_ph_script,2015/10/29,ccc_311_lobby_ph_script,3,3,0:00:10,10,0:00:16,0,30
20151029-ccc_aserv_info_script,2015/10/29,ccc_aserv_info_script,0,0,0:00:00,0,0:00:00,0,0
20151029-ccc_bylaw_script,2015/10/29,ccc_bylaw_script,0,0,0:00:00,0,0:00:00,0,0
20151029-ccc_city_script,2015/10/29,ccc_city_script,14,14,0:00:14,14,0:00:54,0,196
20151029-ccc_cty_online_script,2015/10/29,ccc_cty_online_script,0,0,0:00:00,0,0:00:00,0,0
20151029-ccc_feedback_script,2015/10/29,ccc_feedback_script,0,0,0:00:00,0,0:00:00,0,0
20151029-ccc_fpb_script,2015/10/29,ccc_fpb_script,0,0,0:00:00,0,0:00:00,0,0
20151029-ccc_help_script,2015/10/29,ccc_help_script,11,10,0:00:23,23,0:01:19,1,230
20151029-ccc_link_script,2015/10/29,ccc_link_script,0,0,0:00:00,0,0:00:00,0,0
20151029-ccc_media_line_script,2015/10/29,ccc_media_line_script,1,1,0:00:03,3,0:00:03,0,3
20151029-ccc_priority_script,2015/10/29,ccc_priority_script,35,35,0:00:11,11,0:00:40,0,385
20151029-ccc_tax_script,2015/10/29,ccc_tax_script,24,19,0:02:13,133,0:04:29,5,2527
20151029-ccc_waste_recycling_script,2015/10/29,ccc_waste_recycling_script,0,0,0:00:00,0,0:00:00,0,0
20151030-ccc_311_calgary_script,2015/10/30,ccc_311_calgary_script,2925,2467,0:01:52,112,0:11:32,458,276304
20151030-ccc_311_lobby_ph_script,2015/10/30,ccc_311_lobby_ph_script,3,2,0:00:25,25,0:00:29,1,50
20151030-ccc_aserv_info_script,2015/10/30,ccc_aserv_info_script,0,0,0:00:00,0,0:00:00,0,0
20151030-ccc_bylaw_script,2015/10/30,ccc_bylaw_script,0,0,0:00:00,0,0:00:00,0,0
20151030-ccc_city_script,2015/10/30,ccc_city_script,27,24,0:00:30,30,0:04:15,3,720
20151030-ccc_cty_online_script,2015/10/30,ccc_cty_online_script,0,0,0:00:00,0,0:00:00,0,0
20151030-ccc_feedback_script,2015/10/30,ccc_feedback_script,0,0,0:00:00,0,0:00:00,0,0
20151030-ccc_fpb_script,2015/10/30,ccc_fpb_script,1,1,0:04:22,262,0:04:22,0,262
20151030-ccc_help_script,2015/10/30,ccc_help_script,6,5,0:00:11,11,0:00:17,1,55
20151030-ccc_link_script,2015/10/30,ccc_link_script,0,0,0:00:00,0,0:00:00,0,0
20151030-ccc_media_line_script,2015/10/30,ccc_media_line_script,1,1,0:00:31,31,0:00:31,0,31
20151030-ccc_priority_script,2015/10/30,ccc_priority_script,30,29,0:00:25,25,0:05:16,1,725
20151030-ccc_tax_script,2015/10/30,ccc_tax_script,26,23,0:02:34,154,0:06:39,3,3542
20151030-ccc_waste_recycling_script,2015/10/30,ccc_waste_recycling_script,0,0,0:00:00,0,0:00:00,0,0
20151031-ccc_311_calgary_script,2015/10/31,ccc_311_calgary_script,1204,1103,0:00:44,44,0:08:00,101,48532
20151031-ccc_311_lobby_ph_script,2015/10/31,ccc_311_lobby_ph_script,0,0,0:00:00,0,0:00:00,0,0
20151031-ccc_aserv_info_script,2015/10/31,ccc_aserv_info_script,0,0,0:00:00,0,0:00:00,0,0
20151031-ccc_bylaw_script,2015/10/31,ccc_bylaw_script,0,0,0:00:00,0,0:00:00,0,0
20151031-ccc_city_script,2015/10/31,ccc_city_script,0,0,0:00:00,0,0:00:00,0,0
20151031-ccc_cty_online_script,2015/10/31,ccc_cty_online_script,0,0,0:00:00,0,0:00:00,0,0
20151031-ccc_feedback_script,2015/10/31,ccc_feedback_script,0,0,0:00:00,0,0:00:00,0,0
20151031-ccc_fpb_script,2015/10/31,ccc_fpb_script,0,0,0:00:00,0,0:00:00,0,0
20151031-ccc_help_script,2015/10/31,ccc_help_script,3,3,0:00:13,13,0:00:26,0,39
20151031-ccc_link_script,2015/10/31,ccc_link_script,0,0,0:00:00,0,0:00:00,0,0
20151031-ccc_media_line_script,2015/10/31,ccc_media_line_script,0,0,0:00:00,0,0:00:00,0,0
20151031-ccc_priority_script,2015/10/31,ccc_priority_script,44,41,0:00:23,23,0:03:26,3,943
20151031-ccc_tax_script,2015/10/31,ccc_tax_script,0,0,0:00:00,0,0:00:00,0,0
20151031-ccc_waste_recycling_script,2015/10/31,ccc_waste_recycling_script,0,0,0:00:00,0,0:00:00,0,0
20151101-ccc_311_calgary_script,2015/11/01,ccc_311_calgary_script,1088,1007,0:00:30,30,0:06:29,81,30210
20151101-ccc_311_lobby_ph_script,2015/11/01,ccc_311_lobby_ph_script,0,0,0:00:00,0,0:00:00,0,0
20151101-ccc_aserv_info_script,2015/11/01,ccc_aserv_info_script,0,0,0:00:00,0,0:00:00,0,0
20151101-ccc_bylaw_script,2015/11/01,ccc_bylaw_script,0,0,0:00:00,0,0:00:00,0,0
20151101-ccc_city_script,2015/11/01,ccc_city_script,0,0,0:00:00,0,0:00:00,0,0
20151101-ccc_cty_online_script,2015/11/01,ccc_cty_online_script,0,0,0:00:00,0,0:00:00,0,0
20151101-ccc_feedback_script,2015/11/01,ccc_feedback_script,1,0,0:00:00,0,0:00:00,0,0
20151101-ccc_fpb_script,2015/11/01,ccc_fpb_script,1,0,0:00:00,0,0:00:00,1,0
20151101-ccc_help_script,2015/11/01,ccc_help_script,1,1,0:00:22,22,0:00:22,0,22
20151101-ccc_link_script,2015/11/01,ccc_link_script,0,0,0:00:00,0,0:00:00,0,0
20151101-ccc_media_line_script,2015/11/01,ccc_media_line_script,0,0,0:00:00,0,0:00:00,0,0
20151101-ccc_priority_script,2015/11/01,ccc_priority_script,21,20,0:00:11,11,0:01:34,1,220
20151101-ccc_tax_script,2015/11/01,ccc_tax_script,0,0,0:00:00,0,0:00:00,0,0
20151101-ccc_waste_recycling_script,2015/11/01,ccc_waste_recycling_script,0,0,0:00:00,0,0:00:00,0,0
20151102-ccc_311_calgary_script,2015/11/02,ccc_311_calgary_script,3474,3016,0:01:34,94,0:06:07,457,283504
20151102-ccc_311_lobby_ph_script,2015/11/02,ccc_311_lobby_ph_script,4,3,0:00:06,6,0:00:12,1,18
20151102-ccc_aserv_info_script,2015/11/02,ccc_aserv_info_script,0,0,0:00:00,0,0:00:00,0,0
20151102-ccc_bylaw_script,2015/11/02,ccc_bylaw_script,0,0,0:00:00,0,0:00:00,0,0
20151102-ccc_city_script,2015/11/02,ccc_city_script,7,6,0:00:20,20,0:00:40,1,120
20151102-ccc_cty_online_script,2015/11/02,ccc_cty_online_script,0,0,0:00:00,0,0:00:00,0,0
20151102-ccc_feedback_script,2015/11/02,ccc_feedback_script,0,0,0:00:00,0,0:00:00,0,0
20151102-ccc_fpb_script,2015/11/02,ccc_fpb_script,3,2,0:01:04,64,0:02:04,1,128
20151102-ccc_help_script,2015/11/02,ccc_help_script,4,4,0:00:12,12,0:00:25,0,48
20151102-ccc_link_script,2015/11/02,ccc_link_script,0,0,0:00:00,0,0:00:00,0,0
20151102-ccc_media_line_script,2015/11/02,ccc_media_line_script,0,0,0:00:00,0,0:00:00,0,0
20151102-ccc_priority_script,2015/11/02,ccc_priority_script,26,26,0:00:12,12,0:00:56,0,312
20151102-ccc_tax_script,2015/11/02,ccc_tax_script,16,15,0:02:47,167,0:04:50,1,2505
20151102-ccc_waste_recycling_script,2015/11/02,ccc_waste_recycling_script,0,0,0:00:00,0,0:00:00,0,0
20151103-ccc_311_calgary_script,2015/11/03,ccc_311_calgary_script,3119,2794,0:01:36,96,0:09:17,326,268224
20151103-ccc_311_lobby_ph_script,2015/11/03,ccc_311_lobby_ph_script,2,1,0:00:06,6,0:00:06,1,6
20151103-ccc_aserv_info_script,2015/11/03,ccc_aserv_info_script,0,0,0:00:00,0,0:00:00,0,0
20151103-ccc_bylaw_script,2015/11/03,ccc_bylaw_script,0,0,0:00:00,0,0:00:00,0,0
20151103-ccc_city_script,2015/11/03,ccc_city_script,7,7,0:00:23,23,0:01:32,0,161
20151103-ccc_cty_online_script,2015/11/03,ccc_cty_online_script,0,0,0:00:00,0,0:00:00,0,0
20151103-ccc_feedback_script,2015/11/03,ccc_feedback_script,0,0,0:00:00,0,0:00:00,0,0
20151103-ccc_fpb_script,2015/11/03,ccc_fpb_script,0,0,0:00:00,0,0:00:00,0,0
20151103-ccc_help_script,2015/11/03,ccc_help_script,2,2,0:00:22,22,0:00:31,0,44
20151103-ccc_link_script,2015/11/03,ccc_link_script,0,0,0:00:00,0,0:00:00,0,0
20151103-ccc_media_line_script,2015/11/03,ccc_media_line_script,0,0,0:00:00,0,0:00:00,0,0
20151103-ccc_priority_script,2015/11/03,ccc_priority_script,42,42,0:00:14,14,0:01:56,0,588
20151103-ccc_tax_script,2015/11/03,ccc_tax_script,22,22,0:02:21,141,0:07:58,0,3102
20151103-ccc_waste_recycling_script,2015/11/03,ccc_waste_recycling_script,0,0,0:00:00,0,0:00:00,0,0
20151104-ccc_311_calgary_script,2015/11/04,ccc_311_calgary_script,3382,2929,0:01:59,119,0:08:24,453,348551
20151104-ccc_311_lobby_ph_script,2015/11/04,ccc_311_lobby_ph_script,3,2,0:00:18,18,0:00:30,1,36
20151104-ccc_aserv_info_script,2015/11/04,ccc_aserv_info_script,0,0,0:00:00,0,0:00:00,0,0
20151104-ccc_bylaw_script,2015/11/04,ccc_bylaw_script,0,0,0:00:00,0,0:00:00,0,0
20151104-ccc_city_script,2015/11/04,ccc_city_script,17,17,0:00:14,14,0:00:41,0,238
20151104-ccc_cty_online_script,2015/11/04,ccc_cty_online_script,0,0,0:00:00,0,0:00:00,0,0
20151104-ccc_feedback_script,2015/11/04,ccc_feedback_script,0,0,0:00:00,0,0:00:00,0,0
20151104-ccc_fpb_script,2015/11/04,ccc_fpb_script,0,0,0:00:00,0,0:00:00,0,0
20151104-ccc_help_script,2015/11/04,ccc_help_script,7,6,0:00:14,14,0:00:31,1,84
20151104-ccc_link_script,2015/11/04,ccc_link_script,0,0,0:00:00,0,0:00:00,0,0
20151104-ccc_media_line_script,2015/11/04,ccc_media_line_script,1,1,0:00:02,2,0:00:02,0,2
20151104-ccc_priority_script,2015/11/04,ccc_priority_script,31,27,0:00:14,14,0:01:21,4,378
20151104-ccc_tax_script,2015/11/04,ccc_tax_script,16,16,0:02:13,133,0:08:09,0,2128
20151104-ccc_waste_recycling_script,2015/11/04,ccc_waste_recycling_script,0,0,0:00:00,0,0:00:00,0,0
20151105-ccc_311_calgary_script,2015/11/05,ccc_311_calgary_script,3079,2754,0:01:23,83,0:06:12,325,228582
20151105-ccc_311_lobby_ph_script,2015/11/05,ccc_311_lobby_ph_script,6,6,0:00:08,8,0:00:21,0,48
20151105-ccc_aserv_info_script,2015/11/05,ccc_aserv_info_script,0,0,0:00:00,0,0:00:00,0,0
20151105-ccc_bylaw_script,2015/11/05,ccc_bylaw_script,0,0,0:00:00,0,0:00:00,0,0
20151105-ccc_city_script,2015/11/05,ccc_city_script,9,9,0:00:31,31,0:02:16,0,279
20151105-ccc_cty_online_script,2015/11/05,ccc_cty_online_script,0,0,0:00:00,0,0:00:00,0,0
20151105-ccc_feedback_script,2015/11/05,ccc_feedback_script,0,0,0:00:00,0,0:00:00,0,0
20151105-ccc_fpb_script,2015/11/05,ccc_fpb_script,0,0,0:00:00,0,0:00:00,0,0
20151105-ccc_help_script,2015/11/05,ccc_help_script,11,10,0:00:10,10,0:00:15,1,100
20151105-ccc_link_script,2015/11/05,ccc_link_script,0,0,0:00:00,0,0:00:00,0,0
20151105-ccc_media_line_script,2015/11/05,ccc_media_line_script,0,0,0:00:00,0,0:00:00,0,0
20151105-ccc_priority_script,2015/11/05,ccc_priority_script,20,19,0:00:10,10,0:00:36,1,190
20151105-ccc_tax_script,2015/11/05,ccc_tax_script,9,8,0:01:47,107,0:03:46,1,856
20151105-ccc_waste_recycling_script,2015/11/05,ccc_waste_recycling_script,0,0,0:00:00,0,0:00:00,0,0
20151107-ccc_311_calgary_script,2015/11/07,ccc_311_calgary_script,3336,3166,0:00:39,39,0:04:53,170,123474
20151107-ccc_311_lobby_ph_script,2015/11/07,ccc_311_lobby_ph_script,5,5,0:00:07,7,0:00:11,0,35
20151107-ccc_aserv_info_script,2015/11/07,ccc_aserv_info_script,0,0,0:00:00,0,0:00:00,0,0
20151107-ccc_bylaw_script,2015/11/07,ccc_bylaw_script,0,0,0:00:00,0,0:00:00,0,0
20151107-ccc_city_script,2015/11/07,ccc_city_script,21,20,0:00:15,15,0:01:45,1,300
20151107-ccc_cty_online_script,2015/11/07,ccc_cty_online_script,0,0,0:00:00,0,0:00:00,0,0
20151107-ccc_feedback_script,2015/11/07,ccc_feedback_script,0,0,0:00:00,0,0:00:00,0,0
20151107-ccc_fpb_script,2015/11/07,ccc_fpb_script,1,1,0:00:05,5,0:00:05,0,5
20151107-ccc_help_script,2015/11/07,ccc_help_script,14,13,0:00:06,6,0:00:14,1,78
20151107-ccc_link_script,2015/11/07,ccc_link_script,0,0,0:00:00,0,0:00:00,0,0
20151107-ccc_media_line_script,2015/11/07,ccc_media_line_script,1,1,0:00:10,10,0:00:10,0,10
20151107-ccc_priority_script,2015/11/07,ccc_priority_script,35,35,0:00:13,13,0:01:19,0,455
20151107-ccc_tax_script,2015/11/07,ccc_tax_script,9,7,0:00:47,47,0:02:10,2,329
20151107-ccc_waste_recycling_script,2015/11/07,ccc_waste_recycling_script,0,0,0:00:00,0,0:00:00,0,0
20151108-ccc_311_calgary_script,2015/11/08,ccc_311_calgary_script,950,916,0:00:15,15,0:04:24,34,13740
20151108-ccc_311_lobby_ph_script,2015/11/08,ccc_311_lobby_ph_script,0,0,0:00:00,0,0:00:00,0,0
20151108-ccc_aserv_info_script,2015/11/08,ccc_aserv_info_script,0,0,0:00:00,0,0:00:00,0,0
20151108-ccc_bylaw_script,2015/11/08,ccc_bylaw_script,0,0,0:00:00,0,0:00:00,0,0
20151108-ccc_city_script,2015/11/08,ccc_city_script,0,0,0:00:00,0,0:00:00,0,0
20151108-ccc_cty_online_script,2015/11/08,ccc_cty_online_script,0,0,0:00:00,0,0:00:00,0,0
20151108-ccc_feedback_script,2015/11/08,ccc_feedback_script,0,0,0:00:00,0,0:00:00,0,0
20151108-ccc_fpb_script,2015/11/08,ccc_fpb_script,0,0,0:00:00,0,0:00:00,0,0
20151108-ccc_help_script,2015/11/08,ccc_help_script,3,3,0:00:06,6,0:00:07,0,18
20151108-ccc_link_script,2015/11/08,ccc_link_script,0,0,0:00:00,0,0:00:00,0,0
20151108-ccc_media_line_script,2015/11/08,ccc_media_line_script,0,0,0:00:00,0,0:00:00,0,0
20151108-ccc_priority_script,2015/11/08,ccc_priority_script,13,13,0:00:06,6,0:00:13,0,78
20151108-ccc_tax_script,2015/11/08,ccc_tax_script,0,0,0:00:00,0,0:00:00,0,0
20151108-ccc_waste_recycling_script,2015/11/08,ccc_waste_recycling_script,0,0,0:00:00,0,0:00:00,0,0
20151109-ccc_311_calgary_script,2015/11/09,ccc_311_calgary_script,3145,2970,0:00:34,34,0:08:24,175,100980
20151109-ccc_311_lobby_ph_script,2015/11/09,ccc_311_lobby_ph_script,7,7,0:00:07,7,0:00:13,0,49
20151109-ccc_aserv_info_script,2015/11/09,ccc_aserv_info_script,0,0,0:00:00,0,0:00:00,0,0
20151109-ccc_bylaw_script,2015/11/09,ccc_bylaw_script,0,0,0:00:00,0,0:00:00,0,0
20151109-ccc_city_script,2015/11/09,ccc_city_script,23,23,0:00:08,8,0:00:22,0,184
20151109-ccc_cty_online_script,2015/11/09,ccc_cty_online_script,0,0,0:00:00,0,0:00:00,0,0
20151109-ccc_feedback_script,2015/11/09,ccc_feedback_script,0,0,0:00:00,0,0:00:00,0,0
20151109-ccc_fpb_script,2015/11/09,ccc_fpb_script,1,1,0:00:02,2,0:00:02,0,2
20151109-ccc_help_script,2015/11/09,ccc_help_script,4,4,0:00:14,14,0:00:25,0,56
20151109-ccc_link_script,2015/11/09,ccc_link_script,0,0,0:00:00,0,0:00:00,0,0
20151109-ccc_media_line_script,2015/11/09,ccc_media_line_script,2,2,0:00:09,9,0:00:15,0,18
20151109-ccc_priority_script,2015/11/09,ccc_priority_script,26,25,0:00:15,15,0:01:02,1,375
20151109-ccc_tax_script,2015/11/09,ccc_tax_script,20,19,0:00:31,31,0:01:44,1,589
20151109-ccc_waste_recycling_script,2015/11/09,ccc_waste_recycling_script,0,0,0:00:00,0,0:00:00,0,0
20151110-ccc_311_calgary_script,2015/11/10,ccc_311_calgary_script,3319,2863,0:01:43,103,0:11:50,456,294889
20151110-ccc_311_lobby_ph_script,2015/11/10,ccc_311_lobby_ph_script,0,0,0:00:00,0,0:00:00,0,0
20151110-ccc_aserv_info_script,2015/11/10,ccc_aserv_info_script,0,0,0:00:00,0,0:00:00,0,0
20151110-ccc_bylaw_script,2015/11/10,ccc_bylaw_script,0,0,0:00:00,0,0:00:00,0,0
20151110-ccc_city_script,2015/11/10,ccc_city_script,25,24,0:00:41,41,0:08:00,1,984
20151110-ccc_cty_online_script,2015/11/10,ccc_cty_online_script,0,0,0:00:00,0,0:00:00,0,0
20151110-ccc_feedback_script,2015/11/10,ccc_feedback_script,0,0,0:00:00,0,0:00:00,0,0
20151110-ccc_fpb_script,2015/11/10,ccc_fpb_script,2,2,0:00:12,12,0:00:21,0,24
20151110-ccc_help_script,2015/11/10,ccc_help_script,19,19,0:00:12,12,0:00:46,0,228
20151110-ccc_link_script,2015/11/10,ccc_link_script,0,0,0:00:00,0,0:00:00,0,0
20151110-ccc_media_line_script,2015/11/10,ccc_media_line_script,1,1,0:00:08,8,0:00:08,0,8
20151110-ccc_priority_script,2015/11/10,ccc_priority_script,37,37,0:00:14,14,0:01:38,0,518
20151110-ccc_tax_script,2015/11/10,ccc_tax_script,9,8,0:01:10,70,0:03:49,1,560
20151110-ccc_waste_recycling_script,2015/11/10,ccc_waste_recycling_script,0,0,0:00:00,0,0:00:00,0,0
20151111-ccc_311_calgary_script,2015/11/11,ccc_311_calgary_script,1696,1617,0:00:29,29,0:05:44,79,46893
20151111-ccc_311_lobby_ph_script,2015/11/11,ccc_311_lobby_ph_script,0,0,0:00:00,0,0:00:00,0,0
20151111-ccc_aserv_info_script,2015/11/11,ccc_aserv_info_script,0,0,0:00:00,0,0:00:00,0,0
20151111-ccc_bylaw_script,2015/11/11,ccc_bylaw_script,0,0,0:00:00,0,0:00:00,0,0
20151111-ccc_city_script,2015/11/11,ccc_city_script,0,0,0:00:00,0,0:00:00,0,0
20151111-ccc_cty_online_script,2015/11/11,ccc_cty_online_script,0,0,0:00:00,0,0:00:00,0,0
20151111-ccc_feedback_script,2015/11/11,ccc_feedback_script,0,0,0:00:00,0,0:00:00,0,0
20151111-ccc_fpb_script,2015/11/11,ccc_fpb_script,1,1,0:00:07,7,0:00:07,0,7
20151111-ccc_help_script,2015/11/11,ccc_help_script,5,5,0:00:13,13,0:00:41,0,65
20151111-ccc_link_script,2015/11/11,ccc_link_script,0,0,0:00:00,0,0:00:00,0,0
20151111-ccc_media_line_script,2015/11/11,ccc_media_line_script,1,1,0:00:04,4,0:00:04,0,4
20151111-ccc_priority_script,2015/11/11,ccc_priority_script,20,20,0:00:09,9,0:00:44,0,180
20151111-ccc_tax_script,2015/11/11,ccc_tax_script,0,0,0:00:00,0,0:00:00,0,0
20151111-ccc_waste_recycling_script,2015/11/11,ccc_waste_recycling_script,0,0,0:00:00,0,0:00:00,0,0
20151112-ccc_311_calgary_script,2015/11/12,ccc_311_calgary_script,3112,2871,0:01:04,64,0:08:03,241,183744
20151112-ccc_311_lobby_ph_script,2015/11/12,ccc_311_lobby_ph_script,7,6,0:00:08,8,0:00:13,1,48
20151112-ccc_aserv_info_script,2015/11/12,ccc_aserv_info_script,0,0,0:00:00,0,0:00:00,0,0
20151112-ccc_bylaw_script,2015/11/12,ccc_bylaw_script,0,0,0:00:00,0,0:00:00,0,0
20151112-ccc_city_script,2015/11/12,ccc_city_script,9,8,0:00:32,32,0:01:19,1,256
20151112-ccc_cty_online_script,2015/11/12,ccc_cty_online_script,0,0,0:00:00,0,0:00:00,0,0
20151112-ccc_feedback_script,2015/11/12,ccc_feedback_script,0,0,0:00:00,0,0:00:00,0,0
20151112-ccc_fpb_script,2015/11/12,ccc_fpb_script,0,0,0:00:00,0,0:00:00,0,0
20151112-ccc_help_script,2015/11/12,ccc_help_script,9,5,0:00:20,20,0:00:40,4,100
20151112-ccc_link_script,2015/11/12,ccc_link_script,0,0,0:00:00,0,0:00:00,0,0
20151112-ccc_media_line_script,2015/11/12,ccc_media_line_script,1,1,0:00:13,13,0:00:13,0,13
20151112-ccc_priority_script,2015/11/12,ccc_priority_script,22,21,0:00:12,12,0:00:41,1,252
20151112-ccc_tax_script,2015/11/12,ccc_tax_script,16,13,0:01:57,117,0:07:15,3,1521
20151112-ccc_waste_recycling_script,2015/11/12,ccc_waste_recycling_script,0,0,0:00:00,0,0:00:00,0,0
20151113-ccc_311_calgary_script,2015/11/13,ccc_311_calgary_script,3022,2711,0:01:23,83,0:11:13,311,225013
20151113-ccc_311_lobby_ph_script,2015/11/13,ccc_311_lobby_ph_script,1,0,0:00:00,0,0:00:00,1,0
20151113-ccc_aserv_info_script,2015/11/13,ccc_aserv_info_script,0,0,0:00:00,0,0:00:00,0,0
20151113-ccc_bylaw_script,2015/11/13,ccc_bylaw_script,0,0,0:00:00,0,0:00:00,0,0
20151113-ccc_city_script,2015/11/13,ccc_city_script,18,16,0:00:28,28,0:02:40,2,448
20151113-ccc_cty_online_script,2015/11/13,ccc_cty_online_script,0,0,0:00:00,0,0:00:00,0,0
20151113-ccc_feedback_script,2015/11/13,ccc_feedback_script,0,0,0:00:00,0,0:00:00,0,0
20151113-ccc_fpb_script,2015/11/13,ccc_fpb_script,0,0,0:00:00,0,0:00:00,0,0
20151113-ccc_help_script,2015/11/13,ccc_help_script,8,6,0:00:13,13,0:00:46,2,78
20151113-ccc_link_script,2015/11/13,ccc_link_script,0,0,0:00:00,0,0:00:00,0,0
20151113-ccc_media_line_script,2015/11/13,ccc_media_line_script,0,0,0:00:00,0,0:00:00,0,0
20151113-ccc_priority_script,2015/11/13,ccc_priority_script,30,29,0:00:12,12,0:00:58,1,348
20151113-ccc_tax_script,2015/11/13,ccc_tax_script,16,13,0:01:33,93,0:04:59,3,1209
20151113-ccc_waste_recycling_script,2015/11/13,ccc_waste_recycling_script,0,0,0:00:00,0,0:00:00,0,0
20151114-ccc_311_calgary_script,2015/11/14,ccc_311_calgary_script,955,943,0:00:11,11,0:10:28,12,10373
20151114-ccc_311_lobby_ph_script,2015/11/14,ccc_311_lobby_ph_script,0,0,0:00:00,0,0:00:00,0,0
20151114-ccc_aserv_info_script,2015/11/14,ccc_aserv_info_script,0,0,0:00:00,0,0:00:00,0,0
20151114-ccc_bylaw_script,2015/11/14,ccc_bylaw_script,0,0,0:00:00,0,0:00:00,0,0
20151114-ccc_city_script,2015/11/14,ccc_city_script,0,0,0:00:00,0,0:00:00,0,0
20151114-ccc_cty_online_script,2015/11/14,ccc_cty_online_script,0,0,0:00:00,0,0:00:00,0,0
20151114-ccc_feedback_script,2015/11/14,ccc_feedback_script,0,0,0:00:00,0,0:00:00,0,0
20151114-ccc_fpb_script,2015/11/14,ccc_fpb_script,0,0,0:00:00,0,0:00:00,0,0
20151114-ccc_help_script,2015/11/14,ccc_help_script,2,2,0:00:11,11,0:00:19,0,22
20151114-ccc_link_script,2015/11/14,ccc_link_script,0,0,0:00:00,0,0:00:00,0,0
20151114-ccc_media_line_script,2015/11/14,ccc_media_line_script,1,1,0:00:15,15,0:00:15,0,15
20151114-ccc_priority_script,2015/11/14,ccc_priority_script,13,13,0:00:16,16,0:02:27,0,208
20151114-ccc_tax_script,2015/11/14,ccc_tax_script,0,0,0:00:00,0,0:00:00,0,0
20151114-ccc_waste_recycling_script,2015/11/14,ccc_waste_recycling_script,0,0,0:00:00,0,0:00:00,0,0
20151115-ccc_311_calgary_script,2015/11/15,ccc_311_calgary_script,1212,763,0:00:59,59,0:23:50,448,45017
20151115-ccc_311_lobby_ph_script,2015/11/15,ccc_311_lobby_ph_script,0,0,0:00:00,0,0:00:00,0,0
20151115-ccc_aserv_info_script,2015/11/15,ccc_aserv_info_script,0,0,0:00:00,0,0:00:00,0,0
20151115-ccc_bylaw_script,2015/11/15,ccc_bylaw_script,0,0,0:00:00,0,0:00:00,0,0
20151115-ccc_city_script,2015/11/15,ccc_city_script,0,0,0:00:00,0,0:00:00,0,0
20151115-ccc_cty_online_script,2015/11/15,ccc_cty_online_script,0,0,0:00:00,0,0:00:00,0,0
20151115-ccc_feedback_script,2015/11/15,ccc_feedback_script,0,0,0:00:00,0,0:00:00,0,0
20151115-ccc_fpb_script,2015/11/15,ccc_fpb_script,0,0,0:00:00,0,0:00:00,0,0
20151115-ccc_help_script,2015/11/15,ccc_help_script,1,1,0:00:10,10,0:00:10,0,10
20151115-ccc_link_script,2015/11/15,ccc_link_script,0,0,0:00:00,0,0:00:00,0,0
20151115-ccc_media_line_script,2015/11/15,ccc_media_line_script,1,1,0:00:14,14,0:00:14,0,14
20151115-ccc_priority_script,2015/11/15,ccc_priority_script,35,31,0:00:14,14,0:02:38,4,434
20151115-ccc_tax_script,2015/11/15,ccc_tax_script,3,3,0:00:04,4,0:00:06,0,12
20151115-ccc_waste_recycling_script,2015/11/15,ccc_waste_recycling_script,0,0,0:00:00,0,0:00:00,0,0
20151116-ccc_311_calgary_script,2015/11/16,ccc_311_calgary_script,3143,2919,0:01:02,62,0:06:43,225,180978
20151116-ccc_311_lobby_ph_script,2015/11/16,ccc_311_lobby_ph_script,3,3,0:00:13,13,0:00:22,0,39
20151116-ccc_aserv_info_script,2015/11/16,ccc_aserv_info_script,0,0,0:00:00,0,0:00:00,0,0
20151116-ccc_bylaw_script,2015/11/16,ccc_bylaw_script,0,0,0:00:00,0,0:00:00,0,0
20151116-ccc_city_script,2015/11/16,ccc_city_script,13,13,0:00:15,15,0:00:57,0,195
20151116-ccc_cty_online_script,2015/11/16,ccc_cty_online_script,0,0,0:00:00,0,0:00:00,0,0
20151116-ccc_feedback_script,2015/11/16,ccc_feedback_script,1,0,0:00:00,0,0:00:00,0,0
20151116-ccc_fpb_script,2015/11/16,ccc_fpb_script,1,1,0:00:03,3,0:00:03,0,3
20151116-ccc_help_script,2015/11/16,ccc_help_script,14,14,0:00:18,18,0:01:04,0,252
20151116-ccc_link_script,2015/11/16,ccc_link_script,0,0,0:00:00,0,0:00:00,0,0
20151116-ccc_media_line_script,2015/11/16,ccc_media_line_script,0,0,0:00:00,0,0:00:00,0,0
20151116-ccc_priority_script,2015/11/16,ccc_priority_script,20,19,0:00:12,12,0:00:41,1,228
20151116-ccc_tax_script,2015/11/16,ccc_tax_script,27,25,0:01:32,92,0:06:27,2,2300
20151116-ccc_waste_recycling_script,2015/11/16,ccc_waste_recycling_script,0,0,0:00:00,0,0:00:00,0,0
20151117-ccc_311_calgary_script,2015/11/17,ccc_311_calgary_script,3113,2809,0:00:54,54,0:12:01,304,151686
20151117-ccc_311_lobby_ph_script,2015/11/17,ccc_311_lobby_ph_script,4,2,0:00:12,12,0:00:13,2,24
20151117-ccc_aserv_info_script,2015/11/17,ccc_aserv_info_script,0,0,0:00:00,0,0:00:00,0,0
20151117-ccc_bylaw_script,2015/11/17,ccc_bylaw_script,0,0,0:00:00,0,0:00:00,0,0
20151117-ccc_city_script,2015/11/17,ccc_city_script,7,7,0:00:14,14,0:00:36,0,98
20151117-ccc_cty_online_script,2015/11/17,ccc_cty_online_script,0,0,0:00:00,0,0:00:00,0,0
20151117-ccc_feedback_script,2015/11/17,ccc_feedback_script,0,0,0:00:00,0,0:00:00,0,0
20151117-ccc_fpb_script,2015/11/17,ccc_fpb_script,1,1,0:00:03,3,0:00:03,0,3
20151117-ccc_help_script,2015/11/17,ccc_help_script,7,5,0:00:11,11,0:00:22,2,55
20151117-ccc_link_script,2015/11/17,ccc_link_script,0,0,0:00:00,0,0:00:00,0,0
20151117-ccc_media_line_script,2015/11/17,ccc_media_line_script,2,2,0:00:11,11,0:00:13,0,22
20151117-ccc_priority_script,2015/11/17,ccc_priority_script,54,51,0:00:21,21,0:01:44,3,1071
20151117-ccc_tax_script,2015/11/17,ccc_tax_script,16,16,0:00:39,39,0:02:02,0,624
20151117-ccc_waste_recycling_script,2015/11/17,ccc_waste_recycling_script,0,0,0:00:00,0,0:00:00,0,0
20151118-ccc_311_calgary_script,2015/11/18,ccc_311_calgary_script,3361,2927,0:01:25,85,0:07:10,434,248795
20151118-ccc_311_lobby_ph_script,2015/11/18,ccc_311_lobby_ph_script,4,3,0:00:10,10,0:00:20,1,30
20151118-ccc_aserv_info_script,2015/11/18,ccc_aserv_info_script,0,0,0:00:00,0,0:00:00,0,0
20151118-ccc_bylaw_script,2015/11/18,ccc_bylaw_script,0,0,0:00:00,0,0:00:00,0,0
20151118-ccc_city_script,2015/11/18,ccc_city_script,13,13,0:00:58,58,0:03:51,0,754
20151118-ccc_cty_online_script,2015/11/18,ccc_cty_online_script,0,0,0:00:00,0,0:00:00,0,0
20151118-ccc_feedback_script,2015/11/18,ccc_feedback_script,0,0,0:00:00,0,0:00:00,0,0
20151118-ccc_fpb_script,2015/11/18,ccc_fpb_script,0,0,0:00:00,0,0:00:00,0,0
20151118-ccc_help_script,2015/11/18,ccc_help_script,14,14,0:00:15,15,0:00:42,0,210
20151118-ccc_link_script,2015/11/18,ccc_link_script,0,0,0:00:00,0,0:00:00,0,0
20151118-ccc_media_line_script,2015/11/18,ccc_media_line_script,3,3,0:00:14,14,0:00:35,0,42
20151118-ccc_priority_script,2015/11/18,ccc_priority_script,68,66,0:00:17,17,0:02:37,2,1122
20151118-ccc_tax_script,2015/11/18,ccc_tax_script,22,20,0:01:38,98,0:05:54,2,1960
20151118-ccc_waste_recycling_script,2015/11/18,ccc_waste_recycling_script,0,0,0:00:00,0,0:00:00,0,0
20151119-ccc_311_calgary_script,2015/11/19,ccc_311_calgary_script,3500,2782,0:03:07,187,0:14:51,718,520234
20151119-ccc_311_lobby_ph_script,2015/11/19,ccc_311_lobby_ph_script,2,1,0:00:51,51,0:00:51,1,51
20151119-ccc_aserv_info_script,2015/11/19,ccc_aserv_info_script,0,0,0:00:00,0,0:00:00,0,0
20151119-ccc_bylaw_script,2015/11/19,ccc_bylaw_script,0,0,0:00:00,0,0:00:00,0,0
20151119-ccc_city_script,2015/11/19,ccc_city_script,7,6,0:01:40,100,0:04:37,1,600
20151119-ccc_cty_online_script,2015/11/19,ccc_cty_online_script,0,0,0:00:00,0,0:00:00,0,0
20151119-ccc_feedback_script,2015/11/19,ccc_feedback_script,0,0,0:00:00,0,0:00:00,0,0
20151119-ccc_fpb_script,2015/11/19,ccc_fpb_script,2,0,0:00:00,0,0:00:00,2,0
20151119-ccc_help_script,2015/11/19,ccc_help_script,10,10,0:00:16,16,0:00:40,0,160
20151119-ccc_link_script,2015/11/19,ccc_link_script,0,0,0:00:00,0,0:00:00,0,0
20151119-ccc_media_line_script,2015/11/19,ccc_media_line_script,0,0,0:00:00,0,0:00:00,0,0
20151119-ccc_priority_script,2015/11/19,ccc_priority_script,30,29,0:00:14,14,0:00:47,1,406
20151119-ccc_tax_script,2015/11/19,ccc_tax_script,17,13,0:02:41,161,0:05:39,4,2093
20151119-ccc_waste_recycling_script,2015/11/19,ccc_waste_recycling_script,0,0,0:00:00,0,0:00:00,0,0
20151120-ccc_311_calgary_script,2015/11/20,ccc_311_calgary_script,2686,2580,0:00:25,25,0:04:51,106,64500
20151120-ccc_311_lobby_ph_script,2015/11/20,ccc_311_lobby_ph_script,4,4,0:00:09,9,0:00:24,0,36
20151120-ccc_aserv_info_script,2015/11/20,ccc_aserv_info_script,0,0,0:00:00,0,0:00:00,0,0
20151120-ccc_bylaw_script,2015/11/20,ccc_bylaw_script,0,0,0:00:00,0,0:00:00,0,0
20151120-ccc_city_script,2015/11/20,ccc_city_script,8,8,0:00:07,7,0:00:20,0,56
20151120-ccc_cty_online_script,2015/11/20,ccc_cty_online_script,0,0,0:00:00,0,0:00:00,0,0
20151120-ccc_feedback_script,2015/11/20,ccc_feedback_script,0,0,0:00:00,0,0:00:00,0,0
20151120-ccc_fpb_script,2015/11/20,ccc_fpb_script,0,0,0:00:00,0,0:00:00,0,0
20151120-ccc_help_script,2015/11/20,ccc_help_script,12,12,0:00:11,11,0:00:24,0,132
20151120-ccc_link_script,2015/11/20,ccc_link_script,0,0,0:00:00,0,0:00:00,0,0
20151120-ccc_media_line_script,2015/11/20,ccc_media_line_script,0,0,0:00:00,0,0:00:00,0,0
20151120-ccc_priority_script,2015/11/20,ccc_priority_script,28,27,0:00:12,12,0:01:52,1,324
20151120-ccc_tax_script,2015/11/20,ccc_tax_script,8,8,0:00:17,17,0:00:54,0,136
20151120-ccc_waste_recycling_script,2015/11/20,ccc_waste_recycling_script,0,0,0:00:00,0,0:00:00,0,0
20151121-ccc_311_calgary_script,2015/11/21,ccc_311_calgary_script,1031,997,0:00:21,21,0:04:22,34,20937
20151121-ccc_311_lobby_ph_script,2015/11/21,ccc_311_lobby_ph_script,0,0,0:00:00,0,0:00:00,0,0
20151121-ccc_aserv_info_script,2015/11/21,ccc_aserv_info_script,0,0,0:00:00,0,0:00:00,0,0
20151121-ccc_bylaw_script,2015/11/21,ccc_bylaw_script,0,0,0:00:00,0,0:00:00,0,0
20151121-ccc_city_script,2015/11/21,ccc_city_script,0,0,0:00:00,0,0:00:00,0,0
20151121-ccc_cty_online_script,2015/11/21,ccc_cty_online_script,0,0,0:00:00,0,0:00:00,0,0
20151121-ccc_feedback_script,2015/11/21,ccc_feedback_script,0,0,0:00:00,0,0:00:00,0,0
20151121-ccc_fpb_script,2015/11/21,ccc_fpb_script,0,0,0:00:00,0,0:00:00,0,0
20151121-ccc_help_script,2015/11/21,ccc_help_script,6,6,0:00:22,22,0:01:41,0,132
20151121-ccc_link_script,2015/11/21,ccc_link_script,0,0,0:00:00,0,0:00:00,0,0
20151121-ccc_media_line_script,2015/11/21,ccc_media_line_script,0,0,0:00:00,0,0:00:00,0,0
20151121-ccc_priority_script,2015/11/21,ccc_priority_script,28,28,0:00:09,9,0:00:30,0,252
20151121-ccc_tax_script,2015/11/21,ccc_tax_script,2,1,0:00:04,4,0:00:04,1,4
20151121-ccc_waste_recycling_script,2015/11/21,ccc_waste_recycling_script,0,0,0:00:00,0,0:00:00,0,0
20151122-ccc_311_calgary_script,2015/11/22,ccc_311_calgary_script,833,795,0:00:20,20,0:06:27,38,15900
20151122-ccc_311_lobby_ph_script,2015/11/22,ccc_311_lobby_ph_script,0,0,0:00:00,0,0:00:00,0,0
20151122-ccc_aserv_info_script,2015/11/22,ccc_aserv_info_script,0,0,0:00:00,0,0:00:00,0,0
20151122-ccc_bylaw_script,2015/11/22,ccc_bylaw_script,0,0,0:00:00,0,0:00:00,0,0
20151122-ccc_city_script,2015/11/22,ccc_city_script,0,0,0:00:00,0,0:00:00,0,0
20151122-ccc_cty_online_script,2015/11/22,ccc_cty_online_script,0,0,0:00:00,0,0:00:00,0,0
20151122-ccc_feedback_script,2015/11/22,ccc_feedback_script,0,0,0:00:00,0,0:00:00,0,0
20151122-ccc_fpb_script,2015/11/22,ccc_fpb_script,0,0,0:00:00,0,0:00:00,0,0
20151122-ccc_help_script,2015/11/22,ccc_help_script,1,1,0:00:17,17,0:00:17,0,17
20151122-ccc_link_script,2015/11/22,ccc_link_script,0,0,0:00:00,0,0:00:00,0,0
20151122-ccc_media_line_script,2015/11/22,ccc_media_line_script,0,0,0:00:00,0,0:00:00,0,0
20151122-ccc_priority_script,2015/11/22,ccc_priority_script,16,15,0:00:11,11,0:00:39,1,165
20151122-ccc_tax_script,2015/11/22,ccc_tax_script,0,0,0:00:00,0,0:00:00,0,0
20151122-ccc_waste_recycling_script,2015/11/22,ccc_waste_recycling_script,0,0,0:00:00,0,0:00:00,0,0
20151123-ccc_311_calgary_script,2015/11/23,ccc_311_calgary_script,3266,3169,0:00:22,22,0:06:19,97,69718
20151123-ccc_311_lobby_ph_script,2015/11/23,ccc_311_lobby_ph_script,2,2,0:00:17,17,0:00:27,0,34
20151123-ccc_aserv_info_script,2015/11/23,ccc_aserv_info_script,0,0,0:00:00,0,0:00:00,0,0
20151123-ccc_bylaw_script,2015/11/23,ccc_bylaw_script,0,0,0:00:00,0,0:00:00,0,0
20151123-ccc_city_script,2015/11/23,ccc_city_script,27,27,0:00:09,9,0:00:47,0,243
20151123-ccc_cty_online_script,2015/11/23,ccc_cty_online_script,0,0,0:00:00,0,0:00:00,0,0
20151123-ccc_feedback_script,2015/11/23,ccc_feedback_script,0,0,0:00:00,0,0:00:00,0,0
20151123-ccc_fpb_script,2015/11/23,ccc_fpb_script,0,0,0:00:00,0,0:00:00,0,0
20151123-ccc_help_script,2015/11/23,ccc_help_script,9,8,0:00:07,7,0:00:19,1,56
20151123-ccc_link_script,2015/11/23,ccc_link_script,0,0,0:00:00,0,0:00:00,0,0
20151123-ccc_media_line_script,2015/11/23,ccc_media_line_script,0,0,0:00:00,0,0:00:00,0,0
20151123-ccc_priority_script,2015/11/23,ccc_priority_script,26,24,0:00:12,12,0:02:06,2,288
20151123-ccc_tax_script,2015/11/23,ccc_tax_script,22,21,0:00:28,28,0:02:38,1,588
20151123-ccc_waste_recycling_script,2015/11/23,ccc_waste_recycling_script,0,0,0:00:00,0,0:00:00,0,0
20151124-ccc_311_calgary_script,2015/11/24,ccc_311_calgary_script,3164,3013,0:00:34,34,0:06:46,151,102442
20151124-ccc_311_lobby_ph_script,2015/11/24,ccc_311_lobby_ph_script,1,1,0:00:05,5,0:00:05,0,5
20151124-ccc_aserv_info_script,2015/11/24,ccc_aserv_info_script,0,0,0:00:00,0,0:00:00,0,0
20151124-ccc_bylaw_script,2015/11/24,ccc_bylaw_script,0,0,0:00:00,0,0:00:00,0,0
20151124-ccc_city_script,2015/11/24,ccc_city_script,20,20,0:00:19,19,0:02:40,0,380
20151124-ccc_cty_online_script,2015/11/24,ccc_cty_online_script,0,0,0:00:00,0,0:00:00,0,0
20151124-ccc_feedback_script,2015/11/24,ccc_feedback_script,0,0,0:00:00,0,0:00:00,0,0
20151124-ccc_fpb_script,2015/11/24,ccc_fpb_script,0,0,0:00:00,0,0:00:00,0,0
20151124-ccc_help_script,2015/11/24,ccc_help_script,10,10,0:00:15,15,0:01:04,0,150
20151124-ccc_link_script,2015/11/24,ccc_link_script,0,0,0:00:00,0,0:00:00,0,0
20151124-ccc_media_line_script,2015/11/24,ccc_media_line_script,1,1,0:00:09,9,0:00:09,0,9
20151124-ccc_priority_script,2015/11/24,ccc_priority_script,29,29,0:00:20,20,0:04:35,0,580
20151124-ccc_tax_script,2015/11/24,ccc_tax_script,26,25,0:00:20,20,0:01:47,1,500
20151124-ccc_waste_recycling_script,2015/11/24,ccc_waste_recycling_script,0,0,0:00:00,0,0:00:00,0,0
20151125-ccc_311_calgary_script,2015/11/25,ccc_311_calgary_script,3141,2832,0:01:10,70,0:08:37,309,198240
20151125-ccc_311_lobby_ph_script,2015/11/25,ccc_311_lobby_ph_script,4,2,0:00:37,37,0:01:08,2,74
20151125-ccc_aserv_info_script,2015/11/25,ccc_aserv_info_script,0,0,0:00:00,0,0:00:00,0,0
20151125-ccc_bylaw_script,2015/11/25,ccc_bylaw_script,0,0,0:00:00,0,0:00:00,0,0
20151125-ccc_city_script,2015/11/25,ccc_city_script,22,21,0:00:35,35,0:05:01,1,735
20151125-ccc_cty_online_script,2015/11/25,ccc_cty_online_script,0,0,0:00:00,0,0:00:00,0,0
20151125-ccc_feedback_script,2015/11/25,ccc_feedback_script,2,0,0:00:00,0,0:00:00,0,0
20151125-ccc_fpb_script,2015/11/25,ccc_fpb_script,0,0,0:00:00,0,0:00:00,0,0
20151125-ccc_help_script,2015/11/25,ccc_help_script,11,11,0:00:16,16,0:00:43,0,176
20151125-ccc_link_script,2015/11/25,ccc_link_script,0,0,0:00:00,0,0:00:00,0,0
20151125-ccc_media_line_script,2015/11/25,ccc_media_line_script,2,2,0:01:15,75,0:02:18,0,150
20151125-ccc_priority_script,2015/11/25,ccc_priority_script,30,29,0:00:19,19,0:02:33,1,551
20151125-ccc_tax_script,2015/11/25,ccc_tax_script,22,21,0:00:58,58,0:03:41,1,1218
20151125-ccc_waste_recycling_script,2015/11/25,ccc_waste_recycling_script,0,0,0:00:00,0,0:00:00,0,0
20151126-ccc_311_calgary_script,2015/11/26,ccc_311_calgary_script,3083,2800,0:01:13,73,0:07:15,283,204400
20151126-ccc_311_lobby_ph_script,2015/11/26,ccc_311_lobby_ph_script,0,0,0:00:00,0,0:00:00,0,0
20151126-ccc_aserv_info_script,2015/11/26,ccc_aserv_info_script,0,0,0:00:00,0,0:00:00,0,0
20151126-ccc_bylaw_script,2015/11/26,ccc_bylaw_script,0,0,0:00:00,0,0:00:00,0,0
20151126-ccc_city_script,2015/11/26,ccc_city_script,13,13,0:00:33,33,0:01:56,0,429
20151126-ccc_cty_online_script,2015/11/26,ccc_cty_online_script,0,0,0:00:00,0,0:00:00,0,0
20151126-ccc_feedback_script,2015/11/26,ccc_feedback_script,0,0,0:00:00,0,0:00:00,0,0
20151126-ccc_fpb_script,2015/11/26,ccc_fpb_script,1,1,0:00:27,27,0:00:27,0,27
20151126-ccc_help_script,2015/11/26,ccc_help_script,9,8,0:00:23,23,0:01:13,1,184
20151126-ccc_link_script,2015/11/26,ccc_link_script,0,0,0:00:00,0,0:00:00,0,0
20151126-ccc_media_line_script,2015/11/26,ccc_media_line_script,0,0,0:00:00,0,0:00:00,0,0
20151126-ccc_priority_script,2015/11/26,ccc_priority_script,29,27,0:00:16,16,0:01:13,2,432
20151126-ccc_tax_script,2015/11/26,ccc_tax_script,16,16,0:01:12,72,0:02:34,0,1152
20151126-ccc_waste_recycling_script,2015/11/26,ccc_waste_recycling_script,0,0,0:00:00,0,0:00:00,0,0
20151127-ccc_311_calgary_script,2015/11/27,ccc_311_calgary_script,2718,2497,0:01:14,74,0:08:39,221,184778
20151127-ccc_311_lobby_ph_script,2015/11/27,ccc_311_lobby_ph_script,1,0,0:00:00,0,0:00:00,1,0
20151127-ccc_aserv_info_script,2015/11/27,ccc_aserv_info_script,0,0,0:00:00,0,0:00:00,0,0
20151127-ccc_bylaw_script,2015/11/27,ccc_bylaw_script,0,0,0:00:00,0,0:00:00,0,0
20151127-ccc_city_script,2015/11/27,ccc_city_script,17,16,0:00:13,13,0:00:42,1,208
20151127-ccc_cty_online_script,2015/11/27,ccc_cty_online_script,0,0,0:00:00,0,0:00:00,0,0
20151127-ccc_feedback_script,2015/11/27,ccc_feedback_script,0,0,0:00:00,0,0:00:00,0,0
20151127-ccc_fpb_script,2015/11/27,ccc_fpb_script,2,2,0:00:06,6,0:00:08,0,12
20151127-ccc_help_script,2015/11/27,ccc_help_script,18,15,0:00:12,12,0:00:48,3,180
20151127-ccc_link_script,2015/11/27,ccc_link_script,0,0,0:00:00,0,0:00:00,0,0
20151127-ccc_media_line_script,2015/11/27,ccc_media_line_script,0,0,0:00:00,0,0:00:00,0,0
20151127-ccc_priority_script,2015/11/27,ccc_priority_script,20,20,0:00:14,14,0:01:26,0,280
20151127-ccc_tax_script,2015/11/27,ccc_tax_script,16,16,0:00:53,53,0:04:22,0,848
20151127-ccc_waste_recycling_script,2015/11/27,ccc_waste_recycling_script,0,0,0:00:00,0,0:00:00,0,0
20151128-ccc_311_calgary_script,2015/11/28,ccc_311_calgary_script,1006,968,0:00:20,20,0:04:27,38,19360
20151128-ccc_311_lobby_ph_script,2015/11/28,ccc_311_lobby_ph_script,0,0,0:00:00,0,0:00:00,0,0
20151128-ccc_aserv_info_script,2015/11/28,ccc_aserv_info_script,0,0,0:00:00,0,0:00:00,0,0
20151128-ccc_bylaw_script,2015/11/28,ccc_bylaw_script,0,0,0:00:00,0,0:00:00,0,0
20151128-ccc_city_script,2015/11/28,ccc_city_script,0,0,0:00:00,0,0:00:00,0,0
20151128-ccc_cty_online_script,2015/11/28,ccc_cty_online_script,0,0,0:00:00,0,0:00:00,0,0
20151128-ccc_feedback_script,2015/11/28,ccc_feedback_script,0,0,0:00:00,0,0:00:00,0,0
20151128-ccc_fpb_script,2015/11/28,ccc_fpb_script,0,0,0:00:00,0,0:00:00,0,0
20151128-ccc_help_script,2015/11/28,ccc_help_script,1,0,0:00:00,0,0:00:00,1,0
20151128-ccc_link_script,2015/11/28,ccc_link_script,0,0,0:00:00,0,0:00:00,0,0
20151128-ccc_media_line_script,2015/11/28,ccc_media_line_script,0,0,0:00:00,0,0:00:00,0,0
20151128-ccc_priority_script,2015/11/28,ccc_priority_script,36,35,0:00:08,8,0:00:47,1,280
20151128-ccc_tax_script,2015/11/28,ccc_tax_script,1,1,0:00:03,3,0:00:03,0,3
20151128-ccc_waste_recycling_script,2015/11/28,ccc_waste_recycling_script,0,0,0:00:00,0,0:00:00,0,0
20151129-ccc_311_calgary_script,2015/11/29,ccc_311_calgary_script,731,719,0:00:12,12,0:06:29,12,8628
20151129-ccc_311_lobby_ph_script,2015/11/29,ccc_311_lobby_ph_script,0,0,0:00:00,0,0:00:00,0,0
20151129-ccc_aserv_info_script,2015/11/29,ccc_aserv_info_script,0,0,0:00:00,0,0:00:00,0,0
20151129-ccc_bylaw_script,2015/11/29,ccc_bylaw_script,1,0,0:00:00,0,0:00:00,1,0
20151129-ccc_city_script,2015/11/29,ccc_city_script,0,0,0:00:00,0,0:00:00,0,0
20151129-ccc_cty_online_script,2015/11/29,ccc_cty_online_script,0,0,0:00:00,0,0:00:00,0,0
20151129-ccc_feedback_script,2015/11/29,ccc_feedback_script,0,0,0:00:00,0,0:00:00,0,0
20151129-ccc_fpb_script,2015/11/29,ccc_fpb_script,0,0,0:00:00,0,0:00:00,0,0
20151129-ccc_help_script,2015/11/29,ccc_help_script,1,1,0:00:03,3,0:00:03,0,3
20151129-ccc_link_script,2015/11/29,ccc_link_script,0,0,0:00:00,0,0:00:00,0,0
20151129-ccc_media_line_script,2015/11/29,ccc_media_line_script,0,0,0:00:00,0,0:00:00,0,0
20151129-ccc_priority_script,2015/11/29,ccc_priority_script,26,26,0:00:10,10,0:01:06,0,260
20151129-ccc_tax_script,2015/11/29,ccc_tax_script,1,1,0:00:04,4,0:00:04,0,4
20151129-ccc_waste_recycling_script,2015/11/29,ccc_waste_recycling_script,0,0,0:00:00,0,0:00:00,0,0
20151130-ccc_311_calgary_script,2015/11/30,ccc_311_calgary_script,3306,3195,0:00:25,25,0:11:18,111,79875
20151130-ccc_311_lobby_ph_script,2015/11/30,ccc_311_lobby_ph_script,1,1,0:00:03,3,0:00:03,0,3
20151130-ccc_aserv_info_script,2015/11/30,ccc_aserv_info_script,0,0,0:00:00,0,0:00:00,0,0
20151130-ccc_bylaw_script,2015/11/30,ccc_bylaw_script,0,0,0:00:00,0,0:00:00,0,0
20151130-ccc_city_script,2015/11/30,ccc_city_script,17,17,0:00:07,7,0:00:22,0,119
20151130-ccc_cty_online_script,2015/11/30,ccc_cty_online_script,0,0,0:00:00,0,0:00:00,0,0
20151130-ccc_feedback_script,2015/11/30,ccc_feedback_script,1,0,0:00:00,0,0:00:00,0,0
20151130-ccc_fpb_script,2015/11/30,ccc_fpb_script,0,0,0:00:00,0,0:00:00,0,0
20151130-ccc_help_script,2015/11/30,ccc_help_script,10,9,0:00:12,12,0:00:37,1,108
20151130-ccc_link_script,2015/11/30,ccc_link_script,0,0,0:00:00,0,0:00:00,0,0
20151130-ccc_media_line_script,2015/11/30,ccc_media_line_script,1,1,0:00:02,2,0:00:02,0,2
20151130-ccc_priority_script,2015/11/30,ccc_priority_script,29,29,0:00:09,9,0:00:27,0,261
20151130-ccc_tax_script,2015/11/30,ccc_tax_script,14,12,0:00:18,18,0:01:40,2,216
20151130-ccc_waste_recycling_script,2015/11/30,ccc_waste_recycling_script,0,0,0:00:00,0,0:00:00,0,0
20151201-ccc_311_calgary_script,2015/12/01,ccc_311_calgary_script,3129,2934,0:00:59,59,0:07:04,195,173106
20151201-ccc_311_lobby_ph_script,2015/12/01,ccc_311_lobby_ph_script,5,5,0:00:11,11,0:00:22,0,55
20151201-ccc_aserv_info_script,2015/12/01,ccc_aserv_info_script,0,0,0:00:00,0,0:00:00,0,0
20151201-ccc_bylaw_script,2015/12/01,ccc_bylaw_script,0,0,0:00:00,0,0:00:00,0,0
20151201-ccc_city_script,2015/12/01,ccc_city_script,5,5,0:00:12,12,0:00:28,0,60
20151201-ccc_cty_online_script,2015/12/01,ccc_cty_online_script,0,0,0:00:00,0,0:00:00,0,0
20151201-ccc_feedback_script,2015/12/01,ccc_feedback_script,0,0,0:00:00,0,0:00:00,0,0
20151201-ccc_fpb_script,2015/12/01,ccc_fpb_script,0,0,0:00:00,0,0:00:00,0,0
20151201-ccc_help_script,2015/12/01,ccc_help_script,9,8,0:00:06,6,0:00:10,1,48
20151201-ccc_link_script,2015/12/01,ccc_link_script,0,0,0:00:00,0,0:00:00,0,0
20151201-ccc_media_line_script,2015/12/01,ccc_media_line_script,0,0,0:00:00,0,0:00:00,0,0
20151201-ccc_priority_script,2015/12/01,ccc_priority_script,28,28,0:00:11,11,0:00:40,0,308
20151201-ccc_tax_script,2015/12/01,ccc_tax_script,18,18,0:01:06,66,0:03:45,0,1188
20151201-ccc_waste_recycling_script,2015/12/01,ccc_waste_recycling_script,0,0,0:00:00,0,0:00:00,0,0
20151202-ccc_311_calgary_script,2015/12/02,ccc_311_calgary_script,2979,2746,0:01:13,73,0:09:05,233,200458
20151202-ccc_311_lobby_ph_script,2015/12/02,ccc_311_lobby_ph_script,1,1,0:00:19,19,0:00:19,0,19
20151202-ccc_aserv_info_script,2015/12/02,ccc_aserv_info_script,0,0,0:00:00,0,0:00:00,0,0
20151202-ccc_bylaw_script,2015/12/02,ccc_bylaw_script,0,0,0:00:00,0,0:00:00,0,0
20151202-ccc_city_script,2015/12/02,ccc_city_script,13,13,0:00:28,28,0:03:27,0,364
20151202-ccc_cty_online_script,2015/12/02,ccc_cty_online_script,0,0,0:00:00,0,0:00:00,0,0
20151202-ccc_feedback_script,2015/12/02,ccc_feedback_script,0,0,0:00:00,0,0:00:00,0,0
20151202-ccc_fpb_script,2015/12/02,ccc_fpb_script,0,0,0:00:00,0,0:00:00,0,0
20151202-ccc_help_script,2015/12/02,ccc_help_script,14,14,0:00:12,12,0:00:43,0,168
20151202-ccc_link_script,2015/12/02,ccc_link_script,0,0,0:00:00,0,0:00:00,0,0
20151202-ccc_media_line_script,2015/12/02,ccc_media_line_script,4,4,0:00:06,6,0:00:12,0,24
20151202-ccc_priority_script,2015/12/02,ccc_priority_script,26,25,0:00:07,7,0:00:40,1,175
20151202-ccc_tax_script,2015/12/02,ccc_tax_script,18,17,0:01:28,88,0:07:45,1,1496
20151202-ccc_waste_recycling_script,2015/12/02,ccc_waste_recycling_script,0,0,0:00:00,0,0:00:00,0,0
20151203-ccc_311_calgary_script,2015/12/03,ccc_311_calgary_script,2897,2697,0:01:02,62,0:06:21,200,167214
20151203-ccc_311_lobby_ph_script,2015/12/03,ccc_311_lobby_ph_script,0,0,0:00:00,0,0:00:00,0,0
20151203-ccc_aserv_info_script,2015/12/03,ccc_aserv_info_script,0,0,0:00:00,0,0:00:00,0,0
20151203-ccc_bylaw_script,2015/12/03,ccc_bylaw_script,0,0,0:00:00,0,0:00:00,0,0
20151203-ccc_city_script,2015/12/03,ccc_city_script,17,17,0:00:34,34,0:04:38,0,578
20151203-ccc_cty_online_script,2015/12/03,ccc_cty_online_script,0,0,0:00:00,0,0:00:00,0,0
20151203-ccc_feedback_script,2015/12/03,ccc_feedback_script,0,0,0:00:00,0,0:00:00,0,0
20151203-ccc_fpb_script,2015/12/03,ccc_fpb_script,0,0,0:00:00,0,0:00:00,0,0
20151203-ccc_help_script,2015/12/03,ccc_help_script,21,15,0:00:10,10,0:00:44,6,150
20151203-ccc_link_script,2015/12/03,ccc_link_script,0,0,0:00:00,0,0:00:00,0,0
20151203-ccc_media_line_script,2015/12/03,ccc_media_line_script,4,4,0:00:07,7,0:00:11,0,28
20151203-ccc_priority_script,2015/12/03,ccc_priority_script,34,33,0:00:17,17,0:02:53,1,561
20151203-ccc_tax_script,2015/12/03,ccc_tax_script,14,14,0:00:55,55,0:05:11,0,770
20151203-ccc_waste_recycling_script,2015/12/03,ccc_waste_recycling_script,0,0,0:00:00,0,0:00:00,0,0
20151204-ccc_311_calgary_script,2015/12/04,ccc_311_calgary_script,2713,2394,0:01:59,119,0:11:59,319,284886
20151204-ccc_311_lobby_ph_script,2015/12/04,ccc_311_lobby_ph_script,5,3,0:00:11,11,0:00:21,2,33
20151204-ccc_aserv_info_script,2015/12/04,ccc_aserv_info_script,0,0,0:00:00,0,0:00:00,0,0
20151204-ccc_bylaw_script,2015/12/04,ccc_bylaw_script,0,0,0:00:00,0,0:00:00,0,0
20151204-ccc_city_script,2015/12/04,ccc_city_script,12,12,0:00:18,18,0:00:44,0,216
20151204-ccc_cty_online_script,2015/12/04,ccc_cty_online_script,0,0,0:00:00,0,0:00:00,0,0
20151204-ccc_feedback_script,2015/12/04,ccc_feedback_script,0,0,0:00:00,0,0:00:00,0,0
20151204-ccc_fpb_script,2015/12/04,ccc_fpb_script,0,0,0:00:00,0,0:00:00,0,0
20151204-ccc_help_script,2015/12/04,ccc_help_script,10,7,0:00:16,16,0:00:36,3,112
20151204-ccc_link_script,2015/12/04,ccc_link_script,1,0,0:00:00,0,0:00:00,0,0
20151204-ccc_media_line_script,2015/12/04,ccc_media_line_script,0,0,0:00:00,0,0:00:00,0,0
20151204-ccc_priority_script,2015/12/04,ccc_priority_script,27,25,0:00:18,18,0:03:03,2,450
20151204-ccc_tax_script,2015/12/04,ccc_tax_script,17,14,0:02:25,145,0:06:32,3,2030
20151204-ccc_waste_recycling_script,2015/12/04,ccc_waste_recycling_script,0,0,0:00:00,0,0:00:00,0,0
20151205-ccc_311_calgary_script,2015/12/05,ccc_311_calgary_script,1026,927,0:00:53,53,0:06:36,99,49131
20151205-ccc_311_lobby_ph_script,2015/12/05,ccc_311_lobby_ph_script,0,0,0:00:00,0,0:00:00,0,0
20151205-ccc_aserv_info_script,2015/12/05,ccc_aserv_info_script,0,0,0:00:00,0,0:00:00,0,0
20151205-ccc_bylaw_script,2015/12/05,ccc_bylaw_script,0,0,0:00:00,0,0:00:00,0,0
20151205-ccc_city_script,2015/12/05,ccc_city_script,0,0,0:00:00,0,0:00:00,0,0
20151205-ccc_cty_online_script,2015/12/05,ccc_cty_online_script,0,0,0:00:00,0,0:00:00,0,0
20151205-ccc_feedback_script,2015/12/05,ccc_feedback_script,0,0,0:00:00,0,0:00:00,0,0
20151205-ccc_fpb_script,2015/12/05,ccc_fpb_script,0,0,0:00:00,0,0:00:00,0,0
20151205-ccc_help_script,2015/12/05,ccc_help_script,1,1,0:00:08,8,0:00:08,0,8
20151205-ccc_link_script,2015/12/05,ccc_link_script,0,0,0:00:00,0,0:00:00,0,0
20151205-ccc_media_line_script,2015/12/05,ccc_media_line_script,1,1,0:00:03,3,0:00:03,0,3
20151205-ccc_priority_script,2015/12/05,ccc_priority_script,22,22,0:00:28,28,0:03:02,0,616
20151205-ccc_tax_script,2015/12/05,ccc_tax_script,1,1,0:00:08,8,0:00:08,0,8
20151205-ccc_waste_recycling_script,2015/12/05,ccc_waste_recycling_script,0,0,0:00:00,0,0:00:00,0,0
20151206-ccc_311_calgary_script,2015/12/06,ccc_311_calgary_script,764,744,0:00:13,13,0:07:59,20,9672
20151206-ccc_311_lobby_ph_script,2015/12/06,ccc_311_lobby_ph_script,0,0,0:00:00,0,0:00:00,0,0
20151206-ccc_aserv_info_script,2015/12/06,ccc_aserv_info_script,0,0,0:00:00,0,0:00:00,0,0
20151206-ccc_bylaw_script,2015/12/06,ccc_bylaw_script,0,0,0:00:00,0,0:00:00,0,0
20151206-ccc_city_script,2015/12/06,ccc_city_script,0,0,0:00:00,0,0:00:00,0,0
20151206-ccc_cty_online_script,2015/12/06,ccc_cty_online_script,0,0,0:00:00,0,0:00:00,0,0
20151206-ccc_feedback_script,2015/12/06,ccc_feedback_script,0,0,0:00:00,0,0:00:00,0,0
20151206-ccc_fpb_script,2015/12/06,ccc_fpb_script,0,0,0:00:00,0,0:00:00,0,0
20151206-ccc_help_script,2015/12/06,ccc_help_script,0,0,0:00:00,0,0:00:00,0,0
20151206-ccc_link_script,2015/12/06,ccc_link_script,0,0,0:00:00,0,0:00:00,0,0
20151206-ccc_media_line_script,2015/12/06,ccc_media_line_script,2,2,0:00:05,5,0:00:08,0,10
20151206-ccc_priority_script,2015/12/06,ccc_priority_script,5,4,0:00:05,5,0:00:08,1,20
20151206-ccc_tax_script,2015/12/06,ccc_tax_script,0,0,0:00:00,0,0:00:00,0,0
20151206-ccc_waste_recycling_script,2015/12/06,ccc_waste_recycling_script,0,0,0:00:00,0,0:00:00,0,0
20151207-ccc_311_calgary_script,2015/12/07,ccc_311_calgary_script,3015,2957,0:00:17,17,0:03:33,58,50269
20151207-ccc_311_lobby_ph_script,2015/12/07,ccc_311_lobby_ph_script,1,1,0:00:04,4,0:00:04,0,4
20151207-ccc_aserv_info_script,2015/12/07,ccc_aserv_info_script,0,0,0:00:00,0,0:00:00,0,0
20151207-ccc_bylaw_script,2015/12/07,ccc_bylaw_script,0,0,0:00:00,0,0:00:00,0,0
20151207-ccc_city_script,2015/12/07,ccc_city_script,30,30,0:00:07,7,0:00:20,0,210
20151207-ccc_cty_online_script,2015/12/07,ccc_cty_online_script,0,0,0:00:00,0,0:00:00,0,0
20151207-ccc_feedback_script,2015/12/07,ccc_feedback_script,0,0,0:00:00,0,0:00:00,0,0
20151207-ccc_fpb_script,2015/12/07,ccc_fpb_script,0,0,0:00:00,0,0:00:00,0,0
20151207-ccc_help_script,2015/12/07,ccc_help_script,7,7,0:00:09,9,0:00:14,0,63
20151207-ccc_link_script,2015/12/07,ccc_link_script,0,0,0:00:00,0,0:00:00,0,0
20151207-ccc_media_line_script,2015/12/07,ccc_media_line_script,0,0,0:00:00,0,0:00:00,0,0
20151207-ccc_priority_script,2015/12/07,ccc_priority_script,28,27,0:00:07,7,0:00:20,1,189
20151207-ccc_tax_script,2015/12/07,ccc_tax_script,19,18,0:00:12,12,0:02:02,1,216
20151207-ccc_waste_recycling_script,2015/12/07,ccc_waste_recycling_script,0,0,0:00:00,0,0:00:00,0,0
20151208-ccc_311_calgary_script,2015/12/08,ccc_311_calgary_script,2955,2754,0:01:05,65,0:06:07,201,179010
20151208-ccc_311_lobby_ph_script,2015/12/08,ccc_311_lobby_ph_script,4,2,0:00:04,4,0:00:04,2,8
20151208-ccc_aserv_info_script,2015/12/08,ccc_aserv_info_script,0,0,0:00:00,0,0:00:00,0,0
20151208-ccc_bylaw_script,2015/12/08,ccc_bylaw_script,0,0,0:00:00,0,0:00:00,0,0
20151208-ccc_city_script,2015/12/08,ccc_city_script,13,13,0:00:41,41,0:03:17,0,533
20151208-ccc_cty_online_script,2015/12/08,ccc_cty_online_script,0,0,0:00:00,0,0:00:00,0,0
20151208-ccc_feedback_script,2015/12/08,ccc_feedback_script,0,0,0:00:00,0,0:00:00,0,0
20151208-ccc_fpb_script,2015/12/08,ccc_fpb_script,0,0,0:00:00,0,0:00:00,0,0
20151208-ccc_help_script,2015/12/08,ccc_help_script,1,1,0:00:38,38,0:00:38,0,38
20151208-ccc_link_script,2015/12/08,ccc_link_script,0,0,0:00:00,0,0:00:00,0,0
20151208-ccc_media_line_script,2015/12/08,ccc_media_line_script,0,0,0:00:00,0,0:00:00,0,0
20151208-ccc_priority_script,2015/12/08,ccc_priority_script,15,15,0:00:06,6,0:00:13,0,90
20151208-ccc_tax_script,2015/12/08,ccc_tax_script,11,10,0:01:20,80,0:04:59,1,800
20151208-ccc_waste_recycling_script,2015/12/08,ccc_waste_recycling_script,0,0,0:00:00,0,0:00:00,0,0
20151209-ccc_311_calgary_script,2015/12/09,ccc_311_calgary_script,2745,2669,0:00:28,28,0:05:38,76,74732
20151209-ccc_311_lobby_ph_script,2015/12/09,ccc_311_lobby_ph_script,1,0,0:00:00,0,0:00:00,1,0
20151209-ccc_aserv_info_script,2015/12/09,ccc_aserv_info_script,0,0,0:00:00,0,0:00:00,0,0
20151209-ccc_bylaw_script,2015/12/09,ccc_bylaw_script,0,0,0:00:00,0,0:00:00,0,0
20151209-ccc_city_script,2015/12/09,ccc_city_script,21,19,0:00:06,6,0:00:36,2,114
20151209-ccc_cty_online_script,2015/12/09,ccc_cty_online_script,0,0,0:00:00,0,0:00:00,0,0
20151209-ccc_feedback_script,2015/12/09,ccc_feedback_script,0,0,0:00:00,0,0:00:00,0,0
20151209-ccc_fpb_script,2015/12/09,ccc_fpb_script,1,1,0:00:11,11,0:00:11,0,11
20151209-ccc_help_script,2015/12/09,ccc_help_script,6,6,0:00:06,6,0:00:10,0,36
20151209-ccc_link_script,2015/12/09,ccc_link_script,0,0,0:00:00,0,0:00:00,0,0
20151209-ccc_media_line_script,2015/12/09,ccc_media_line_script,1,1,0:00:07,7,0:00:07,0,7
20151209-ccc_priority_script,2015/12/09,ccc_priority_script,17,15,0:00:07,7,0:00:28,2,105
20151209-ccc_tax_script,2015/12/09,ccc_tax_script,15,13,0:00:44,44,0:03:29,2,572
20151209-ccc_waste_recycling_script,2015/12/09,ccc_waste_recycling_script,0,0,0:00:00,0,0:00:00,0,0
20151210-ccc_311_calgary_script,2015/12/10,ccc_311_calgary_script,2558,2506,0:00:16,16,0:03:14,52,40096
20151210-ccc_311_lobby_ph_script,2015/12/10,ccc_311_lobby_ph_script,3,3,0:00:04,4,0:00:06,0,12
20151210-ccc_aserv_info_script,2015/12/10,ccc_aserv_info_script,0,0,0:00:00,0,0:00:00,0,0
20151210-ccc_bylaw_script,2015/12/10,ccc_bylaw_script,0,0,0:00:00,0,0:00:00,0,0
20151210-ccc_city_script,2015/12/10,ccc_city_script,23,22,0:00:08,8,0:00:20,1,176
20151210-ccc_cty_online_script,2015/12/10,ccc_cty_online_script,0,0,0:00:00,0,0:00:00,0,0
20151210-ccc_feedback_script,2015/12/10,ccc_feedback_script,0,0,0:00:00,0,0:00:00,0,0
20151210-ccc_fpb_script,2015/12/10,ccc_fpb_script,2,2,0:00:03,3,0:00:03,0,6
20151210-ccc_help_script,2015/12/10,ccc_help_script,20,16,0:00:07,7,0:00:21,4,112
20151210-ccc_link_script,2015/12/10,ccc_link_script,0,0,0:00:00,0,0:00:00,0,0
20151210-ccc_media_line_script,2015/12/10,ccc_media_line_script,1,1,0:00:04,4,0:00:04,0,4
20151210-ccc_priority_script,2015/12/10,ccc_priority_script,20,18,0:00:06,6,0:00:11,2,108
20151210-ccc_tax_script,2015/12/10,ccc_tax_script,19,19,0:00:24,24,0:02:30,0,456
20151210-ccc_waste_recycling_script,2015/12/10,ccc_waste_recycling_script,0,0,0:00:00,0,0:00:00,0,0
20151211-ccc_311_calgary_script,2015/12/11,ccc_311_calgary_script,2307,2275,0:00:10,10,0:04:22,32,22750
20151211-ccc_311_lobby_ph_script,2015/12/11,ccc_311_lobby_ph_script,1,1,0:00:09,9,0:00:09,0,9
20151211-ccc_aserv_info_script,2015/12/11,ccc_aserv_info_script,0,0,0:00:00,0,0:00:00,0,0
20151211-ccc_bylaw_script,2015/12/11,ccc_bylaw_script,0,0,0:00:00,0,0:00:00,0,0
20151211-ccc_city_script,2015/12/11,ccc_city_script,18,18,0:00:08,8,0:00:22,0,144
20151211-ccc_cty_online_script,2015/12/11,ccc_cty_online_script,0,0,0:00:00,0,0:00:00,0,0
20151211-ccc_feedback_script,2015/12/11,ccc_feedback_script,0,0,0:00:00,0,0:00:00,0,0
20151211-ccc_fpb_script,2015/12/11,ccc_fpb_script,0,0,0:00:00,0,0:00:00,0,0
20151211-ccc_help_script,2015/12/11,ccc_help_script,6,6,0:00:16,16,0:00:35,0,96
20151211-ccc_link_script,2015/12/11,ccc_link_script,0,0,0:00:00,0,0:00:00,0,0
20151211-ccc_media_line_script,2015/12/11,ccc_media_line_script,0,0,0:00:00,0,0:00:00,0,0
20151211-ccc_priority_script,2015/12/11,ccc_priority_script,21,21,0:00:09,9,0:01:07,0,189
20151211-ccc_tax_script,2015/12/11,ccc_tax_script,6,6,0:00:07,7,0:00:11,0,42
20151211-ccc_waste_recycling_script,2015/12/11,ccc_waste_recycling_script,0,0,0:00:00,0,0:00:00,0,0
20151212-ccc_311_calgary_script,2015/12/12,ccc_311_calgary_script,914,904,0:00:11,11,0:03:01,10,9944
20151212-ccc_311_lobby_ph_script,2015/12/12,ccc_311_lobby_ph_script,0,0,0:00:00,0,0:00:00,0,0
20151212-ccc_aserv_info_script,2015/12/12,ccc_aserv_info_script,0,0,0:00:00,0,0:00:00,0,0
20151212-ccc_bylaw_script,2015/12/12,ccc_bylaw_script,0,0,0:00:00,0,0:00:00,0,0
20151212-ccc_city_script,2015/12/12,ccc_city_script,0,0,0:00:00,0,0:00:00,0,0
20151212-ccc_cty_online_script,2015/12/12,ccc_cty_online_script,0,0,0:00:00,0,0:00:00,0,0
20151212-ccc_feedback_script,2015/12/12,ccc_feedback_script,0,0,0:00:00,0,0:00:00,0,0
20151212-ccc_fpb_script,2015/12/12,ccc_fpb_script,0,0,0:00:00,0,0:00:00,0,0
20151212-ccc_help_script,2015/12/12,ccc_help_script,1,1,0:00:02,2,0:00:02,0,2
20151212-ccc_link_script,2015/12/12,ccc_link_script,0,0,0:00:00,0,0:00:00,0,0
20151212-ccc_media_line_script,2015/12/12,ccc_media_line_script,3,3,0:00:06,6,0:00:09,0,18
20151212-ccc_priority_script,2015/12/12,ccc_priority_script,24,22,0:00:11,11,0:00:55,2,242
20151212-ccc_tax_script,2015/12/12,ccc_tax_script,0,0,0:00:00,0,0:00:00,0,0
20151212-ccc_waste_recycling_script,2015/12/12,ccc_waste_recycling_script,0,0,0:00:00,0,0:00:00,0,0
20151213-ccc_311_calgary_script,2015/12/13,ccc_311_calgary_script,660,647,0:00:14,14,0:11:18,13,9058
20151213-ccc_311_lobby_ph_script,2015/12/13,ccc_311_lobby_ph_script,0,0,0:00:00,0,0:00:00,0,0
20151213-ccc_aserv_info_script,2015/12/13,ccc_aserv_info_script,0,0,0:00:00,0,0:00:00,0,0
20151213-ccc_bylaw_script,2015/12/13,ccc_bylaw_script,0,0,0:00:00,0,0:00:00,0,0
20151213-ccc_city_script,2015/12/13,ccc_city_script,0,0,0:00:00,0,0:00:00,0,0
20151213-ccc_cty_online_script,2015/12/13,ccc_cty_online_script,0,0,0:00:00,0,0:00:00,0,0
20151213-ccc_feedback_script,2015/12/13,ccc_feedback_script,0,0,0:00:00,0,0:00:00,0,0
20151213-ccc_fpb_script,2015/12/13,ccc_fpb_script,0,0,0:00:00,0,0:00:00,0,0
20151213-ccc_help_script,2015/12/13,ccc_help_script,0,0,0:00:00,0,0:00:00,0,0
20151213-ccc_link_script,2015/12/13,ccc_link_script,0,0,0:00:00,0,0:00:00,0,0
20151213-ccc_media_line_script,2015/12/13,ccc_media_line_script,0,0,0:00:00,0,0:00:00,0,0
20151213-ccc_priority_script,2015/12/13,ccc_priority_script,16,16,0:00:07,7,0:00:19,0,112
20151213-ccc_tax_script,2015/12/13,ccc_tax_script,0,0,0:00:00,0,0:00:00,0,0
20151213-ccc_waste_recycling_script,2015/12/13,ccc_waste_recycling_script,0,0,0:00:00,0,0:00:00,0,0
20151214-ccc_311_calgary_script,2015/12/14,ccc_311_calgary_script,2744,2695,0:00:17,17,0:02:52,49,45815
20151214-ccc_311_lobby_ph_script,2015/12/14,ccc_311_lobby_ph_script,2,2,0:00:14,14,0:00:22,0,28
20151214-ccc_aserv_info_script,2015/12/14,ccc_aserv_info_script,0,0,0:00:00,0,0:00:00,0,0
20151214-ccc_bylaw_script,2015/12/14,ccc_bylaw_script,0,0,0:00:00,0,0:00:00,0,0
20151214-ccc_city_script,2015/12/14,ccc_city_script,16,16,0:00:07,7,0:00:27,0,112
20151214-ccc_cty_online_script,2015/12/14,ccc_cty_online_script,0,0,0:00:00,0,0:00:00,0,0
20151214-ccc_feedback_script,2015/12/14,ccc_feedback_script,0,0,0:00:00,0,0:00:00,0,0
20151214-ccc_fpb_script,2015/12/14,ccc_fpb_script,2,2,0:00:06,6,0:00:07,0,12
20151214-ccc_help_script,2015/12/14,ccc_help_script,9,8,0:00:07,7,0:00:13,1,56
20151214-ccc_link_script,2015/12/14,ccc_link_script,0,0,0:00:00,0,0:00:00,0,0
20151214-ccc_media_line_script,2015/12/14,ccc_media_line_script,0,0,0:00:00,0,0:00:00,0,0
20151214-ccc_priority_script,2015/12/14,ccc_priority_script,20,19,0:00:10,10,0:00:33,1,190
20151214-ccc_tax_script,2015/12/14,ccc_tax_script,16,15,0:00:41,41,0:02:37,1,615
20151214-ccc_waste_recycling_script,2015/12/14,ccc_waste_recycling_script,0,0,0:00:00,0,0:00:00,0,0
20151215-ccc_311_calgary_script,2015/12/15,ccc_311_calgary_script,2687,2506,0:00:57,57,0:06:39,181,142842
20151215-ccc_311_lobby_ph_script,2015/12/15,ccc_311_lobby_ph_script,2,2,0:00:11,11,0:00:14,0,22
20151215-ccc_aserv_info_script,2015/12/15,ccc_aserv_info_script,0,0,0:00:00,0,0:00:00,0,0
20151215-ccc_bylaw_script,2015/12/15,ccc_bylaw_script,0,0,0:00:00,0,0:00:00,0,0
20151215-ccc_city_script,2015/12/15,ccc_city_script,13,12,0:00:18,18,0:00:59,1,216
20151215-ccc_cty_online_script,2015/12/15,ccc_cty_online_script,0,0,0:00:00,0,0:00:00,0,0
20151215-ccc_feedback_script,2015/12/15,ccc_feedback_script,0,0,0:00:00,0,0:00:00,0,0
20151215-ccc_fpb_script,2015/12/15,ccc_fpb_script,0,0,0:00:00,0,0:00:00,0,0
20151215-ccc_help_script,2015/12/15,ccc_help_script,1,1,0:00:18,18,0:00:18,0,18
20151215-ccc_link_script,2015/12/15,ccc_link_script,0,0,0:00:00,0,0:00:00,0,0
20151215-ccc_media_line_script,2015/12/15,ccc_media_line_script,3,3,0:00:06,6,0:00:10,0,18
20151215-ccc_priority_script,2015/12/15,ccc_priority_script,21,21,0:00:13,13,0:01:10,0,273
20151215-ccc_tax_script,2015/12/15,ccc_tax_script,20,18,0:01:14,74,0:04:44,2,1332
20151215-ccc_waste_recycling_script,2015/12/15,ccc_waste_recycling_script,0,0,0:00:00,0,0:00:00,0,0
20151216-ccc_311_calgary_script,2015/12/16,ccc_311_calgary_script,2653,2582,0:00:18,18,0:06:02,71,46476
20151216-ccc_311_lobby_ph_script,2015/12/16,ccc_311_lobby_ph_script,5,4,0:00:06,6,0:00:14,1,24
20151216-ccc_aserv_info_script,2015/12/16,ccc_aserv_info_script,0,0,0:00:00,0,0:00:00,0,0
20151216-ccc_bylaw_script,2015/12/16,ccc_bylaw_script,0,0,0:00:00,0,0:00:00,0,0
20151216-ccc_city_script,2015/12/16,ccc_city_script,10,9,0:00:06,6,0:00:17,1,54
20151216-ccc_cty_online_script,2015/12/16,ccc_cty_online_script,0,0,0:00:00,0,0:00:00,0,0
20151216-ccc_feedback_script,2015/12/16,ccc_feedback_script,0,0,0:00:00,0,0:00:00,0,0
20151216-ccc_fpb_script,2015/12/16,ccc_fpb_script,0,0,0:00:00,0,0:00:00,0,0
20151216-ccc_help_script,2015/12/16,ccc_help_script,4,4,0:00:24,24,0:00:40,0,96
20151216-ccc_link_script,2015/12/16,ccc_link_script,0,0,0:00:00,0,0:00:00,0,0
20151216-ccc_media_line_script,2015/12/16,ccc_media_line_script,2,1,0:00:13,13,0:00:13,1,13
20151216-ccc_priority_script,2015/12/16,ccc_priority_script,36,35,0:00:12,12,0:00:44,1,420
20151216-ccc_tax_script,2015/12/16,ccc_tax_script,26,26,0:00:11,11,0:01:23,0,286
20151216-ccc_waste_recycling_script,2015/12/16,ccc_waste_recycling_script,0,0,0:00:00,0,0:00:00,0,0
20151217-ccc_311_calgary_script,2015/12/17,ccc_311_calgary_script,2643,2539,0:00:26,26,0:07:11,103,66014
20151217-ccc_311_lobby_ph_script,2015/12/17,ccc_311_lobby_ph_script,3,3,0:00:07,7,0:00:15,0,21
20151217-ccc_aserv_info_script,2015/12/17,ccc_aserv_info_script,0,0,0:00:00,0,0:00:00,0,0
20151217-ccc_bylaw_script,2015/12/17,ccc_bylaw_script,0,0,0:00:00,0,0:00:00,0,0
20151217-ccc_city_script,2015/12/17,ccc_city_script,10,10,0:00:10,10,0:00:27,0,100
20151217-ccc_cty_online_script,2015/12/17,ccc_cty_online_script,0,0,0:00:00,0,0:00:00,0,0
20151217-ccc_feedback_script,2015/12/17,ccc_feedback_script,0,0,0:00:00,0,0:00:00,0,0
20151217-ccc_fpb_script,2015/12/17,ccc_fpb_script,0,0,0:00:00,0,0:00:00,0,0
20151217-ccc_help_script,2015/12/17,ccc_help_script,4,4,0:00:17,17,0:00:40,0,68
20151217-ccc_link_script,2015/12/17,ccc_link_script,0,0,0:00:00,0,0:00:00,0,0
20151217-ccc_media_line_script,2015/12/17,ccc_media_line_script,0,0,0:00:00,0,0:00:00,0,0
20151217-ccc_priority_script,2015/12/17,ccc_priority_script,27,27,0:00:11,11,0:01:44,0,297
20151217-ccc_tax_script,2015/12/17,ccc_tax_script,18,16,0:00:25,25,0:02:12,2,400
20151217-ccc_waste_recycling_script,2015/12/17,ccc_waste_recycling_script,0,0,0:00:00,0,0:00:00,0,0
20151218-ccc_311_calgary_script,2015/12/18,ccc_311_calgary_script,2520,2406,0:00:29,29,0:06:55,115,69774
20151218-ccc_311_lobby_ph_script,2015/12/18,ccc_311_lobby_ph_script,8,7,0:00:11,11,0:00:36,1,77
20151218-ccc_aserv_info_script,2015/12/18,ccc_aserv_info_script,0,0,0:00:00,0,0:00:00,0,0
20151218-ccc_bylaw_script,2015/12/18,ccc_bylaw_script,0,0,0:00:00,0,0:00:00,0,0
20151218-ccc_city_script,2015/12/18,ccc_city_script,15,13,0:00:10,10,0:00:41,2,130
20151218-ccc_cty_online_script,2015/12/18,ccc_cty_online_script,0,0,0:00:00,0,0:00:00,0,0
20151218-ccc_feedback_script,2015/12/18,ccc_feedback_script,0,0,0:00:00,0,0:00:00,0,0
20151218-ccc_fpb_script,2015/12/18,ccc_fpb_script,0,0,0:00:00,0,0:00:00,0,0
20151218-ccc_help_script,2015/12/18,ccc_help_script,5,5,0:00:11,11,0:00:41,0,55
20151218-ccc_link_script,2015/12/18,ccc_link_script,0,0,0:00:00,0,0:00:00,0,0
20151218-ccc_media_line_script,2015/12/18,ccc_media_line_script,4,4,0:00:11,11,0:00:25,0,44
20151218-ccc_priority_script,2015/12/18,ccc_priority_script,43,40,0:00:09,9,0:00:31,3,360
20151218-ccc_tax_script,2015/12/18,ccc_tax_script,21,21,0:00:37,37,0:02:52,0,777
20151218-ccc_waste_recycling_script,2015/12/18,ccc_waste_recycling_script,0,0,0:00:00,0,0:00:00,0,0
20151219-ccc_311_calgary_script,2015/12/19,ccc_311_calgary_script,976,961,0:00:12,12,0:04:28,15,11532
20151219-ccc_311_lobby_ph_script,2015/12/19,ccc_311_lobby_ph_script,0,0,0:00:00,0,0:00:00,0,0
20151219-ccc_aserv_info_script,2015/12/19,ccc_aserv_info_script,0,0,0:00:00,0,0:00:00,0,0
20151219-ccc_bylaw_script,2015/12/19,ccc_bylaw_script,0,0,0:00:00,0,0:00:00,0,0
20151219-ccc_city_script,2015/12/19,ccc_city_script,0,0,0:00:00,0,0:00:00,0,0
20151219-ccc_cty_online_script,2015/12/19,ccc_cty_online_script,0,0,0:00:00,0,0:00:00,0,0
20151219-ccc_feedback_script,2015/12/19,ccc_feedback_script,0,0,0:00:00,0,0:00:00,0,0
20151219-ccc_fpb_script,2015/12/19,ccc_fpb_script,0,0,0:00:00,0,0:00:00,0,0
20151219-ccc_help_script,2015/12/19,ccc_help_script,0,0,0:00:00,0,0:00:00,0,0
20151219-ccc_link_script,2015/12/19,ccc_link_script,0,0,0:00:00,0,0:00:00,0,0
20151219-ccc_media_line_script,2015/12/19,ccc_media_line_script,0,0,0:00:00,0,0:00:00,0,0
20151219-ccc_priority_script,2015/12/19,ccc_priority_script,36,35,0:00:09,9,0:00:54,1,315
20151219-ccc_tax_script,2015/12/19,ccc_tax_script,0,0,0:00:00,0,0:00:00,0,0
20151219-ccc_waste_recycling_script,2015/12/19,ccc_waste_recycling_script,0,0,0:00:00,0,0:00:00,0,0
20151220-ccc_311_calgary_script,2015/12/20,ccc_311_calgary_script,733,721,0:00:08,8,0:03:06,12,5768
20151220-ccc_311_lobby_ph_script,2015/12/20,ccc_311_lobby_ph_script,0,0,0:00:00,0,0:00:00,0,0
20151220-ccc_aserv_info_script,2015/12/20,ccc_aserv_info_script,0,0,0:00:00,0,0:00:00,0,0
20151220-ccc_bylaw_script,2015/12/20,ccc_bylaw_script,0,0,0:00:00,0,0:00:00,0,0
20151220-ccc_city_script,2015/12/20,ccc_city_script,0,0,0:00:00,0,0:00:00,0,0
20151220-ccc_cty_online_script,2015/12/20,ccc_cty_online_script,0,0,0:00:00,0,0:00:00,0,0
20151220-ccc_feedback_script,2015/12/20,ccc_feedback_script,0,0,0:00:00,0,0:00:00,0,0
20151220-ccc_fpb_script,2015/12/20,ccc_fpb_script,0,0,0:00:00,0,0:00:00,0,0
20151220-ccc_help_script,2015/12/20,ccc_help_script,1,1,0:00:02,2,0:00:02,0,2
20151220-ccc_link_script,2015/12/20,ccc_link_script,0,0,0:00:00,0,0:00:00,0,0
20151220-ccc_media_line_script,2015/12/20,ccc_media_line_script,1,1,0:00:04,4,0:00:04,0,4
20151220-ccc_priority_script,2015/12/20,ccc_priority_script,15,14,0:00:05,5,0:00:14,1,70
20151220-ccc_tax_script,2015/12/20,ccc_tax_script,0,0,0:00:00,0,0:00:00,0,0
20151220-ccc_waste_recycling_script,2015/12/20,ccc_waste_recycling_script,0,0,0:00:00,0,0:00:00,0,0
20151221-ccc_311_calgary_script,2015/12/21,ccc_311_calgary_script,2608,2574,0:00:13,13,0:03:54,34,33462
20151221-ccc_311_lobby_ph_script,2015/12/21,ccc_311_lobby_ph_script,5,5,0:00:07,7,0:00:17,0,35
20151221-ccc_aserv_info_script,2015/12/21,ccc_aserv_info_script,0,0,0:00:00,0,0:00:00,0,0
20151221-ccc_bylaw_script,2015/12/21,ccc_bylaw_script,0,0,0:00:00,0,0:00:00,0,0
20151221-ccc_city_script,2015/12/21,ccc_city_script,14,12,0:00:09,9,0:00:26,2,108
20151221-ccc_cty_online_script,2015/12/21,ccc_cty_online_script,0,0,0:00:00,0,0:00:00,0,0
20151221-ccc_feedback_script,2015/12/21,ccc_feedback_script,1,0,0:00:00,0,0:00:00,0,0
20151221-ccc_fpb_script,2015/12/21,ccc_fpb_script,0,0,0:00:00,0,0:00:00,0,0
20151221-ccc_help_script,2015/12/21,ccc_help_script,20,20,0:00:09,9,0:00:36,0,180
20151221-ccc_link_script,2015/12/21,ccc_link_script,0,0,0:00:00,0,0:00:00,0,0
20151221-ccc_media_line_script,2015/12/21,ccc_media_line_script,1,1,0:00:05,5,0:00:05,0,5
20151221-ccc_priority_script,2015/12/21,ccc_priority_script,24,24,0:00:07,7,0:00:22,0,168
20151221-ccc_tax_script,2015/12/21,ccc_tax_script,13,13,0:00:09,9,0:00:34,0,117
20151221-ccc_waste_recycling_script,2015/12/21,ccc_waste_recycling_script,0,0,0:00:00,0,0:00:00,0,0
20151222-ccc_311_calgary_script,2015/12/22,ccc_311_calgary_script,2529,2473,0:00:21,21,0:11:06,56,51933
20151222-ccc_311_lobby_ph_script,2015/12/22,ccc_311_lobby_ph_script,3,3,0:00:08,8,0:00:10,0,24
20151222-ccc_aserv_info_script,2015/12/22,ccc_aserv_info_script,0,0,0:00:00,0,0:00:00,0,0
20151222-ccc_bylaw_script,2015/12/22,ccc_bylaw_script,0,0,0:00:00,0,0:00:00,0,0
20151222-ccc_city_script,2015/12/22,ccc_city_script,24,24,0:00:09,9,0:00:20,0,216
20151222-ccc_cty_online_script,2015/12/22,ccc_cty_online_script,0,0,0:00:00,0,0:00:00,0,0
20151222-ccc_feedback_script,2015/12/22,ccc_feedback_script,0,0,0:00:00,0,0:00:00,0,0
20151222-ccc_fpb_script,2015/12/22,ccc_fpb_script,1,1,0:00:07,7,0:00:07,0,7
20151222-ccc_help_script,2015/12/22,ccc_help_script,6,6,0:00:10,10,0:00:34,0,60
20151222-ccc_link_script,2015/12/22,ccc_link_script,0,0,0:00:00,0,0:00:00,0,0
20151222-ccc_media_line_script,2015/12/22,ccc_media_line_script,0,0,0:00:00,0,0:00:00,0,0
20151222-ccc_priority_script,2015/12/22,ccc_priority_script,24,23,0:00:09,9,0:01:14,1,207
20151222-ccc_tax_script,2015/12/22,ccc_tax_script,13,13,0:00:19,19,0:01:03,0,247
20151222-ccc_waste_recycling_script,2015/12/22,ccc_waste_recycling_script,0,0,0:00:00,0,0:00:00,0,0
20151223-ccc_311_calgary_script,2015/12/23,ccc_311_calgary_script,2254,2221,0:00:10,10,0:04:58,31,22210
20151223-ccc_311_lobby_ph_script,2015/12/23,ccc_311_lobby_ph_script,3,3,0:00:06,6,0:00:08,0,18
20151223-ccc_aserv_info_script,2015/12/23,ccc_aserv_info_script,0,0,0:00:00,0,0:00:00,0,0
20151223-ccc_bylaw_script,2015/12/23,ccc_bylaw_script,0,0,0:00:00,0,0:00:00,0,0
20151223-ccc_city_script,2015/12/23,ccc_city_script,3,3,0:00:03,3,0:00:03,0,9
20151223-ccc_cty_online_script,2015/12/23,ccc_cty_online_script,0,0,0:00:00,0,0:00:00,0,0
20151223-ccc_feedback_script,2015/12/23,ccc_feedback_script,1,0,0:00:00,0,0:00:00,0,0
20151223-ccc_fpb_script,2015/12/23,ccc_fpb_script,0,0,0:00:00,0,0:00:00,0,0
20151223-ccc_help_script,2015/12/23,ccc_help_script,8,7,0:00:19,19,0:01:05,1,133
20151223-ccc_link_script,2015/12/23,ccc_link_script,0,0,0:00:00,0,0:00:00,0,0
20151223-ccc_media_line_script,2015/12/23,ccc_media_line_script,2,2,0:00:55,55,0:01:40,0,110
20151223-ccc_priority_script,2015/12/23,ccc_priority_script,26,24,0:00:05,5,0:00:15,2,120
20151223-ccc_tax_script,2015/12/23,ccc_tax_script,13,13,0:00:12,12,0:01:34,0,156
20151223-ccc_waste_recycling_script,2015/12/23,ccc_waste_recycling_script,0,0,0:00:00,0,0:00:00,0,0
20151224-ccc_311_calgary_script,2015/12/24,ccc_311_calgary_script,1342,1327,0:00:10,10,0:06:09,17,13270
20151224-ccc_311_lobby_ph_script,2015/12/24,ccc_311_lobby_ph_script,1,1,0:00:05,5,0:00:05,0,5
20151224-ccc_aserv_info_script,2015/12/24,ccc_aserv_info_script,0,0,0:00:00,0,0:00:00,0,0
20151224-ccc_bylaw_script,2015/12/24,ccc_bylaw_script,1,1,0:00:10,10,0:00:10,0,10
20151224-ccc_city_script,2015/12/24,ccc_city_script,1,1,0:00:10,10,0:00:10,0,10
20151224-ccc_cty_online_script,2015/12/24,ccc_cty_online_script,0,0,0:00:00,0,0:00:00,0,0
20151224-ccc_feedback_script,2015/12/24,ccc_feedback_script,0,0,0:00:00,0,0:00:00,0,0
20151224-ccc_fpb_script,2015/12/24,ccc_fpb_script,0,0,0:00:00,0,0:00:00,0,0
20151224-ccc_help_script,2015/12/24,ccc_help_script,6,5,0:00:06,6,0:00:09,1,30
20151224-ccc_link_script,2015/12/24,ccc_link_script,0,0,0:00:00,0,0:00:00,0,0
20151224-ccc_media_line_script,2015/12/24,ccc_media_line_script,8,6,0:00:05,5,0:00:09,2,30
20151224-ccc_priority_script,2015/12/24,ccc_priority_script,47,45,0:00:11,11,0:01:58,2,495
20151224-ccc_tax_script,2015/12/24,ccc_tax_script,0,0,0:00:00,0,0:00:00,0,0
20151224-ccc_waste_recycling_script,2015/12/24,ccc_waste_recycling_script,0,0,0:00:00,0,0:00:00,0,0
20151225-ccc_311_calgary_script,2015/12/25,ccc_311_calgary_script,462,455,0:00:09,9,0:02:50,7,4095
20151225-ccc_311_lobby_ph_script,2015/12/25,ccc_311_lobby_ph_script,0,0,0:00:00,0,0:00:00,0,0
20151225-ccc_aserv_info_script,2015/12/25,ccc_aserv_info_script,0,0,0:00:00,0,0:00:00,0,0
20151225-ccc_bylaw_script,2015/12/25,ccc_bylaw_script,0,0,0:00:00,0,0:00:00,0,0
20151225-ccc_city_script,2015/12/25,ccc_city_script,0,0,0:00:00,0,0:00:00,0,0
20151225-ccc_cty_online_script,2015/12/25,ccc_cty_online_script,0,0,0:00:00,0,0:00:00,0,0
20151225-ccc_feedback_script,2015/12/25,ccc_feedback_script,0,0,0:00:00,0,0:00:00,0,0
20151225-ccc_fpb_script,2015/12/25,ccc_fpb_script,0,0,0:00:00,0,0:00:00,0,0
20151225-ccc_help_script,2015/12/25,ccc_help_script,0,0,0:00:00,0,0:00:00,0,0
20151225-ccc_link_script,2015/12/25,ccc_link_script,0,0,0:00:00,0,0:00:00,0,0
20151225-ccc_media_line_script,2015/12/25,ccc_media_line_script,1,1,0:00:04,4,0:00:04,0,4
20151225-ccc_priority_script,2015/12/25,ccc_priority_script,56,55,0:00:06,6,0:00:18,1,330
20151225-ccc_tax_script,2015/12/25,ccc_tax_script,0,0,0:00:00,0,0:00:00,0,0
20151225-ccc_waste_recycling_script,2015/12/25,ccc_waste_recycling_script,0,0,0:00:00,0,0:00:00,0,0
20151226-ccc_311_calgary_script,2015/12/26,ccc_311_calgary_script,801,784,0:00:17,17,0:05:47,17,13328
20151226-ccc_311_lobby_ph_script,2015/12/26,ccc_311_lobby_ph_script,0,0,0:00:00,0,0:00:00,0,0
20151226-ccc_aserv_info_script,2015/12/26,ccc_aserv_info_script,0,0,0:00:00,0,0:00:00,0,0
20151226-ccc_bylaw_script,2015/12/26,ccc_bylaw_script,0,0,0:00:00,0,0:00:00,0,0
20151226-ccc_city_script,2015/12/26,ccc_city_script,0,0,0:00:00,0,0:00:00,0,0
20151226-ccc_cty_online_script,2015/12/26,ccc_cty_online_script,0,0,0:00:00,0,0:00:00,0,0
20151226-ccc_feedback_script,2015/12/26,ccc_feedback_script,0,0,0:00:00,0,0:00:00,0,0
20151226-ccc_fpb_script,2015/12/26,ccc_fpb_script,0,0,0:00:00,0,0:00:00,0,0
20151226-ccc_help_script,2015/12/26,ccc_help_script,0,0,0:00:00,0,0:00:00,0,0
20151226-ccc_link_script,2015/12/26,ccc_link_script,0,0,0:00:00,0,0:00:00,0,0
20151226-ccc_media_line_script,2015/12/26,ccc_media_line_script,1,1,0:00:05,5,0:00:05,0,5
20151226-ccc_priority_script,2015/12/26,ccc_priority_script,46,45,0:00:07,7,0:01:01,1,315
20151226-ccc_tax_script,2015/12/26,ccc_tax_script,0,0,0:00:00,0,0:00:00,0,0
20151226-ccc_waste_recycling_script,2015/12/26,ccc_waste_recycling_script,0,0,0:00:00,0,0:00:00,0,0
20151227-ccc_311_calgary_script,2015/12/27,ccc_311_calgary_script,832,819,0:00:07,7,0:01:33,13,5733
20151227-ccc_311_lobby_ph_script,2015/12/27,ccc_311_lobby_ph_script,0,0,0:00:00,0,0:00:00,0,0
20151227-ccc_aserv_info_script,2015/12/27,ccc_aserv_info_script,0,0,0:00:00,0,0:00:00,0,0
20151227-ccc_bylaw_script,2015/12/27,ccc_bylaw_script,0,0,0:00:00,0,0:00:00,0,0
20151227-ccc_city_script,2015/12/27,ccc_city_script,0,0,0:00:00,0,0:00:00,0,0
20151227-ccc_cty_online_script,2015/12/27,ccc_cty_online_script,0,0,0:00:00,0,0:00:00,0,0
20151227-ccc_feedback_script,2015/12/27,ccc_feedback_script,0,0,0:00:00,0,0:00:00,0,0
20151227-ccc_fpb_script,2015/12/27,ccc_fpb_script,0,0,0:00:00,0,0:00:00,0,0
20151227-ccc_help_script,2015/12/27,ccc_help_script,0,0,0:00:00,0,0:00:00,0,0
20151227-ccc_link_script,2015/12/27,ccc_link_script,0,0,0:00:00,0,0:00:00,0,0
20151227-ccc_media_line_script,2015/12/27,ccc_media_line_script,1,1,0:00:03,3,0:00:03,0,3
20151227-ccc_priority_script,2015/12/27,ccc_priority_script,24,24,0:00:06,6,0:00:30,0,144
20151227-ccc_tax_script,2015/12/27,ccc_tax_script,0,0,0:00:00,0,0:00:00,0,0
20151227-ccc_waste_recycling_script,2015/12/27,ccc_waste_recycling_script,0,0,0:00:00,0,0:00:00,0,0
20151228-ccc_311_calgary_script,2015/12/28,ccc_311_calgary_script,2095,2085,0:00:07,7,0:02:02,10,14595
20151228-ccc_311_lobby_ph_script,2015/12/28,ccc_311_lobby_ph_script,2,2,0:00:03,3,0:00:03,0,6
20151228-ccc_aserv_info_script,2015/12/28,ccc_aserv_info_script,0,0,0:00:00,0,0:00:00,0,0
20151228-ccc_bylaw_script,2015/12/28,ccc_bylaw_script,0,0,0:00:00,0,0:00:00,0,0
20151228-ccc_city_script,2015/12/28,ccc_city_script,8,8,0:00:06,6,0:00:13,0,48
20151228-ccc_cty_online_script,2015/12/28,ccc_cty_online_script,0,0,0:00:00,0,0:00:00,0,0
20151228-ccc_feedback_script,2015/12/28,ccc_feedback_script,0,0,0:00:00,0,0:00:00,0,0
20151228-ccc_fpb_script,2015/12/28,ccc_fpb_script,0,0,0:00:00,0,0:00:00,0,0
20151228-ccc_help_script,2015/12/28,ccc_help_script,8,8,0:00:12,12,0:00:41,0,96
20151228-ccc_link_script,2015/12/28,ccc_link_script,0,0,0:00:00,0,0:00:00,0,0
20151228-ccc_media_line_script,2015/12/28,ccc_media_line_script,5,4,0:00:05,5,0:00:09,1,20
20151228-ccc_priority_script,2015/12/28,ccc_priority_script,27,27,0:00:14,14,0:01:33,0,378
20151228-ccc_tax_script,2015/12/28,ccc_tax_script,2,2,0:00:03,3,0:00:03,0,6
20151228-ccc_waste_recycling_script,2015/12/28,ccc_waste_recycling_script,0,0,0:00:00,0,0:00:00,0,0
20151229-ccc_311_calgary_script,2015/12/29,ccc_311_calgary_script,2359,2319,0:00:13,13,0:02:50,40,30147
20151229-ccc_311_lobby_ph_script,2015/12/29,ccc_311_lobby_ph_script,0,0,0:00:00,0,0:00:00,0,0
20151229-ccc_aserv_info_script,2015/12/29,ccc_aserv_info_script,0,0,0:00:00,0,0:00:00,0,0
20151229-ccc_bylaw_script,2015/12/29,ccc_bylaw_script,0,0,0:00:00,0,0:00:00,0,0
20151229-ccc_city_script,2015/12/29,ccc_city_script,18,18,0:00:09,9,0:00:28,0,162
20151229-ccc_cty_online_script,2015/12/29,ccc_cty_online_script,0,0,0:00:00,0,0:00:00,0,0
20151229-ccc_feedback_script,2015/12/29,ccc_feedback_script,0,0,0:00:00,0,0:00:00,0,0
20151229-ccc_fpb_script,2015/12/29,ccc_fpb_script,0,0,0:00:00,0,0:00:00,0,0
20151229-ccc_help_script,2015/12/29,ccc_help_script,7,7,0:00:12,12,0:00:36,0,84
20151229-ccc_link_script,2015/12/29,ccc_link_script,0,0,0:00:00,0,0:00:00,0,0
20151229-ccc_media_line_script,2015/12/29,ccc_media_line_script,0,0,0:00:00,0,0:00:00,0,0
20151229-ccc_priority_script,2015/12/29,ccc_priority_script,31,31,0:00:08,8,0:00:47,0,248
20151229-ccc_tax_script,2015/12/29,ccc_tax_script,3,3,0:00:08,8,0:00:10,0,24
20151229-ccc_waste_recycling_script,2015/12/29,ccc_waste_recycling_script,0,0,0:00:00,0,0:00:00,0,0
20151230-ccc_311_calgary_script,2015/12/30,ccc_311_calgary_script,2374,2298,0:00:24,24,0:04:02,76,55152
20151230-ccc_311_lobby_ph_script,2015/12/30,ccc_311_lobby_ph_script,1,1,0:00:09,9,0:00:09,0,9
20151230-ccc_aserv_info_script,2015/12/30,ccc_aserv_info_script,0,0,0:00:00,0,0:00:00,0,0
20151230-ccc_bylaw_script,2015/12/30,ccc_bylaw_script,0,0,0:00:00,0,0:00:00,0,0
20151230-ccc_city_script,2015/12/30,ccc_city_script,12,12,0:00:09,9,0:00:26,0,108
20151230-ccc_cty_online_script,2015/12/30,ccc_cty_online_script,0,0,0:00:00,0,0:00:00,0,0
20151230-ccc_feedback_script,2015/12/30,ccc_feedback_script,0,0,0:00:00,0,0:00:00,0,0
20151230-ccc_fpb_script,2015/12/30,ccc_fpb_script,0,0,0:00:00,0,0:00:00,0,0
20151230-ccc_help_script,2015/12/30,ccc_help_script,15,13,0:00:10,10,0:00:20,2,130
20151230-ccc_link_script,2015/12/30,ccc_link_script,0,0,0:00:00,0,0:00:00,0,0
20151230-ccc_media_line_script,2015/12/30,ccc_media_line_script,0,0,0:00:00,0,0:00:00,0,0
20151230-ccc_priority_script,2015/12/30,ccc_priority_script,23,22,0:00:10,10,0:01:00,1,220
20151230-ccc_tax_script,2015/12/30,ccc_tax_script,5,5,0:00:36,36,0:01:57,0,180
20151230-ccc_waste_recycling_script,2015/12/30,ccc_waste_recycling_script,0,0,0:00:00,0,0:00:00,0,0
20151231-ccc_311_calgary_script,2015/12/31,ccc_311_calgary_script,2059,2026,0:00:11,11,0:02:25,33,22286
20151231-ccc_311_lobby_ph_script,2015/12/31,ccc_311_lobby_ph_script,2,1,0:00:05,5,0:00:05,1,5
20151231-ccc_aserv_info_script,2015/12/31,ccc_aserv_info_script,0,0,0:00:00,0,0:00:00,0,0
20151231-ccc_bylaw_script,2015/12/31,ccc_bylaw_script,0,0,0:00:00,0,0:00:00,0,0
20151231-ccc_city_script,2015/12/31,ccc_city_script,7,7,0:00:08,8,0:00:18,0,56
20151231-ccc_cty_online_script,2015/12/31,ccc_cty_online_script,0,0,0:00:00,0,0:00:00,0,0
20151231-ccc_feedback_script,2015/12/31,ccc_feedback_script,0,0,0:00:00,0,0:00:00,0,0
20151231-ccc_fpb_script,2015/12/31,ccc_fpb_script,0,0,0:00:00,0,0:00:00,0,0
20151231-ccc_help_script,2015/12/31,ccc_help_script,10,10,0:00:12,12,0:00:55,0,120
20151231-ccc_link_script,2015/12/31,ccc_link_script,0,0,0:00:00,0,0:00:00,0,0
20151231-ccc_media_line_script,2015/12/31,ccc_media_line_script,0,0,0:00:00,0,0:00:00,0,0
20151231-ccc_priority_script,2015/12/31,ccc_priority_script,18,18,0:00:07,7,0:00:14,0,126
20151231-ccc_tax_script,2015/12/31,ccc_tax_script,1,1,0:00:05,5,0:00:05,0,5
20151231-ccc_waste_recycling_script,2015/12/31,ccc_waste_recycling_script,0,0,0:00:00,0,0:00:00,0,0
20160101-ccc_311_calgary_script,2016/01/01,ccc_311_calgary_script,733,667,0:00:39,39,0:09:57,63,26013
20160101-ccc_311_lobby_ph_script,2016/01/01,ccc_311_lobby_ph_script,0,0,0:00:00,0,0:00:00,0,0
20160101-ccc_aserv_info_script,2016/01/01,ccc_aserv_info_script,0,0,0:00:00,0,0:00:00,0,0
20160101-ccc_bylaw_script,2016/01/01,ccc_bylaw_script,0,0,0:00:00,0,0:00:00,0,0
20160101-ccc_city_script,2016/01/01,ccc_city_script,0,0,0:00:00,0,0:00:00,0,0
20160101-ccc_cty_online_script,2016/01/01,ccc_cty_online_script,0,0,0:00:00,0,0:00:00,0,0
20160101-ccc_feedback_script,2016/01/01,ccc_feedback_script,0,0,0:00:00,0,0:00:00,0,0
20160101-ccc_fpb_script,2016/01/01,ccc_fpb_script,0,0,0:00:00,0,0:00:00,0,0
20160101-ccc_help_script,2016/01/01,ccc_help_script,0,0,0:00:00,0,0:00:00,0,0
20160101-ccc_link_script,2016/01/01,ccc_link_script,0,0,0:00:00,0,0:00:00,0,0
20160101-ccc_media_line_script,2016/01/01,ccc_media_line_script,0,0,0:00:00,0,0:00:00,0,0
20160101-ccc_priority_script,2016/01/01,ccc_priority_script,22,20,0:00:28,28,0:03:22,2,560
20160101-ccc_tax_script,2016/01/01,ccc_tax_script,0,0,0:00:00,0,0:00:00,0,0
20160101-ccc_waste_recycling_script,2016/01/01,ccc_waste_recycling_script,0,0,0:00:00,0,0:00:00,0,0
20160102-ccc_311_calgary_script,2016/01/02,ccc_311_calgary_script,992,953,0:00:24,24,0:05:50,39,22872
20160102-ccc_311_lobby_ph_script,2016/01/02,ccc_311_lobby_ph_script,0,0,0:00:00,0,0:00:00,0,0
20160102-ccc_aserv_info_script,2016/01/02,ccc_aserv_info_script,0,0,0:00:00,0,0:00:00,0,0
20160102-ccc_bylaw_script,2016/01/02,ccc_bylaw_script,0,0,0:00:00,0,0:00:00,0,0
20160102-ccc_city_script,2016/01/02,ccc_city_script,0,0,0:00:00,0,0:00:00,0,0
20160102-ccc_cty_online_script,2016/01/02,ccc_cty_online_script,0,0,0:00:00,0,0:00:00,0,0
20160102-ccc_feedback_script,2016/01/02,ccc_feedback_script,0,0,0:00:00,0,0:00:00,0,0
20160102-ccc_fpb_script,2016/01/02,ccc_fpb_script,0,0,0:00:00,0,0:00:00,0,0
20160102-ccc_help_script,2016/01/02,ccc_help_script,1,1,0:00:07,7,0:00:07,0,7
20160102-ccc_link_script,2016/01/02,ccc_link_script,0,0,0:00:00,0,0:00:00,0,0
20160102-ccc_media_line_script,2016/01/02,ccc_media_line_script,2,1,0:00:06,6,0:00:06,1,6
20160102-ccc_priority_script,2016/01/02,ccc_priority_script,26,26,0:00:08,8,0:01:14,0,208
20160102-ccc_tax_script,2016/01/02,ccc_tax_script,0,0,0:00:00,0,0:00:00,0,0
20160102-ccc_waste_recycling_script,2016/01/02,ccc_waste_recycling_script,0,0,0:00:00,0,0:00:00,0,0
20160103-ccc_311_calgary_script,2016/01/03,ccc_311_calgary_script,797,787,0:00:09,9,0:04:32,8,7083
20160103-ccc_311_lobby_ph_script,2016/01/03,ccc_311_lobby_ph_script,0,0,0:00:00,0,0:00:00,0,0
20160103-ccc_aserv_info_script,2016/01/03,ccc_aserv_info_script,0,0,0:00:00,0,0:00:00,0,0
20160103-ccc_bylaw_script,2016/01/03,ccc_bylaw_script,0,0,0:00:00,0,0:00:00,0,0
20160103-ccc_city_script,2016/01/03,ccc_city_script,0,0,0:00:00,0,0:00:00,0,0
20160103-ccc_cty_online_script,2016/01/03,ccc_cty_online_script,0,0,0:00:00,0,0:00:00,0,0
20160103-ccc_feedback_script,2016/01/03,ccc_feedback_script,0,0,0:00:00,0,0:00:00,0,0
20160103-ccc_fpb_script,2016/01/03,ccc_fpb_script,0,0,0:00:00,0,0:00:00,0,0
20160103-ccc_help_script,2016/01/03,ccc_help_script,3,3,0:00:19,19,0:00:52,0,57
20160103-ccc_link_script,2016/01/03,ccc_link_script,0,0,0:00:00,0,0:00:00,0,0
20160103-ccc_media_line_script,2016/01/03,ccc_media_line_script,3,3,0:00:07,7,0:00:13,0,21
20160103-ccc_priority_script,2016/01/03,ccc_priority_script,16,16,0:00:14,14,0:02:21,0,224
20160103-ccc_tax_script,2016/01/03,ccc_tax_script,1,1,0:00:06,6,0:00:06,0,6
20160103-ccc_waste_recycling_script,2016/01/03,ccc_waste_recycling_script,0,0,0:00:00,0,0:00:00,0,0
20160104-ccc_311_calgary_script,2016/01/04,ccc_311_calgary_script,3521,3392,0:00:35,35,0:06:14,131,118720
20160104-ccc_311_lobby_ph_script,2016/01/04,ccc_311_lobby_ph_script,2,2,0:00:04,4,0:00:05,0,8
20160104-ccc_aserv_info_script,2016/01/04,ccc_aserv_info_script,0,0,0:00:00,0,0:00:00,0,0
20160104-ccc_bylaw_script,2016/01/04,ccc_bylaw_script,1,1,0:00:03,3,0:00:03,0,3
20160104-ccc_city_script,2016/01/04,ccc_city_script,22,22,0:00:10,10,0:02:00,0,220
20160104-ccc_cty_online_script,2016/01/04,ccc_cty_online_script,0,0,0:00:00,0,0:00:00,0,0
20160104-ccc_feedback_script,2016/01/04,ccc_feedback_script,0,0,0:00:00,0,0:00:00,0,0
20160104-ccc_fpb_script,2016/01/04,ccc_fpb_script,2,2,0:00:02,2,0:00:02,0,4
20160104-ccc_help_script,2016/01/04,ccc_help_script,32,32,0:00:11,11,0:00:52,0,352
20160104-ccc_link_script,2016/01/04,ccc_link_script,1,0,0:00:00,0,0:00:00,0,0
20160104-ccc_media_line_script,2016/01/04,ccc_media_line_script,4,4,0:00:05,5,0:00:08,0,20
20160104-ccc_priority_script,2016/01/04,ccc_priority_script,35,35,0:00:12,12,0:01:20,0,420
20160104-ccc_tax_script,2016/01/04,ccc_tax_script,11,11,0:00:18,18,0:01:45,0,198
20160104-ccc_waste_recycling_script,2016/01/04,ccc_waste_recycling_script,0,0,0:00:00,0,0:00:00,0,0
20160105-ccc_311_calgary_script,2016/01/05,ccc_311_calgary_script,3250,3143,0:00:29,29,0:03:23,107,91147
20160105-ccc_311_lobby_ph_script,2016/01/05,ccc_311_lobby_ph_script,6,6,0:00:13,13,0:00:23,0,78
20160105-ccc_aserv_info_script,2016/01/05,ccc_aserv_info_script,0,0,0:00:00,0,0:00:00,0,0
20160105-ccc_bylaw_script,2016/01/05,ccc_bylaw_script,0,0,0:00:00,0,0:00:00,0,0
20160105-ccc_city_script,2016/01/05,ccc_city_script,15,15,0:00:13,13,0:00:37,0,195
20160105-ccc_cty_online_script,2016/01/05,ccc_cty_online_script,0,0,0:00:00,0,0:00:00,0,0
20160105-ccc_feedback_script,2016/01/05,ccc_feedback_script,0,0,0:00:00,0,0:00:00,0,0
20160105-ccc_fpb_script,2016/01/05,ccc_fpb_script,0,0,0:00:00,0,0:00:00,0,0
20160105-ccc_help_script,2016/01/05,ccc_help_script,25,24,0:00:14,14,0:01:06,1,336
20160105-ccc_link_script,2016/01/05,ccc_link_script,1,0,0:00:00,0,0:00:00,1,0
20160105-ccc_media_line_script,2016/01/05,ccc_media_line_script,0,0,0:00:00,0,0:00:00,0,0
20160105-ccc_priority_script,2016/01/05,ccc_priority_script,28,27,0:00:15,15,0:01:07,1,405
20160105-ccc_tax_script,2016/01/05,ccc_tax_script,18,18,0:00:35,35,0:01:52,0,630
20160105-ccc_waste_recycling_script,2016/01/05,ccc_waste_recycling_script,0,0,0:00:00,0,0:00:00,0,0
20160106-ccc_311_calgary_script,2016/01/06,ccc_311_calgary_script,3069,2929,0:00:39,39,0:07:42,140,114231
20160106-ccc_311_lobby_ph_script,2016/01/06,ccc_311_lobby_ph_script,1,0,0:00:00,0,0:00:00,1,0
20160106-ccc_aserv_info_script,2016/01/06,ccc_aserv_info_script,0,0,0:00:00,0,0:00:00,0,0
20160106-ccc_bylaw_script,2016/01/06,ccc_bylaw_script,0,0,0:00:00,0,0:00:00,0,0
20160106-ccc_city_script,2016/01/06,ccc_city_script,9,8,0:00:09,9,0:00:30,1,72
20160106-ccc_cty_online_script,2016/01/06,ccc_cty_online_script,0,0,0:00:00,0,0:00:00,0,0
20160106-ccc_feedback_script,2016/01/06,ccc_feedback_script,0,0,0:00:00,0,0:00:00,0,0
20160106-ccc_fpb_script,2016/01/06,ccc_fpb_script,0,0,0:00:00,0,0:00:00,0,0
20160106-ccc_help_script,2016/01/06,ccc_help_script,9,9,0:00:19,19,0:00:45,0,171
20160106-ccc_link_script,2016/01/06,ccc_link_script,0,0,0:00:00,0,0:00:00,0,0
20160106-ccc_media_line_script,2016/01/06,ccc_media_line_script,0,0,0:00:00,0,0:00:00,0,0
20160106-ccc_priority_script,2016/01/06,ccc_priority_script,34,32,0:00:18,18,0:03:34,2,576
20160106-ccc_tax_script,2016/01/06,ccc_tax_script,20,18,0:00:31,31,0:01:19,2,558
20160106-ccc_waste_recycling_script,2016/01/06,ccc_waste_recycling_script,0,0,0:00:00,0,0:00:00,0,0
20160107-ccc_311_calgary_script,2016/01/07,ccc_311_calgary_script,3039,2980,0:00:17,17,0:03:41,59,50660
20160107-ccc_311_lobby_ph_script,2016/01/07,ccc_311_lobby_ph_script,0,0,0:00:00,0,0:00:00,0,0
20160107-ccc_aserv_info_script,2016/01/07,ccc_aserv_info_script,0,0,0:00:00,0,0:00:00,0,0
20160107-ccc_bylaw_script,2016/01/07,ccc_bylaw_script,0,0,0:00:00,0,0:00:00,0,0
20160107-ccc_city_script,2016/01/07,ccc_city_script,20,20,0:00:10,10,0:00:49,0,200
20160107-ccc_cty_online_script,2016/01/07,ccc_cty_online_script,0,0,0:00:00,0,0:00:00,0,0
20160107-ccc_feedback_script,2016/01/07,ccc_feedback_script,1,0,0:00:00,0,0:00:00,1,0
20160107-ccc_fpb_script,2016/01/07,ccc_fpb_script,0,0,0:00:00,0,0:00:00,0,0
20160107-ccc_help_script,2016/01/07,ccc_help_script,10,9,0:00:16,16,0:00:47,1,144
20160107-ccc_link_script,2016/01/07,ccc_link_script,0,0,0:00:00,0,0:00:00,0,0
20160107-ccc_media_line_script,2016/01/07,ccc_media_line_script,0,0,0:00:00,0,0:00:00,0,0
20160107-ccc_priority_script,2016/01/07,ccc_priority_script,40,40,0:00:08,8,0:00:34,0,320
20160107-ccc_tax_script,2016/01/07,ccc_tax_script,18,17,0:00:10,10,0:00:31,1,170
20160107-ccc_waste_recycling_script,2016/01/07,ccc_waste_recycling_script,0,0,0:00:00,0,0:00:00,0,0
20160108-ccc_311_calgary_script,2016/01/08,ccc_311_calgary_script,2984,2819,0:00:44,44,0:08:09,165,124036
20160108-ccc_311_lobby_ph_script,2016/01/08,ccc_311_lobby_ph_script,1,0,0:00:00,0,0:00:00,1,0
20160108-ccc_aserv_info_script,2016/01/08,ccc_aserv_info_script,0,0,0:00:00,0,0:00:00,0,0
20160108-ccc_bylaw_script,2016/01/08,ccc_bylaw_script,0,0,0:00:00,0,0:00:00,0,0
20160108-ccc_city_script,2016/01/08,ccc_city_script,14,14,0:00:17,17,0:01:22,0,238
20160108-ccc_cty_online_script,2016/01/08,ccc_cty_online_script,0,0,0:00:00,0,0:00:00,0,0
20160108-ccc_feedback_script,2016/01/08,ccc_feedback_script,1,0,0:00:00,0,0:00:00,0,0
20160108-ccc_fpb_script,2016/01/08,ccc_fpb_script,0,0,0:00:00,0,0:00:00,0,0
20160108-ccc_help_script,2016/01/08,ccc_help_script,10,8,0:00:11,11,0:00:37,2,88
20160108-ccc_link_script,2016/01/08,ccc_link_script,0,0,0:00:00,0,0:00:00,0,0
20160108-ccc_media_line_script,2016/01/08,ccc_media_line_script,3,3,0:00:04,4,0:00:07,0,12
20160108-ccc_priority_script,2016/01/08,ccc_priority_script,25,25,0:00:10,10,0:00:59,0,250
20160108-ccc_tax_script,2016/01/08,ccc_tax_script,14,10,0:00:31,31,0:02:26,4,310
20160108-ccc_waste_recycling_script,2016/01/08,ccc_waste_recycling_script,0,0,0:00:00,0,0:00:00,0,0
20160109-ccc_311_calgary_script,2016/01/09,ccc_311_calgary_script,1219,1096,0:00:22,22,0:09:42,123,24112
20160109-ccc_311_lobby_ph_script,2016/01/09,ccc_311_lobby_ph_script,0,0,0:00:00,0,0:00:00,0,0
20160109-ccc_aserv_info_script,2016/01/09,ccc_aserv_info_script,0,0,0:00:00,0,0:00:00,0,0
20160109-ccc_bylaw_script,2016/01/09,ccc_bylaw_script,0,0,0:00:00,0,0:00:00,0,0
20160109-ccc_city_script,2016/01/09,ccc_city_script,0,0,0:00:00,0,0:00:00,0,0
20160109-ccc_cty_online_script,2016/01/09,ccc_cty_online_script,0,0,0:00:00,0,0:00:00,0,0
20160109-ccc_feedback_script,2016/01/09,ccc_feedback_script,0,0,0:00:00,0,0:00:00,0,0
20160109-ccc_fpb_script,2016/01/09,ccc_fpb_script,0,0,0:00:00,0,0:00:00,0,0
20160109-ccc_help_script,2016/01/09,ccc_help_script,3,3,0:00:07,7,0:00:10,0,21
20160109-ccc_link_script,2016/01/09,ccc_link_script,0,0,0:00:00,0,0:00:00,0,0
20160109-ccc_media_line_script,2016/01/09,ccc_media_line_script,3,3,0:00:06,6,0:00:09,0,18
20160109-ccc_priority_script,2016/01/09,ccc_priority_script,30,29,0:00:10,10,0:01:29,1,290
20160109-ccc_tax_script,2016/01/09,ccc_tax_script,0,0,0:00:00,0,0:00:00,0,0
20160109-ccc_waste_recycling_script,2016/01/09,ccc_waste_recycling_script,0,0,0:00:00,0,0:00:00,0,0
20160110-ccc_311_calgary_script,2016/01/10,ccc_311_calgary_script,834,823,0:00:09,9,0:05:25,10,7407
20160110-ccc_311_lobby_ph_script,2016/01/10,ccc_311_lobby_ph_script,0,0,0:00:00,0,0:00:00,0,0
20160110-ccc_aserv_info_script,2016/01/10,ccc_aserv_info_script,0,0,0:00:00,0,0:00:00,0,0
20160110-ccc_bylaw_script,2016/01/10,ccc_bylaw_script,0,0,0:00:00,0,0:00:00,0,0
20160110-ccc_city_script,2016/01/10,ccc_city_script,0,0,0:00:00,0,0:00:00,0,0
20160110-ccc_cty_online_script,2016/01/10,ccc_cty_online_script,0,0,0:00:00,0,0:00:00,0,0
20160110-ccc_feedback_script,2016/01/10,ccc_feedback_script,0,0,0:00:00,0,0:00:00,0,0
20160110-ccc_fpb_script,2016/01/10,ccc_fpb_script,0,0,0:00:00,0,0:00:00,0,0
20160110-ccc_help_script,2016/01/10,ccc_help_script,5,5,0:00:04,4,0:00:06,0,20
20160110-ccc_link_script,2016/01/10,ccc_link_script,0,0,0:00:00,0,0:00:00,0,0
20160110-ccc_media_line_script,2016/01/10,ccc_media_line_script,1,1,0:00:04,4,0:00:04,0,4
20160110-ccc_priority_script,2016/01/10,ccc_priority_script,24,24,0:00:06,6,0:00:18,0,144
20160110-ccc_tax_script,2016/01/10,ccc_tax_script,0,0,0:00:00,0,0:00:00,0,0
20160110-ccc_waste_recycling_script,2016/01/10,ccc_waste_recycling_script,0,0,0:00:00,0,0:00:00,0,0
20160111-ccc_311_calgary_script,2016/01/11,ccc_311_calgary_script,3192,3156,0:00:11,11,0:02:42,37,34716
20160111-ccc_311_lobby_ph_script,2016/01/11,ccc_311_lobby_ph_script,2,2,0:00:11,11,0:00:18,0,22
20160111-ccc_aserv_info_script,2016/01/11,ccc_aserv_info_script,0,0,0:00:00,0,0:00:00,0,0
20160111-ccc_bylaw_script,2016/01/11,ccc_bylaw_script,0,0,0:00:00,0,0:00:00,0,0
20160111-ccc_city_script,2016/01/11,ccc_city_script,18,18,0:00:06,6,0:00:19,0,108
20160111-ccc_cty_online_script,2016/01/11,ccc_cty_online_script,0,0,0:00:00,0,0:00:00,0,0
20160111-ccc_feedback_script,2016/01/11,ccc_feedback_script,0,0,0:00:00,0,0:00:00,0,0
20160111-ccc_fpb_script,2016/01/11,ccc_fpb_script,1,1,0:00:12,12,0:00:12,0,12
20160111-ccc_help_script,2016/01/11,ccc_help_script,19,19,0:00:08,8,0:00:35,0,152
20160111-ccc_link_script,2016/01/11,ccc_link_script,0,0,0:00:00,0,0:00:00,0,0
20160111-ccc_media_line_script,2016/01/11,ccc_media_line_script,0,0,0:00:00,0,0:00:00,0,0
20160111-ccc_priority_script,2016/01/11,ccc_priority_script,23,23,0:00:07,7,0:00:19,0,161
20160111-ccc_tax_script,2016/01/11,ccc_tax_script,21,21,0:00:13,13,0:01:44,0,273
20160111-ccc_waste_recycling_script,2016/01/11,ccc_waste_recycling_script,0,0,0:00:00,0,0:00:00,0,0
20160112-ccc_311_calgary_script,2016/01/12,ccc_311_calgary_script,2952,2865,0:00:20,20,0:04:13,87,57300
20160112-ccc_311_lobby_ph_script,2016/01/12,ccc_311_lobby_ph_script,4,1,0:00:13,13,0:00:13,3,13
20160112-ccc_aserv_info_script,2016/01/12,ccc_aserv_info_script,0,0,0:00:00,0,0:00:00,0,0
20160112-ccc_bylaw_script,2016/01/12,ccc_bylaw_script,0,0,0:00:00,0,0:00:00,0,0
20160112-ccc_city_script,2016/01/12,ccc_city_script,6,6,0:00:06,6,0:00:18,0,36
20160112-ccc_cty_online_script,2016/01/12,ccc_cty_online_script,0,0,0:00:00,0,0:00:00,0,0
20160112-ccc_feedback_script,2016/01/12,ccc_feedback_script,0,0,0:00:00,0,0:00:00,0,0
20160112-ccc_fpb_script,2016/01/12,ccc_fpb_script,0,0,0:00:00,0,0:00:00,0,0
20160112-ccc_help_script,2016/01/12,ccc_help_script,8,8,0:00:12,12,0:00:34,0,96
20160112-ccc_link_script,2016/01/12,ccc_link_script,0,0,0:00:00,0,0:00:00,0,0
20160112-ccc_media_line_script,2016/01/12,ccc_media_line_script,0,0,0:00:00,0,0:00:00,0,0
20160112-ccc_priority_script,2016/01/12,ccc_priority_script,14,14,0:00:11,11,0:00:43,0,154
20160112-ccc_tax_script,2016/01/12,ccc_tax_script,24,22,0:00:28,28,0:02:33,2,616
20160112-ccc_waste_recycling_script,2016/01/12,ccc_waste_recycling_script,0,0,0:00:00,0,0:00:00,0,0
20160113-ccc_311_calgary_script,2016/01/13,ccc_311_calgary_script,2796,2765,0:00:09,9,0:06:56,31,24885
20160113-ccc_311_lobby_ph_script,2016/01/13,ccc_311_lobby_ph_script,4,3,0:00:06,6,0:00:08,1,18
20160113-ccc_aserv_info_script,2016/01/13,ccc_aserv_info_script,0,0,0:00:00,0,0:00:00,0,0
20160113-ccc_bylaw_script,2016/01/13,ccc_bylaw_script,0,0,0:00:00,0,0:00:00,0,0
20160113-ccc_city_script,2016/01/13,ccc_city_script,19,18,0:00:06,6,0:00:21,1,108
20160113-ccc_cty_online_script,2016/01/13,ccc_cty_online_script,0,0,0:00:00,0,0:00:00,0,0
20160113-ccc_feedback_script,2016/01/13,ccc_feedback_script,0,0,0:00:00,0,0:00:00,0,0
20160113-ccc_fpb_script,2016/01/13,ccc_fpb_script,0,0,0:00:00,0,0:00:00,0,0
20160113-ccc_help_script,2016/01/13,ccc_help_script,13,13,0:00:10,10,0:01:09,0,130
20160113-ccc_link_script,2016/01/13,ccc_link_script,0,0,0:00:00,0,0:00:00,0,0
20160113-ccc_media_line_script,2016/01/13,ccc_media_line_script,0,0,0:00:00,0,0:00:00,0,0
20160113-ccc_priority_script,2016/01/13,ccc_priority_script,20,20,0:00:14,14,0:01:20,0,280
20160113-ccc_tax_script,2016/01/13,ccc_tax_script,14,14,0:00:08,8,0:00:47,0,112
20160113-ccc_waste_recycling_script,2016/01/13,ccc_waste_recycling_script,0,0,0:00:00,0,0:00:00,0,0
20160114-ccc_311_calgary_script,2016/01/14,ccc_311_calgary_script,2929,2827,0:00:24,24,0:04:12,102,67848
20160114-ccc_311_lobby_ph_script,2016/01/14,ccc_311_lobby_ph_script,0,0,0:00:00,0,0:00:00,0,0
20160114-ccc_aserv_info_script,2016/01/14,ccc_aserv_info_script,0,0,0:00:00,0,0:00:00,0,0
20160114-ccc_bylaw_script,2016/01/14,ccc_bylaw_script,0,0,0:00:00,0,0:00:00,0,0
20160114-ccc_city_script,2016/01/14,ccc_city_script,10,10,0:00:14,14,0:00:43,0,140
20160114-ccc_cty_online_script,2016/01/14,ccc_cty_online_script,0,0,0:00:00,0,0:00:00,0,0
20160114-ccc_feedback_script,2016/01/14,ccc_feedback_script,0,0,0:00:00,0,0:00:00,0,0
20160114-ccc_fpb_script,2016/01/14,ccc_fpb_script,0,0,0:00:00,0,0:00:00,0,0
20160114-ccc_help_script,2016/01/14,ccc_help_script,11,8,0:00:09,9,0:00:41,3,72
20160114-ccc_link_script,2016/01/14,ccc_link_script,0,0,0:00:00,0,0:00:00,0,0
20160114-ccc_media_line_script,2016/01/14,ccc_media_line_script,0,0,0:00:00,0,0:00:00,0,0
20160114-ccc_priority_script,2016/01/14,ccc_priority_script,24,24,0:00:08,8,0:00:28,0,192
20160114-ccc_tax_script,2016/01/14,ccc_tax_script,22,22,0:00:12,12,0:01:14,0,264
20160114-ccc_waste_recycling_script,2016/01/14,ccc_waste_recycling_script,0,0,0:00:00,0,0:00:00,0,0
20160115-ccc_311_calgary_script,2016/01/15,ccc_311_calgary_script,2692,2603,0:00:32,32,0:04:48,87,83296
20160115-ccc_311_lobby_ph_script,2016/01/15,ccc_311_lobby_ph_script,5,4,0:00:06,6,0:00:09,1,24
20160115-ccc_aserv_info_script,2016/01/15,ccc_aserv_info_script,0,0,0:00:00,0,0:00:00,0,0
20160115-ccc_bylaw_script,2016/01/15,ccc_bylaw_script,0,0,0:00:00,0,0:00:00,0,0
20160115-ccc_city_script,2016/01/15,ccc_city_script,14,14,0:00:10,10,0:00:25,0,140
20160115-ccc_cty_online_script,2016/01/15,ccc_cty_online_script,0,0,0:00:00,0,0:00:00,0,0
20160115-ccc_feedback_script,2016/01/15,ccc_feedback_script,0,0,0:00:00,0,0:00:00,0,0
20160115-ccc_fpb_script,2016/01/15,ccc_fpb_script,0,0,0:00:00,0,0:00:00,0,0
20160115-ccc_help_script,2016/01/15,ccc_help_script,8,8,0:00:07,7,0:00:19,0,56
20160115-ccc_link_script,2016/01/15,ccc_link_script,0,0,0:00:00,0,0:00:00,0,0
20160115-ccc_media_line_script,2016/01/15,ccc_media_line_script,2,2,0:00:07,7,0:00:09,0,14
20160115-ccc_priority_script,2016/01/15,ccc_priority_script,36,33,0:00:18,18,0:01:47,1,594
20160115-ccc_tax_script,2016/01/15,ccc_tax_script,25,24,0:00:32,32,0:04:53,1,768
20160115-ccc_waste_recycling_script,2016/01/15,ccc_waste_recycling_script,0,0,0:00:00,0,0:00:00,0,0
20160116-ccc_311_calgary_script,2016/01/16,ccc_311_calgary_script,875,869,0:00:07,7,0:03:44,7,6083
20160116-ccc_311_lobby_ph_script,2016/01/16,ccc_311_lobby_ph_script,0,0,0:00:00,0,0:00:00,0,0
20160116-ccc_aserv_info_script,2016/01/16,ccc_aserv_info_script,0,0,0:00:00,0,0:00:00,0,0
20160116-ccc_bylaw_script,2016/01/16,ccc_bylaw_script,0,0,0:00:00,0,0:00:00,0,0
20160116-ccc_city_script,2016/01/16,ccc_city_script,0,0,0:00:00,0,0:00:00,0,0
20160116-ccc_cty_online_script,2016/01/16,ccc_cty_online_script,0,0,0:00:00,0,0:00:00,0,0
20160116-ccc_feedback_script,2016/01/16,ccc_feedback_script,0,0,0:00:00,0,0:00:00,0,0
20160116-ccc_fpb_script,2016/01/16,ccc_fpb_script,0,0,0:00:00,0,0:00:00,0,0
20160116-ccc_help_script,2016/01/16,ccc_help_script,5,5,0:00:06,6,0:00:10,0,30
20160116-ccc_link_script,2016/01/16,ccc_link_script,0,0,0:00:00,0,0:00:00,0,0
20160116-ccc_media_line_script,2016/01/16,ccc_media_line_script,1,1,0:00:05,5,0:00:05,0,5
20160116-ccc_priority_script,2016/01/16,ccc_priority_script,19,19,0:00:06,6,0:00:18,0,114
20160116-ccc_tax_script,2016/01/16,ccc_tax_script,0,0,0:00:00,0,0:00:00,0,0
20160116-ccc_waste_recycling_script,2016/01/16,ccc_waste_recycling_script,0,0,0:00:00,0,0:00:00,0,0
20160117-ccc_311_calgary_script,2016/01/17,ccc_311_calgary_script,750,739,0:00:07,7,0:02:27,11,5173
20160117-ccc_311_lobby_ph_script,2016/01/17,ccc_311_lobby_ph_script,0,0,0:00:00,0,0:00:00,0,0
20160117-ccc_aserv_info_script,2016/01/17,ccc_aserv_info_script,0,0,0:00:00,0,0:00:00,0,0
20160117-ccc_bylaw_script,2016/01/17,ccc_bylaw_script,0,0,0:00:00,0,0:00:00,0,0
20160117-ccc_city_script,2016/01/17,ccc_city_script,0,0,0:00:00,0,0:00:00,0,0
20160117-ccc_cty_online_script,2016/01/17,ccc_cty_online_script,0,0,0:00:00,0,0:00:00,0,0
20160117-ccc_feedback_script,2016/01/17,ccc_feedback_script,0,0,0:00:00,0,0:00:00,0,0
20160117-ccc_fpb_script,2016/01/17,ccc_fpb_script,0,0,0:00:00,0,0:00:00,0,0
20160117-ccc_help_script,2016/01/17,ccc_help_script,2,2,0:00:04,4,0:00:05,0,8
20160117-ccc_link_script,2016/01/17,ccc_link_script,0,0,0:00:00,0,0:00:00,0,0
20160117-ccc_media_line_script,2016/01/17,ccc_media_line_script,1,1,0:00:10,10,0:00:10,0,10
20160117-ccc_priority_script,2016/01/17,ccc_priority_script,13,13,0:00:08,8,0:00:46,0,104
20160117-ccc_tax_script,2016/01/17,ccc_tax_script,0,0,0:00:00,0,0:00:00,0,0
20160117-ccc_waste_recycling_script,2016/01/17,ccc_waste_recycling_script,0,0,0:00:00,0,0:00:00,0,0
20160118-ccc_311_calgary_script,2016/01/18,ccc_311_calgary_script,3076,2973,0:00:26,26,0:10:38,103,77298
20160118-ccc_311_lobby_ph_script,2016/01/18,ccc_311_lobby_ph_script,5,5,0:00:13,13,0:00:21,0,65
20160118-ccc_aserv_info_script,2016/01/18,ccc_aserv_info_script,0,0,0:00:00,0,0:00:00,0,0
20160118-ccc_bylaw_script,2016/01/18,ccc_bylaw_script,0,0,0:00:00,0,0:00:00,0,0
20160118-ccc_city_script,2016/01/18,ccc_city_script,25,25,0:00:11,11,0:00:30,0,275
20160118-ccc_cty_online_script,2016/01/18,ccc_cty_online_script,0,0,0:00:00,0,0:00:00,0,0
20160118-ccc_feedback_script,2016/01/18,ccc_feedback_script,0,0,0:00:00,0,0:00:00,0,0
20160118-ccc_fpb_script,2016/01/18,ccc_fpb_script,1,1,0:00:05,5,0:00:05,0,5
20160118-ccc_help_script,2016/01/18,ccc_help_script,18,16,0:00:09,9,0:00:25,2,144
20160118-ccc_link_script,2016/01/18,ccc_link_script,0,0,0:00:00,0,0:00:00,0,0
20160118-ccc_media_line_script,2016/01/18,ccc_media_line_script,0,0,0:00:00,0,0:00:00,0,0
20160118-ccc_priority_script,2016/01/18,ccc_priority_script,22,22,0:00:11,11,0:00:39,0,242
20160118-ccc_tax_script,2016/01/18,ccc_tax_script,9,9,0:00:38,38,0:01:51,0,342
20160118-ccc_waste_recycling_script,2016/01/18,ccc_waste_recycling_script,0,0,0:00:00,0,0:00:00,0,0
20160119-ccc_311_calgary_script,2016/01/19,ccc_311_calgary_script,2980,2901,0:00:24,24,0:04:26,79,69624
20160119-ccc_311_lobby_ph_script,2016/01/19,ccc_311_lobby_ph_script,6,6,0:00:10,10,0:00:30,0,60
20160119-ccc_aserv_info_script,2016/01/19,ccc_aserv_info_script,0,0,0:00:00,0,0:00:00,0,0
20160119-ccc_bylaw_script,2016/01/19,ccc_bylaw_script,0,0,0:00:00,0,0:00:00,0,0
20160119-ccc_city_script,2016/01/19,ccc_city_script,19,18,0:00:14,14,0:00:44,1,252
20160119-ccc_cty_online_script,2016/01/19,ccc_cty_online_script,0,0,0:00:00,0,0:00:00,0,0
20160119-ccc_feedback_script,2016/01/19,ccc_feedback_script,0,0,0:00:00,0,0:00:00,0,0
20160119-ccc_fpb_script,2016/01/19,ccc_fpb_script,0,0,0:00:00,0,0:00:00,0,0
20160119-ccc_help_script,2016/01/19,ccc_help_script,14,14,0:00:15,15,0:01:09,0,210
20160119-ccc_link_script,2016/01/19,ccc_link_script,0,0,0:00:00,0,0:00:00,0,0
20160119-ccc_media_line_script,2016/01/19,ccc_media_line_script,1,1,0:00:04,4,0:00:04,0,4
20160119-ccc_priority_script,2016/01/19,ccc_priority_script,25,24,0:00:09,9,0:00:34,1,216
20160119-ccc_tax_script,2016/01/19,ccc_tax_script,15,14,0:00:35,35,0:02:12,1,490
20160119-ccc_waste_recycling_script,2016/01/19,ccc_waste_recycling_script,0,0,0:00:00,0,0:00:00,0,0
20160120-ccc_311_calgary_script,2016/01/20,ccc_311_calgary_script,2843,2683,0:00:43,43,0:05:53,160,115369
20160120-ccc_311_lobby_ph_script,2016/01/20,ccc_311_lobby_ph_script,2,2,0:00:13,13,0:00:22,0,26
20160120-ccc_aserv_info_script,2016/01/20,ccc_aserv_info_script,0,0,0:00:00,0,0:00:00,0,0
20160120-ccc_bylaw_script,2016/01/20,ccc_bylaw_script,0,0,0:00:00,0,0:00:00,0,0
20160120-ccc_city_script,2016/01/20,ccc_city_script,11,11,0:00:14,14,0:00:28,0,154
20160120-ccc_cty_online_script,2016/01/20,ccc_cty_online_script,0,0,0:00:00,0,0:00:00,0,0
20160120-ccc_feedback_script,2016/01/20,ccc_feedback_script,0,0,0:00:00,0,0:00:00,0,0
20160120-ccc_fpb_script,2016/01/20,ccc_fpb_script,1,1,0:01:07,67,0:01:07,0,67
20160120-ccc_help_script,2016/01/20,ccc_help_script,8,8,0:00:21,21,0:01:07,0,168
20160120-ccc_link_script,2016/01/20,ccc_link_script,0,0,0:00:00,0,0:00:00,0,0
20160120-ccc_media_line_script,2016/01/20,ccc_media_line_script,0,0,0:00:00,0,0:00:00,0,0
20160120-ccc_priority_script,2016/01/20,ccc_priority_script,31,30,0:00:12,12,0:00:47,1,360
20160120-ccc_tax_script,2016/01/20,ccc_tax_script,24,23,0:01:01,61,0:03:00,1,1403
20160120-ccc_waste_recycling_script,2016/01/20,ccc_waste_recycling_script,0,0,0:00:00,0,0:00:00,0,0
20160121-ccc_311_calgary_script,2016/01/21,ccc_311_calgary_script,2684,2626,0:00:19,19,0:05:05,58,49894
20160121-ccc_311_lobby_ph_script,2016/01/21,ccc_311_lobby_ph_script,1,1,0:00:04,4,0:00:04,0,4
20160121-ccc_aserv_info_script,2016/01/21,ccc_aserv_info_script,0,0,0:00:00,0,0:00:00,0,0
20160121-ccc_bylaw_script,2016/01/21,ccc_bylaw_script,0,0,0:00:00,0,0:00:00,0,0
20160121-ccc_city_script,2016/01/21,ccc_city_script,26,26,0:00:10,10,0:00:37,0,260
20160121-ccc_cty_online_script,2016/01/21,ccc_cty_online_script,0,0,0:00:00,0,0:00:00,0,0
20160121-ccc_feedback_script,2016/01/21,ccc_feedback_script,0,0,0:00:00,0,0:00:00,0,0
20160121-ccc_fpb_script,2016/01/21,ccc_fpb_script,1,1,0:00:16,16,0:00:16,0,16
20160121-ccc_help_script,2016/01/21,ccc_help_script,20,18,0:00:09,9,0:00:35,2,162
20160121-ccc_link_script,2016/01/21,ccc_link_script,1,0,0:00:00,0,0:00:00,1,0
20160121-ccc_media_line_script,2016/01/21,ccc_media_line_script,1,1,0:00:37,37,0:00:37,0,37
20160121-ccc_priority_script,2016/01/21,ccc_priority_script,18,17,0:00:06,6,0:00:14,1,102
20160121-ccc_tax_script,2016/01/21,ccc_tax_script,16,15,0:00:20,20,0:01:53,1,300
20160121-ccc_waste_recycling_script,2016/01/21,ccc_waste_recycling_script,0,0,0:00:00,0,0:00:00,0,0
20160122-ccc_311_calgary_script,2016/01/22,ccc_311_calgary_script,2563,2507,0:00:15,15,0:04:49,56,37605
20160122-ccc_311_lobby_ph_script,2016/01/22,ccc_311_lobby_ph_script,1,1,0:00:03,3,0:00:03,0,3
20160122-ccc_aserv_info_script,2016/01/22,ccc_aserv_info_script,0,0,0:00:00,0,0:00:00,0,0
20160122-ccc_bylaw_script,2016/01/22,ccc_bylaw_script,0,0,0:00:00,0,0:00:00,0,0
20160122-ccc_city_script,2016/01/22,ccc_city_script,18,18,0:00:09,9,0:00:58,0,162
20160122-ccc_cty_online_script,2016/01/22,ccc_cty_online_script,0,0,0:00:00,0,0:00:00,0,0
20160122-ccc_feedback_script,2016/01/22,ccc_feedback_script,0,0,0:00:00,0,0:00:00,0,0
20160122-ccc_fpb_script,2016/01/22,ccc_fpb_script,1,1,0:00:03,3,0:00:03,0,3
20160122-ccc_help_script,2016/01/22,ccc_help_script,6,6,0:00:13,13,0:00:35,0,78
20160122-ccc_link_script,2016/01/22,ccc_link_script,0,0,0:00:00,0,0:00:00,0,0
20160122-ccc_media_line_script,2016/01/22,ccc_media_line_script,1,1,0:00:05,5,0:00:05,0,5
20160122-ccc_priority_script,2016/01/22,ccc_priority_script,28,28,0:00:10,10,0:00:50,0,280
20160122-ccc_tax_script,2016/01/22,ccc_tax_script,14,14,0:00:14,14,0:01:02,0,196
20160122-ccc_waste_recycling_script,2016/01/22,ccc_waste_recycling_script,0,0,0:00:00,0,0:00:00,0,0
20160123-ccc_311_calgary_script,2016/01/23,ccc_311_calgary_script,1055,1035,0:00:15,15,0:03:24,20,15525
20160123-ccc_311_lobby_ph_script,2016/01/23,ccc_311_lobby_ph_script,0,0,0:00:00,0,0:00:00,0,0
20160123-ccc_aserv_info_script,2016/01/23,ccc_aserv_info_script,0,0,0:00:00,0,0:00:00,0,0
20160123-ccc_bylaw_script,2016/01/23,ccc_bylaw_script,0,0,0:00:00,0,0:00:00,0,0
20160123-ccc_city_script,2016/01/23,ccc_city_script,0,0,0:00:00,0,0:00:00,0,0
20160123-ccc_cty_online_script,2016/01/23,ccc_cty_online_script,0,0,0:00:00,0,0:00:00,0,0
20160123-ccc_feedback_script,2016/01/23,ccc_feedback_script,2,0,0:00:00,0,0:00:00,0,0
20160123-ccc_fpb_script,2016/01/23,ccc_fpb_script,0,0,0:00:00,0,0:00:00,0,0
20160123-ccc_help_script,2016/01/23,ccc_help_script,5,5,0:00:22,22,0:01:23,0,110
20160123-ccc_link_script,2016/01/23,ccc_link_script,0,0,0:00:00,0,0:00:00,0,0
20160123-ccc_media_line_script,2016/01/23,ccc_media_line_script,0,0,0:00:00,0,0:00:00,0,0
20160123-ccc_priority_script,2016/01/23,ccc_priority_script,21,21,0:00:21,21,0:02:31,0,441
20160123-ccc_tax_script,2016/01/23,ccc_tax_script,1,1,0:00:09,9,0:00:09,0,9
20160123-ccc_waste_recycling_script,2016/01/23,ccc_waste_recycling_script,0,0,0:00:00,0,0:00:00,0,0
20160124-ccc_311_calgary_script,2016/01/24,ccc_311_calgary_script,908,894,0:00:12,12,0:06:23,14,10728
20160124-ccc_311_lobby_ph_script,2016/01/24,ccc_311_lobby_ph_script,0,0,0:00:00,0,0:00:00,0,0
20160124-ccc_aserv_info_script,2016/01/24,ccc_aserv_info_script,0,0,0:00:00,0,0:00:00,0,0
20160124-ccc_bylaw_script,2016/01/24,ccc_bylaw_script,0,0,0:00:00,0,0:00:00,0,0
20160124-ccc_city_script,2016/01/24,ccc_city_script,0,0,0:00:00,0,0:00:00,0,0
20160124-ccc_cty_online_script,2016/01/24,ccc_cty_online_script,0,0,0:00:00,0,0:00:00,0,0
20160124-ccc_feedback_script,2016/01/24,ccc_feedback_script,0,0,0:00:00,0,0:00:00,0,0
20160124-ccc_fpb_script,2016/01/24,ccc_fpb_script,0,0,0:00:00,0,0:00:00,0,0
20160124-ccc_help_script,2016/01/24,ccc_help_script,3,3,0:00:06,6,0:00:08,0,18
20160124-ccc_link_script,2016/01/24,ccc_link_script,0,0,0:00:00,0,0:00:00,0,0
20160124-ccc_media_line_script,2016/01/24,ccc_media_line_script,0,0,0:00:00,0,0:00:00,0,0
20160124-ccc_priority_script,2016/01/24,ccc_priority_script,15,15,0:00:14,14,0:01:43,0,210
20160124-ccc_tax_script,2016/01/24,ccc_tax_script,0,0,0:00:00,0,0:00:00,0,0
20160124-ccc_waste_recycling_script,2016/01/24,ccc_waste_recycling_script,0,0,0:00:00,0,0:00:00,0,0
20160125-ccc_311_calgary_script,2016/01/25,ccc_311_calgary_script,3204,3149,0:00:11,11,0:02:31,55,34639
20160125-ccc_311_lobby_ph_script,2016/01/25,ccc_311_lobby_ph_script,1,1,0:00:05,5,0:00:05,0,5
20160125-ccc_aserv_info_script,2016/01/25,ccc_aserv_info_script,0,0,0:00:00,0,0:00:00,0,0
20160125-ccc_bylaw_script,2016/01/25,ccc_bylaw_script,0,0,0:00:00,0,0:00:00,0,0
20160125-ccc_city_script,2016/01/25,ccc_city_script,14,13,0:00:05,5,0:00:10,1,65
20160125-ccc_cty_online_script,2016/01/25,ccc_cty_online_script,0,0,0:00:00,0,0:00:00,0,0
20160125-ccc_feedback_script,2016/01/25,ccc_feedback_script,0,0,0:00:00,0,0:00:00,0,0
20160125-ccc_fpb_script,2016/01/25,ccc_fpb_script,0,0,0:00:00,0,0:00:00,0,0
20160125-ccc_help_script,2016/01/25,ccc_help_script,11,11,0:00:09,9,0:00:21,0,99
20160125-ccc_link_script,2016/01/25,ccc_link_script,0,0,0:00:00,0,0:00:00,0,0
20160125-ccc_media_line_script,2016/01/25,ccc_media_line_script,0,0,0:00:00,0,0:00:00,0,0
20160125-ccc_priority_script,2016/01/25,ccc_priority_script,25,25,0:00:04,4,0:00:09,0,100
20160125-ccc_tax_script,2016/01/25,ccc_tax_script,17,16,0:00:14,14,0:01:24,1,224
20160125-ccc_waste_recycling_script,2016/01/25,ccc_waste_recycling_script,0,0,0:00:00,0,0:00:00,0,0
20160126-ccc_311_calgary_script,2016/01/26,ccc_311_calgary_script,3021,2799,0:01:01,61,0:08:01,222,170739
20160126-ccc_311_lobby_ph_script,2016/01/26,ccc_311_lobby_ph_script,2,2,0:00:05,5,0:00:05,0,10
20160126-ccc_aserv_info_script,2016/01/26,ccc_aserv_info_script,0,0,0:00:00,0,0:00:00,0,0
20160126-ccc_bylaw_script,2016/01/26,ccc_bylaw_script,0,0,0:00:00,0,0:00:00,0,0
20160126-ccc_city_script,2016/01/26,ccc_city_script,12,12,0:00:23,23,0:02:36,0,276
20160126-ccc_cty_online_script,2016/01/26,ccc_cty_online_script,0,0,0:00:00,0,0:00:00,0,0
20160126-ccc_feedback_script,2016/01/26,ccc_feedback_script,0,0,0:00:00,0,0:00:00,0,0
20160126-ccc_fpb_script,2016/01/26,ccc_fpb_script,0,0,0:00:00,0,0:00:00,0,0
20160126-ccc_help_script,2016/01/26,ccc_help_script,12,11,0:00:21,21,0:01:04,1,231
20160126-ccc_link_script,2016/01/26,ccc_link_script,0,0,0:00:00,0,0:00:00,0,0
20160126-ccc_media_line_script,2016/01/26,ccc_media_line_script,1,1,0:00:07,7,0:00:07,0,7
20160126-ccc_priority_script,2016/01/26,ccc_priority_script,42,41,0:00:13,13,0:01:18,1,533
20160126-ccc_tax_script,2016/01/26,ccc_tax_script,14,14,0:01:30,90,0:04:31,0,1260
20160126-ccc_waste_recycling_script,2016/01/26,ccc_waste_recycling_script,0,0,0:00:00,0,0:00:00,0,0
20160127-ccc_311_calgary_script,2016/01/27,ccc_311_calgary_script,3046,2923,0:00:26,26,0:05:52,123,75998
20160127-ccc_311_lobby_ph_script,2016/01/27,ccc_311_lobby_ph_script,1,1,0:00:04,4,0:00:04,0,4
20160127-ccc_aserv_info_script,2016/01/27,ccc_aserv_info_script,0,0,0:00:00,0,0:00:00,0,0
20160127-ccc_bylaw_script,2016/01/27,ccc_bylaw_script,0,0,0:00:00,0,0:00:00,0,0
20160127-ccc_city_script,2016/01/27,ccc_city_script,15,15,0:00:04,4,0:00:11,0,60
20160127-ccc_cty_online_script,2016/01/27,ccc_cty_online_script,0,0,0:00:00,0,0:00:00,0,0
20160127-ccc_feedback_script,2016/01/27,ccc_feedback_script,0,0,0:00:00,0,0:00:00,0,0
20160127-ccc_fpb_script,2016/01/27,ccc_fpb_script,1,1,0:00:05,5,0:00:05,0,5
20160127-ccc_help_script,2016/01/27,ccc_help_script,11,11,0:00:17,17,0:00:50,0,187
20160127-ccc_link_script,2016/01/27,ccc_link_script,0,0,0:00:00,0,0:00:00,0,0
20160127-ccc_media_line_script,2016/01/27,ccc_media_line_script,1,1,0:00:08,8,0:00:08,0,8
20160127-ccc_priority_script,2016/01/27,ccc_priority_script,31,30,0:00:16,16,0:01:48,1,480
20160127-ccc_tax_script,2016/01/27,ccc_tax_script,17,17,0:00:09,9,0:01:05,0,153
20160127-ccc_waste_recycling_script,2016/01/27,ccc_waste_recycling_script,0,0,0:00:00,0,0:00:00,0,0
20160128-ccc_311_calgary_script,2016/01/28,ccc_311_calgary_script,2969,2811,0:00:41,41,0:09:18,158,115251
20160128-ccc_311_lobby_ph_script,2016/01/28,ccc_311_lobby_ph_script,5,4,0:00:06,6,0:00:13,1,24
20160128-ccc_aserv_info_script,2016/01/28,ccc_aserv_info_script,0,0,0:00:00,0,0:00:00,0,0
20160128-ccc_bylaw_script,2016/01/28,ccc_bylaw_script,0,0,0:00:00,0,0:00:00,0,0
20160128-ccc_city_script,2016/01/28,ccc_city_script,14,14,0:00:26,26,0:03:58,0,364
20160128-ccc_cty_online_script,2016/01/28,ccc_cty_online_script,0,0,0:00:00,0,0:00:00,0,0
20160128-ccc_feedback_script,2016/01/28,ccc_feedback_script,0,0,0:00:00,0,0:00:00,0,0
20160128-ccc_fpb_script,2016/01/28,ccc_fpb_script,0,0,0:00:00,0,0:00:00,0,0
20160128-ccc_help_script,2016/01/28,ccc_help_script,10,10,0:00:14,14,0:01:15,0,140
20160128-ccc_link_script,2016/01/28,ccc_link_script,0,0,0:00:00,0,0:00:00,0,0
20160128-ccc_media_line_script,2016/01/28,ccc_media_line_script,0,0,0:00:00,0,0:00:00,0,0
20160128-ccc_priority_script,2016/01/28,ccc_priority_script,34,34,0:00:23,23,0:03:18,0,782
20160128-ccc_tax_script,2016/01/28,ccc_tax_script,23,21,0:00:36,36,0:02:10,2,756
20160128-ccc_waste_recycling_script,2016/01/28,ccc_waste_recycling_script,0,0,0:00:00,0,0:00:00,0,0
20160129-ccc_311_calgary_script,2016/01/29,ccc_311_calgary_script,2714,2584,0:00:35,35,0:09:17,130,90440
20160129-ccc_311_lobby_ph_script,2016/01/29,ccc_311_lobby_ph_script,4,4,0:00:10,10,0:00:18,0,40
20160129-ccc_aserv_info_script,2016/01/29,ccc_aserv_info_script,0,0,0:00:00,0,0:00:00,0,0
20160129-ccc_bylaw_script,2016/01/29,ccc_bylaw_script,0,0,0:00:00,0,0:00:00,0,0
20160129-ccc_city_script,2016/01/29,ccc_city_script,20,20,0:00:08,8,0:00:25,0,160
20160129-ccc_cty_online_script,2016/01/29,ccc_cty_online_script,0,0,0:00:00,0,0:00:00,0,0
20160129-ccc_feedback_script,2016/01/29,ccc_feedback_script,0,0,0:00:00,0,0:00:00,0,0
20160129-ccc_fpb_script,2016/01/29,ccc_fpb_script,0,0,0:00:00,0,0:00:00,0,0
20160129-ccc_help_script,2016/01/29,ccc_help_script,6,6,0:00:08,8,0:00:15,0,48
20160129-ccc_link_script,2016/01/29,ccc_link_script,0,0,0:00:00,0,0:00:00,0,0
20160129-ccc_media_line_script,2016/01/29,ccc_media_line_script,0,0,0:00:00,0,0:00:00,0,0
20160129-ccc_priority_script,2016/01/29,ccc_priority_script,19,19,0:00:19,19,0:02:28,0,361
20160129-ccc_tax_script,2016/01/29,ccc_tax_script,20,19,0:00:23,23,0:02:24,1,437
20160129-ccc_waste_recycling_script,2016/01/29,ccc_waste_recycling_script,0,0,0:00:00,0,0:00:00,0,0
20160130-ccc_311_calgary_script,2016/01/30,ccc_311_calgary_script,1124,1113,0:00:10,10,0:04:10,11,11130
20160130-ccc_311_lobby_ph_script,2016/01/30,ccc_311_lobby_ph_script,0,0,0:00:00,0,0:00:00,0,0
20160130-ccc_aserv_info_script,2016/01/30,ccc_aserv_info_script,0,0,0:00:00,0,0:00:00,0,0
20160130-ccc_bylaw_script,2016/01/30,ccc_bylaw_script,0,0,0:00:00,0,0:00:00,0,0
20160130-ccc_city_script,2016/01/30,ccc_city_script,0,0,0:00:00,0,0:00:00,0,0
20160130-ccc_cty_online_script,2016/01/30,ccc_cty_online_script,0,0,0:00:00,0,0:00:00,0,0
20160130-ccc_feedback_script,2016/01/30,ccc_feedback_script,0,0,0:00:00,0,0:00:00,0,0
20160130-ccc_fpb_script,2016/01/30,ccc_fpb_script,0,0,0:00:00,0,0:00:00,0,0
20160130-ccc_help_script,2016/01/30,ccc_help_script,7,7,0:00:08,8,0:00:17,0,56
20160130-ccc_link_script,2016/01/30,ccc_link_script,0,0,0:00:00,0,0:00:00,0,0
20160130-ccc_media_line_script,2016/01/30,ccc_media_line_script,0,0,0:00:00,0,0:00:00,0,0
20160130-ccc_priority_script,2016/01/30,ccc_priority_script,17,17,0:00:11,11,0:01:42,0,187
20160130-ccc_tax_script,2016/01/30,ccc_tax_script,2,2,0:00:07,7,0:00:11,0,14
20160130-ccc_waste_recycling_script,2016/01/30,ccc_waste_recycling_script,0,0,0:00:00,0,0:00:00,0,0
20160131-ccc_311_calgary_script,2016/01/31,ccc_311_calgary_script,892,869,0:00:16,16,0:05:13,23,13904
20160131-ccc_311_lobby_ph_script,2016/01/31,ccc_311_lobby_ph_script,1,1,0:00:05,5,0:00:05,0,5
20160131-ccc_aserv_info_script,2016/01/31,ccc_aserv_info_script,0,0,0:00:00,0,0:00:00,0,0
20160131-ccc_bylaw_script,2016/01/31,ccc_bylaw_script,0,0,0:00:00,0,0:00:00,0,0
20160131-ccc_city_script,2016/01/31,ccc_city_script,0,0,0:00:00,0,0:00:00,0,0
20160131-ccc_cty_online_script,2016/01/31,ccc_cty_online_script,0,0,0:00:00,0,0:00:00,0,0
20160131-ccc_feedback_script,2016/01/31,ccc_feedback_script,0,0,0:00:00,0,0:00:00,0,0
20160131-ccc_fpb_script,2016/01/31,ccc_fpb_script,0,0,0:00:00,0,0:00:00,0,0
20160131-ccc_help_script,2016/01/31,ccc_help_script,4,4,0:00:14,14,0:00:28,0,56
20160131-ccc_link_script,2016/01/31,ccc_link_script,0,0,0:00:00,0,0:00:00,0,0
20160131-ccc_media_line_script,2016/01/31,ccc_media_line_script,1,1,0:00:02,2,0:00:02,0,2
20160131-ccc_priority_script,2016/01/31,ccc_priority_script,21,20,0:00:06,6,0:00:14,1,120
20160131-ccc_tax_script,2016/01/31,ccc_tax_script,0,0,0:00:00,0,0:00:00,0,0
20160131-ccc_waste_recycling_script,2016/01/31,ccc_waste_recycling_script,0,0,0:00:00,0,0:00:00,0,0
20160201-ccc_311_calgary_script,2016/02/01,ccc_311_calgary_script,3046,2965,0:00:19,19,0:03:12,81,56335
20160201-ccc_311_lobby_ph_script,2016/02/01,ccc_311_lobby_ph_script,7,7,0:00:11,11,0:00:26,0,77
20160201-ccc_aserv_info_script,2016/02/01,ccc_aserv_info_script,0,0,0:00:00,0,0:00:00,0,0
20160201-ccc_bylaw_script,2016/02/01,ccc_bylaw_script,0,0,0:00:00,0,0:00:00,0,0
20160201-ccc_city_script,2016/02/01,ccc_city_script,20,20,0:00:11,11,0:01:41,0,220
20160201-ccc_cty_online_script,2016/02/01,ccc_cty_online_script,0,0,0:00:00,0,0:00:00,0,0
20160201-ccc_feedback_script,2016/02/01,ccc_feedback_script,0,0,0:00:00,0,0:00:00,0,0
20160201-ccc_fpb_script,2016/02/01,ccc_fpb_script,0,0,0:00:00,0,0:00:00,0,0
20160201-ccc_help_script,2016/02/01,ccc_help_script,20,19,0:00:11,11,0:00:49,1,209
20160201-ccc_link_script,2016/02/01,ccc_link_script,0,0,0:00:00,0,0:00:00,0,0
20160201-ccc_media_line_script,2016/02/01,ccc_media_line_script,1,1,0:00:02,2,0:00:02,0,2
20160201-ccc_priority_script,2016/02/01,ccc_priority_script,22,20,0:00:08,8,0:00:18,2,160
20160201-ccc_tax_script,2016/02/01,ccc_tax_script,23,23,0:00:19,19,0:03:07,0,437
20160201-ccc_waste_recycling_script,2016/02/01,ccc_waste_recycling_script,0,0,0:00:00,0,0:00:00,0,0
20160202-ccc_311_calgary_script,2016/02/02,ccc_311_calgary_script,3062,2892,0:00:37,37,0:06:43,170,107004
20160202-ccc_311_lobby_ph_script,2016/02/02,ccc_311_lobby_ph_script,3,2,0:00:08,8,0:00:08,1,16
20160202-ccc_aserv_info_script,2016/02/02,ccc_aserv_info_script,0,0,0:00:00,0,0:00:00,0,0
20160202-ccc_bylaw_script,2016/02/02,ccc_bylaw_script,0,0,0:00:00,0,0:00:00,0,0
20160202-ccc_city_script,2016/02/02,ccc_city_script,14,14,0:00:29,29,0:05:02,0,406
20160202-ccc_cty_online_script,2016/02/02,ccc_cty_online_script,0,0,0:00:00,0,0:00:00,0,0
20160202-ccc_feedback_script,2016/02/02,ccc_feedback_script,0,0,0:00:00,0,0:00:00,0,0
20160202-ccc_fpb_script,2016/02/02,ccc_fpb_script,1,1,0:00:07,7,0:00:07,0,7
20160202-ccc_help_script,2016/02/02,ccc_help_script,9,9,0:00:20,20,0:01:00,0,180
20160202-ccc_link_script,2016/02/02,ccc_link_script,0,0,0:00:00,0,0:00:00,0,0
20160202-ccc_media_line_script,2016/02/02,ccc_media_line_script,0,0,0:00:00,0,0:00:00,0,0
20160202-ccc_priority_script,2016/02/02,ccc_priority_script,27,26,0:00:08,8,0:00:27,1,208
20160202-ccc_tax_script,2016/02/02,ccc_tax_script,9,9,0:00:25,25,0:01:04,0,225
20160202-ccc_waste_recycling_script,2016/02/02,ccc_waste_recycling_script,0,0,0:00:00,0,0:00:00,0,0
20160203-ccc_311_calgary_script,2016/02/03,ccc_311_calgary_script,2780,2700,0:00:17,17,0:06:36,80,45900
20160203-ccc_311_lobby_ph_script,2016/02/03,ccc_311_lobby_ph_script,4,4,0:00:04,4,0:00:06,0,16
20160203-ccc_aserv_info_script,2016/02/03,ccc_aserv_info_script,0,0,0:00:00,0,0:00:00,0,0
20160203-ccc_bylaw_script,2016/02/03,ccc_bylaw_script,0,0,0:00:00,0,0:00:00,0,0
20160203-ccc_city_script,2016/02/03,ccc_city_script,14,14,0:00:12,12,0:01:27,0,168
20160203-ccc_cty_online_script,2016/02/03,ccc_cty_online_script,0,0,0:00:00,0,0:00:00,0,0
20160203-ccc_feedback_script,2016/02/03,ccc_feedback_script,0,0,0:00:00,0,0:00:00,0,0
20160203-ccc_fpb_script,2016/02/03,ccc_fpb_script,0,0,0:00:00,0,0:00:00,0,0
20160203-ccc_help_script,2016/02/03,ccc_help_script,12,12,0:00:12,12,0:00:39,0,144
20160203-ccc_link_script,2016/02/03,ccc_link_script,0,0,0:00:00,0,0:00:00,0,0
20160203-ccc_media_line_script,2016/02/03,ccc_media_line_script,1,1,0:00:06,6,0:00:06,0,6
20160203-ccc_priority_script,2016/02/03,ccc_priority_script,25,25,0:00:12,12,0:00:47,0,300
20160203-ccc_tax_script,2016/02/03,ccc_tax_script,19,18,0:00:06,6,0:00:21,1,108
20160203-ccc_waste_recycling_script,2016/02/03,ccc_waste_recycling_script,0,0,0:00:00,0,0:00:00,0,0
20160204-ccc_311_calgary_script,2016/02/04,ccc_311_calgary_script,2701,2670,0:00:15,15,0:03:39,31,40050
20160204-ccc_311_lobby_ph_script,2016/02/04,ccc_311_lobby_ph_script,2,1,0:00:02,2,0:00:02,1,2
20160204-ccc_aserv_info_script,2016/02/04,ccc_aserv_info_script,0,0,0:00:00,0,0:00:00,0,0
20160204-ccc_bylaw_script,2016/02/04,ccc_bylaw_script,0,0,0:00:00,0,0:00:00,0,0
20160204-ccc_city_script,2016/02/04,ccc_city_script,12,12,0:00:09,9,0:00:28,0,108
20160204-ccc_cty_online_script,2016/02/04,ccc_cty_online_script,0,0,0:00:00,0,0:00:00,0,0
20160204-ccc_feedback_script,2016/02/04,ccc_feedback_script,0,0,0:00:00,0,0:00:00,0,0
20160204-ccc_fpb_script,2016/02/04,ccc_fpb_script,0,0,0:00:00,0,0:00:00,0,0
20160204-ccc_help_script,2016/02/04,ccc_help_script,18,17,0:00:06,6,0:00:10,1,102
20160204-ccc_link_script,2016/02/04,ccc_link_script,0,0,0:00:00,0,0:00:00,0,0
20160204-ccc_media_line_script,2016/02/04,ccc_media_line_script,0,0,0:00:00,0,0:00:00,0,0
20160204-ccc_priority_script,2016/02/04,ccc_priority_script,31,28,0:00:08,8,0:00:24,3,224
20160204-ccc_tax_script,2016/02/04,ccc_tax_script,23,23,0:00:16,16,0:01:50,0,368
20160204-ccc_waste_recycling_script,2016/02/04,ccc_waste_recycling_script,0,0,0:00:00,0,0:00:00,0,0
20160205-ccc_311_calgary_script,2016/02/05,ccc_311_calgary_script,2523,2457,0:00:28,28,0:06:20,66,68796
20160205-ccc_311_lobby_ph_script,2016/02/05,ccc_311_lobby_ph_script,5,5,0:00:10,10,0:00:23,0,50
20160205-ccc_aserv_info_script,2016/02/05,ccc_aserv_info_script,0,0,0:00:00,0,0:00:00,0,0
20160205-ccc_bylaw_script,2016/02/05,ccc_bylaw_script,0,0,0:00:00,0,0:00:00,0,0
20160205-ccc_city_script,2016/02/05,ccc_city_script,6,6,0:00:06,6,0:00:09,0,36
20160205-ccc_cty_online_script,2016/02/05,ccc_cty_online_script,0,0,0:00:00,0,0:00:00,0,0
20160205-ccc_feedback_script,2016/02/05,ccc_feedback_script,0,0,0:00:00,0,0:00:00,0,0
20160205-ccc_fpb_script,2016/02/05,ccc_fpb_script,0,0,0:00:00,0,0:00:00,0,0
20160205-ccc_help_script,2016/02/05,ccc_help_script,5,5,0:00:22,22,0:01:05,0,110
20160205-ccc_link_script,2016/02/05,ccc_link_script,1,0,0:00:00,0,0:00:00,0,0
20160205-ccc_media_line_script,2016/02/05,ccc_media_line_script,0,0,0:00:00,0,0:00:00,0,0
20160205-ccc_priority_script,2016/02/05,ccc_priority_script,19,19,0:00:09,9,0:00:31,0,171
20160205-ccc_tax_script,2016/02/05,ccc_tax_script,19,18,0:01:09,69,0:05:25,1,1242
20160205-ccc_waste_recycling_script,2016/02/05,ccc_waste_recycling_script,0,0,0:00:00,0,0:00:00,0,0
20160206-ccc_311_calgary_script,2016/02/06,ccc_311_calgary_script,1052,1036,0:00:07,7,0:03:41,16,7252
20160206-ccc_311_lobby_ph_script,2016/02/06,ccc_311_lobby_ph_script,0,0,0:00:00,0,0:00:00,0,0
20160206-ccc_aserv_info_script,2016/02/06,ccc_aserv_info_script,0,0,0:00:00,0,0:00:00,0,0
20160206-ccc_bylaw_script,2016/02/06,ccc_bylaw_script,0,0,0:00:00,0,0:00:00,0,0
20160206-ccc_city_script,2016/02/06,ccc_city_script,0,0,0:00:00,0,0:00:00,0,0
20160206-ccc_cty_online_script,2016/02/06,ccc_cty_online_script,0,0,0:00:00,0,0:00:00,0,0
20160206-ccc_feedback_script,2016/02/06,ccc_feedback_script,0,0,0:00:00,0,0:00:00,0,0
20160206-ccc_fpb_script,2016/02/06,ccc_fpb_script,0,0,0:00:00,0,0:00:00,0,0
20160206-ccc_help_script,2016/02/06,ccc_help_script,2,2,0:00:09,9,0:00:09,0,18
20160206-ccc_link_script,2016/02/06,ccc_link_script,0,0,0:00:00,0,0:00:00,0,0
20160206-ccc_media_line_script,2016/02/06,ccc_media_line_script,3,3,0:00:06,6,0:00:08,0,18
20160206-ccc_priority_script,2016/02/06,ccc_priority_script,24,24,0:00:12,12,0:02:19,0,288
20160206-ccc_tax_script,2016/02/06,ccc_tax_script,3,2,0:00:04,4,0:00:04,1,8
20160206-ccc_waste_recycling_script,2016/02/06,ccc_waste_recycling_script,0,0,0:00:00,0,0:00:00,0,0
20160207-ccc_311_calgary_script,2016/02/07,ccc_311_calgary_script,788,773,0:00:08,8,0:07:12,15,6184
20160207-ccc_311_lobby_ph_script,2016/02/07,ccc_311_lobby_ph_script,0,0,0:00:00,0,0:00:00,0,0
20160207-ccc_aserv_info_script,2016/02/07,ccc_aserv_info_script,0,0,0:00:00,0,0:00:00,0,0
20160207-ccc_bylaw_script,2016/02/07,ccc_bylaw_script,0,0,0:00:00,0,0:00:00,0,0
20160207-ccc_city_script,2016/02/07,ccc_city_script,0,0,0:00:00,0,0:00:00,0,0
20160207-ccc_cty_online_script,2016/02/07,ccc_cty_online_script,0,0,0:00:00,0,0:00:00,0,0
20160207-ccc_feedback_script,2016/02/07,ccc_feedback_script,0,0,0:00:00,0,0:00:00,0,0
20160207-ccc_fpb_script,2016/02/07,ccc_fpb_script,0,0,0:00:00,0,0:00:00,0,0
20160207-ccc_help_script,2016/02/07,ccc_help_script,2,2,0:00:24,24,0:00:24,0,48
20160207-ccc_link_script,2016/02/07,ccc_link_script,0,0,0:00:00,0,0:00:00,0,0
20160207-ccc_media_line_script,2016/02/07,ccc_media_line_script,1,1,0:00:06,6,0:00:06,0,6
20160207-ccc_priority_script,2016/02/07,ccc_priority_script,17,17,0:00:05,5,0:00:11,0,85
20160207-ccc_tax_script,2016/02/07,ccc_tax_script,0,0,0:00:00,0,0:00:00,0,0
20160207-ccc_waste_recycling_script,2016/02/07,ccc_waste_recycling_script,0,0,0:00:00,0,0:00:00,0,0
20160208-ccc_311_calgary_script,2016/02/08,ccc_311_calgary_script,3215,3155,0:00:20,20,0:05:07,60,63100
20160208-ccc_311_lobby_ph_script,2016/02/08,ccc_311_lobby_ph_script,1,1,0:00:14,14,0:00:14,0,14
20160208-ccc_aserv_info_script,2016/02/08,ccc_aserv_info_script,0,0,0:00:00,0,0:00:00,0,0
20160208-ccc_bylaw_script,2016/02/08,ccc_bylaw_script,0,0,0:00:00,0,0:00:00,0,0
20160208-ccc_city_script,2016/02/08,ccc_city_script,16,16,0:00:13,13,0:01:47,0,208
20160208-ccc_cty_online_script,2016/02/08,ccc_cty_online_script,0,0,0:00:00,0,0:00:00,0,0
20160208-ccc_feedback_script,2016/02/08,ccc_feedback_script,0,0,0:00:00,0,0:00:00,0,0
20160208-ccc_fpb_script,2016/02/08,ccc_fpb_script,0,0,0:00:00,0,0:00:00,0,0
20160208-ccc_help_script,2016/02/08,ccc_help_script,16,16,0:00:17,17,0:01:12,0,272
20160208-ccc_link_script,2016/02/08,ccc_link_script,0,0,0:00:00,0,0:00:00,0,0
20160208-ccc_media_line_script,2016/02/08,ccc_media_line_script,1,1,0:00:19,19,0:00:19,0,19
20160208-ccc_priority_script,2016/02/08,ccc_priority_script,19,19,0:00:11,11,0:01:03,0,209
20160208-ccc_tax_script,2016/02/08,ccc_tax_script,11,10,0:00:35,35,0:04:10,1,350
20160208-ccc_waste_recycling_script,2016/02/08,ccc_waste_recycling_script,0,0,0:00:00,0,0:00:00,0,0
20160209-ccc_311_calgary_script,2016/02/09,ccc_311_calgary_script,3260,3064,0:00:52,52,0:04:47,196,159328
20160209-ccc_311_lobby_ph_script,2016/02/09,ccc_311_lobby_ph_script,2,2,0:00:13,13,0:00:20,0,26
20160209-ccc_aserv_info_script,2016/02/09,ccc_aserv_info_script,0,0,0:00:00,0,0:00:00,0,0
20160209-ccc_bylaw_script,2016/02/09,ccc_bylaw_script,0,0,0:00:00,0,0:00:00,0,0
20160209-ccc_city_script,2016/02/09,ccc_city_script,21,21,0:00:18,18,0:02:00,0,378
20160209-ccc_cty_online_script,2016/02/09,ccc_cty_online_script,0,0,0:00:00,0,0:00:00,0,0
20160209-ccc_feedback_script,2016/02/09,ccc_feedback_script,0,0,0:00:00,0,0:00:00,0,0
20160209-ccc_fpb_script,2016/02/09,ccc_fpb_script,0,0,0:00:00,0,0:00:00,0,0
20160209-ccc_help_script,2016/02/09,ccc_help_script,8,7,0:00:17,17,0:00:43,1,119
20160209-ccc_link_script,2016/02/09,ccc_link_script,0,0,0:00:00,0,0:00:00,0,0
20160209-ccc_media_line_script,2016/02/09,ccc_media_line_script,1,1,0:00:02,2,0:00:02,0,2
20160209-ccc_priority_script,2016/02/09,ccc_priority_script,34,33,0:00:07,7,0:00:25,1,231
20160209-ccc_tax_script,2016/02/09,ccc_tax_script,16,16,0:01:06,66,0:03:00,0,1056
20160209-ccc_waste_recycling_script,2016/02/09,ccc_waste_recycling_script,0,0,0:00:00,0,0:00:00,0,0
20160210-ccc_311_calgary_script,2016/02/10,ccc_311_calgary_script,2884,2817,0:00:15,15,0:04:13,67,42255
20160210-ccc_311_lobby_ph_script,2016/02/10,ccc_311_lobby_ph_script,3,3,0:00:06,6,0:00:08,0,18
20160210-ccc_aserv_info_script,2016/02/10,ccc_aserv_info_script,0,0,0:00:00,0,0:00:00,0,0
20160210-ccc_bylaw_script,2016/02/10,ccc_bylaw_script,0,0,0:00:00,0,0:00:00,0,0
20160210-ccc_city_script,2016/02/10,ccc_city_script,18,17,0:00:09,9,0:00:22,1,153
20160210-ccc_cty_online_script,2016/02/10,ccc_cty_online_script,0,0,0:00:00,0,0:00:00,0,0
20160210-ccc_feedback_script,2016/02/10,ccc_feedback_script,1,0,0:00:00,0,0:00:00,0,0
20160210-ccc_fpb_script,2016/02/10,ccc_fpb_script,2,2,0:00:06,6,0:00:06,0,12
20160210-ccc_help_script,2016/02/10,ccc_help_script,22,21,0:00:14,14,0:00:43,1,294
20160210-ccc_link_script,2016/02/10,ccc_link_script,0,0,0:00:00,0,0:00:00,0,0
20160210-ccc_media_line_script,2016/02/10,ccc_media_line_script,0,0,0:00:00,0,0:00:00,0,0
20160210-ccc_priority_script,2016/02/10,ccc_priority_script,19,17,0:00:08,8,0:00:24,2,136
20160210-ccc_tax_script,2016/02/10,ccc_tax_script,16,16,0:00:21,21,0:02:01,0,336
20160210-ccc_waste_recycling_script,2016/02/10,ccc_waste_recycling_script,0,0,0:00:00,0,0:00:00,0,0
20160211-ccc_311_calgary_script,2016/02/11,ccc_311_calgary_script,2811,2753,0:00:15,15,0:11:17,58,41295
20160211-ccc_311_lobby_ph_script,2016/02/11,ccc_311_lobby_ph_script,2,2,0:00:04,4,0:00:05,0,8
20160211-ccc_aserv_info_script,2016/02/11,ccc_aserv_info_script,0,0,0:00:00,0,0:00:00,0,0
20160211-ccc_bylaw_script,2016/02/11,ccc_bylaw_script,0,0,0:00:00,0,0:00:00,0,0
20160211-ccc_city_script,2016/02/11,ccc_city_script,16,16,0:00:12,12,0:01:14,0,192
20160211-ccc_cty_online_script,2016/02/11,ccc_cty_online_script,0,0,0:00:00,0,0:00:00,0,0
20160211-ccc_feedback_script,2016/02/11,ccc_feedback_script,0,0,0:00:00,0,0:00:00,0,0
20160211-ccc_fpb_script,2016/02/11,ccc_fpb_script,1,1,0:00:06,6,0:00:06,0,6
20160211-ccc_help_script,2016/02/11,ccc_help_script,26,26,0:00:06,6,0:00:23,0,156
20160211-ccc_link_script,2016/02/11,ccc_link_script,0,0,0:00:00,0,0:00:00,0,0
20160211-ccc_media_line_script,2016/02/11,ccc_media_line_script,0,0,0:00:00,0,0:00:00,0,0
20160211-ccc_priority_script,2016/02/11,ccc_priority_script,32,31,0:00:13,13,0:01:08,1,403
20160211-ccc_tax_script,2016/02/11,ccc_tax_script,21,21,0:00:17,17,0:01:38,0,357
20160211-ccc_waste_recycling_script,2016/02/11,ccc_waste_recycling_script,0,0,0:00:00,0,0:00:00,0,0
20160212-ccc_311_calgary_script,2016/02/12,ccc_311_calgary_script,2490,2454,0:00:14,14,0:03:49,36,34356
20160212-ccc_311_lobby_ph_script,2016/02/12,ccc_311_lobby_ph_script,5,5,0:00:10,10,0:00:29,0,50
20160212-ccc_aserv_info_script,2016/02/12,ccc_aserv_info_script,0,0,0:00:00,0,0:00:00,0,0
20160212-ccc_bylaw_script,2016/02/12,ccc_bylaw_script,0,0,0:00:00,0,0:00:00,0,0
20160212-ccc_city_script,2016/02/12,ccc_city_script,14,14,0:00:10,10,0:00:29,0,140
20160212-ccc_cty_online_script,2016/02/12,ccc_cty_online_script,0,0,0:00:00,0,0:00:00,0,0
20160212-ccc_feedback_script,2016/02/12,ccc_feedback_script,0,0,0:00:00,0,0:00:00,0,0
20160212-ccc_fpb_script,2016/02/12,ccc_fpb_script,0,0,0:00:00,0,0:00:00,0,0
20160212-ccc_help_script,2016/02/12,ccc_help_script,15,15,0:00:05,5,0:00:12,0,75
20160212-ccc_link_script,2016/02/12,ccc_link_script,0,0,0:00:00,0,0:00:00,0,0
20160212-ccc_media_line_script,2016/02/12,ccc_media_line_script,3,3,0:00:09,9,0:00:18,0,27
20160212-ccc_priority_script,2016/02/12,ccc_priority_script,17,13,0:00:09,9,0:00:43,4,117
20160212-ccc_tax_script,2016/02/12,ccc_tax_script,9,9,0:00:26,26,0:01:17,0,234
20160212-ccc_waste_recycling_script,2016/02/12,ccc_waste_recycling_script,0,0,0:00:00,0,0:00:00,0,0
20160213-ccc_311_calgary_script,2016/02/13,ccc_311_calgary_script,989,972,0:00:10,10,0:07:01,17,9720
20160213-ccc_311_lobby_ph_script,2016/02/13,ccc_311_lobby_ph_script,0,0,0:00:00,0,0:00:00,0,0
20160213-ccc_aserv_info_script,2016/02/13,ccc_aserv_info_script,0,0,0:00:00,0,0:00:00,0,0
20160213-ccc_bylaw_script,2016/02/13,ccc_bylaw_script,0,0,0:00:00,0,0:00:00,0,0
20160213-ccc_city_script,2016/02/13,ccc_city_script,0,0,0:00:00,0,0:00:00,0,0
20160213-ccc_cty_online_script,2016/02/13,ccc_cty_online_script,0,0,0:00:00,0,0:00:00,0,0
20160213-ccc_feedback_script,2016/02/13,ccc_feedback_script,0,0,0:00:00,0,0:00:00,0,0
20160213-ccc_fpb_script,2016/02/13,ccc_fpb_script,0,0,0:00:00,0,0:00:00,0,0
20160213-ccc_help_script,2016/02/13,ccc_help_script,4,4,0:00:04,4,0:00:09,0,16
20160213-ccc_link_script,2016/02/13,ccc_link_script,0,0,0:00:00,0,0:00:00,0,0
20160213-ccc_media_line_script,2016/02/13,ccc_media_line_script,0,0,0:00:00,0,0:00:00,0,0
20160213-ccc_priority_script,2016/02/13,ccc_priority_script,19,19,0:00:04,4,0:00:10,0,76
20160213-ccc_tax_script,2016/02/13,ccc_tax_script,1,1,0:00:11,11,0:00:11,0,11
20160213-ccc_waste_recycling_script,2016/02/13,ccc_waste_recycling_script,0,0,0:00:00,0,0:00:00,0,0
20160214-ccc_311_calgary_script,2016/02/14,ccc_311_calgary_script,849,838,0:00:12,12,0:05:48,11,10056
20160214-ccc_311_lobby_ph_script,2016/02/14,ccc_311_lobby_ph_script,0,0,0:00:00,0,0:00:00,0,0
20160214-ccc_aserv_info_script,2016/02/14,ccc_aserv_info_script,0,0,0:00:00,0,0:00:00,0,0
20160214-ccc_bylaw_script,2016/02/14,ccc_bylaw_script,0,0,0:00:00,0,0:00:00,0,0
20160214-ccc_city_script,2016/02/14,ccc_city_script,0,0,0:00:00,0,0:00:00,0,0
20160214-ccc_cty_online_script,2016/02/14,ccc_cty_online_script,0,0,0:00:00,0,0:00:00,0,0
20160214-ccc_feedback_script,2016/02/14,ccc_feedback_script,0,0,0:00:00,0,0:00:00,0,0
20160214-ccc_fpb_script,2016/02/14,ccc_fpb_script,1,1,0:00:02,2,0:00:02,0,2
20160214-ccc_help_script,2016/02/14,ccc_help_script,0,0,0:00:00,0,0:00:00,0,0
20160214-ccc_link_script,2016/02/14,ccc_link_script,0,0,0:00:00,0,0:00:00,0,0
20160214-ccc_media_line_script,2016/02/14,ccc_media_line_script,0,0,0:00:00,0,0:00:00,0,0
20160214-ccc_priority_script,2016/02/14,ccc_priority_script,20,19,0:00:10,10,0:01:33,1,190
20160214-ccc_tax_script,2016/02/14,ccc_tax_script,0,0,0:00:00,0,0:00:00,0,0
20160214-ccc_waste_recycling_script,2016/02/14,ccc_waste_recycling_script,0,0,0:00:00,0,0:00:00,0,0
20160215-ccc_311_calgary_script,2016/02/15,ccc_311_calgary_script,1369,1350,0:00:09,9,0:06:56,19,12150
20160215-ccc_311_lobby_ph_script,2016/02/15,ccc_311_lobby_ph_script,0,0,0:00:00,0,0:00:00,0,0
20160215-ccc_aserv_info_script,2016/02/15,ccc_aserv_info_script,0,0,0:00:00,0,0:00:00,0,0
20160215-ccc_bylaw_script,2016/02/15,ccc_bylaw_script,0,0,0:00:00,0,0:00:00,0,0
20160215-ccc_city_script,2016/02/15,ccc_city_script,0,0,0:00:00,0,0:00:00,0,0
20160215-ccc_cty_online_script,2016/02/15,ccc_cty_online_script,0,0,0:00:00,0,0:00:00,0,0
20160215-ccc_feedback_script,2016/02/15,ccc_feedback_script,0,0,0:00:00,0,0:00:00,0,0
20160215-ccc_fpb_script,2016/02/15,ccc_fpb_script,0,0,0:00:00,0,0:00:00,0,0
20160215-ccc_help_script,2016/02/15,ccc_help_script,2,2,0:00:09,9,0:00:10,0,18
20160215-ccc_link_script,2016/02/15,ccc_link_script,0,0,0:00:00,0,0:00:00,0,0
20160215-ccc_media_line_script,2016/02/15,ccc_media_line_script,2,2,0:00:05,5,0:00:07,0,10
20160215-ccc_priority_script,2016/02/15,ccc_priority_script,10,8,0:00:14,14,0:00:35,2,112
20160215-ccc_tax_script,2016/02/15,ccc_tax_script,0,0,0:00:00,0,0:00:00,0,0
20160215-ccc_waste_recycling_script,2016/02/15,ccc_waste_recycling_script,0,0,0:00:00,0,0:00:00,0,0
20160216-ccc_311_calgary_script,2016/02/16,ccc_311_calgary_script,3320,3213,0:00:24,24,0:04:10,107,77112
20160216-ccc_311_lobby_ph_script,2016/02/16,ccc_311_lobby_ph_script,5,3,0:00:15,15,0:00:19,2,45
20160216-ccc_aserv_info_script,2016/02/16,ccc_aserv_info_script,0,0,0:00:00,0,0:00:00,0,0
20160216-ccc_bylaw_script,2016/02/16,ccc_bylaw_script,0,0,0:00:00,0,0:00:00,0,0
20160216-ccc_city_script,2016/02/16,ccc_city_script,18,18,0:00:11,11,0:01:18,0,198
20160216-ccc_cty_online_script,2016/02/16,ccc_cty_online_script,0,0,0:00:00,0,0:00:00,0,0
20160216-ccc_feedback_script,2016/02/16,ccc_feedback_script,0,0,0:00:00,0,0:00:00,0,0
20160216-ccc_fpb_script,2016/02/16,ccc_fpb_script,0,0,0:00:00,0,0:00:00,0,0
20160216-ccc_help_script,2016/02/16,ccc_help_script,5,4,0:00:11,11,0:00:16,1,44
20160216-ccc_link_script,2016/02/16,ccc_link_script,0,0,0:00:00,0,0:00:00,0,0
20160216-ccc_media_line_script,2016/02/16,ccc_media_line_script,1,1,0:00:10,10,0:00:10,0,10
20160216-ccc_priority_script,2016/02/16,ccc_priority_script,26,26,0:00:09,9,0:00:45,0,234
20160216-ccc_tax_script,2016/02/16,ccc_tax_script,8,8,0:00:16,16,0:01:23,0,128
20160216-ccc_waste_recycling_script,2016/02/16,ccc_waste_recycling_script,0,0,0:00:00,0,0:00:00,0,0
20160217-ccc_311_calgary_script,2016/02/17,ccc_311_calgary_script,2960,2804,0:00:39,39,0:06:07,156,109356
20160217-ccc_311_lobby_ph_script,2016/02/17,ccc_311_lobby_ph_script,4,4,0:00:07,7,0:00:17,0,28
20160217-ccc_aserv_info_script,2016/02/17,ccc_aserv_info_script,0,0,0:00:00,0,0:00:00,0,0
20160217-ccc_bylaw_script,2016/02/17,ccc_bylaw_script,0,0,0:00:00,0,0:00:00,0,0
20160217-ccc_city_script,2016/02/17,ccc_city_script,13,13,0:00:09,9,0:00:26,0,117
20160217-ccc_cty_online_script,2016/02/17,ccc_cty_online_script,0,0,0:00:00,0,0:00:00,0,0
20160217-ccc_feedback_script,2016/02/17,ccc_feedback_script,0,0,0:00:00,0,0:00:00,0,0
20160217-ccc_fpb_script,2016/02/17,ccc_fpb_script,1,1,0:00:23,23,0:00:23,0,23
20160217-ccc_help_script,2016/02/17,ccc_help_script,10,9,0:00:17,17,0:01:08,1,153
20160217-ccc_link_script,2016/02/17,ccc_link_script,1,0,0:00:00,0,0:00:00,1,0
20160217-ccc_media_line_script,2016/02/17,ccc_media_line_script,3,3,0:00:10,10,0:00:18,0,30
20160217-ccc_priority_script,2016/02/17,ccc_priority_script,16,16,0:00:21,21,0:02:07,0,336
20160217-ccc_tax_script,2016/02/17,ccc_tax_script,18,16,0:00:27,27,0:03:02,2,432
20160217-ccc_waste_recycling_script,2016/02/17,ccc_waste_recycling_script,0,0,0:00:00,0,0:00:00,0,0
20160218-ccc_311_calgary_script,2016/02/18,ccc_311_calgary_script,2723,2647,0:00:21,21,0:04:02,76,55587
20160218-ccc_311_lobby_ph_script,2016/02/18,ccc_311_lobby_ph_script,7,7,0:00:05,5,0:00:13,0,35
20160218-ccc_aserv_info_script,2016/02/18,ccc_aserv_info_script,0,0,0:00:00,0,0:00:00,0,0
20160218-ccc_bylaw_script,2016/02/18,ccc_bylaw_script,0,0,0:00:00,0,0:00:00,0,0
20160218-ccc_city_script,2016/02/18,ccc_city_script,21,21,0:00:08,8,0:00:42,0,168
20160218-ccc_cty_online_script,2016/02/18,ccc_cty_online_script,0,0,0:00:00,0,0:00:00,0,0
20160218-ccc_feedback_script,2016/02/18,ccc_feedback_script,0,0,0:00:00,0,0:00:00,0,0
20160218-ccc_fpb_script,2016/02/18,ccc_fpb_script,0,0,0:00:00,0,0:00:00,0,0
20160218-ccc_help_script,2016/02/18,ccc_help_script,12,12,0:00:19,19,0:00:41,0,228
20160218-ccc_link_script,2016/02/18,ccc_link_script,0,0,0:00:00,0,0:00:00,0,0
20160218-ccc_media_line_script,2016/02/18,ccc_media_line_script,3,3,0:00:11,11,0:00:20,0,33
20160218-ccc_priority_script,2016/02/18,ccc_priority_script,33,33,0:00:08,8,0:00:54,0,264
20160218-ccc_tax_script,2016/02/18,ccc_tax_script,12,11,0:00:45,45,0:03:20,1,495
20160218-ccc_waste_recycling_script,2016/02/18,ccc_waste_recycling_script,0,0,0:00:00,0,0:00:00,0,0
20160219-ccc_311_calgary_script,2016/02/19,ccc_311_calgary_script,2743,2599,0:00:46,46,0:05:14,144,119554
20160219-ccc_311_lobby_ph_script,2016/02/19,ccc_311_lobby_ph_script,0,0,0:00:00,0,0:00:00,0,0
20160219-ccc_aserv_info_script,2016/02/19,ccc_aserv_info_script,0,0,0:00:00,0,0:00:00,0,0
20160219-ccc_bylaw_script,2016/02/19,ccc_bylaw_script,0,0,0:00:00,0,0:00:00,0,0
20160219-ccc_city_script,2016/02/19,ccc_city_script,16,16,0:00:32,32,0:03:49,0,512
20160219-ccc_cty_online_script,2016/02/19,ccc_cty_online_script,0,0,0:00:00,0,0:00:00,0,0
20160219-ccc_feedback_script,2016/02/19,ccc_feedback_script,0,0,0:00:00,0,0:00:00,0,0
20160219-ccc_fpb_script,2016/02/19,ccc_fpb_script,0,0,0:00:00,0,0:00:00,0,0
20160219-ccc_help_script,2016/02/19,ccc_help_script,19,16,0:00:21,21,0:02:31,3,336
20160219-ccc_link_script,2016/02/19,ccc_link_script,0,0,0:00:00,0,0:00:00,0,0
20160219-ccc_media_line_script,2016/02/19,ccc_media_line_script,0,0,0:00:00,0,0:00:00,0,0
20160219-ccc_priority_script,2016/02/19,ccc_priority_script,29,29,0:00:09,9,0:00:24,0,261
20160219-ccc_tax_script,2016/02/19,ccc_tax_script,18,18,0:00:47,47,0:03:29,0,846
20160219-ccc_waste_recycling_script,2016/02/19,ccc_waste_recycling_script,0,0,0:00:00,0,0:00:00,0,0
20160220-ccc_311_calgary_script,2016/02/20,ccc_311_calgary_script,949,926,0:00:22,22,0:05:28,23,20372
20160220-ccc_311_lobby_ph_script,2016/02/20,ccc_311_lobby_ph_script,0,0,0:00:00,0,0:00:00,0,0
20160220-ccc_aserv_info_script,2016/02/20,ccc_aserv_info_script,0,0,0:00:00,0,0:00:00,0,0
20160220-ccc_bylaw_script,2016/02/20,ccc_bylaw_script,0,0,0:00:00,0,0:00:00,0,0
20160220-ccc_city_script,2016/02/20,ccc_city_script,0,0,0:00:00,0,0:00:00,0,0
20160220-ccc_cty_online_script,2016/02/20,ccc_cty_online_script,0,0,0:00:00,0,0:00:00,0,0
20160220-ccc_feedback_script,2016/02/20,ccc_feedback_script,2,0,0:00:00,0,0:00:00,0,0
20160220-ccc_fpb_script,2016/02/20,ccc_fpb_script,0,0,0:00:00,0,0:00:00,0,0
20160220-ccc_help_script,2016/02/20,ccc_help_script,0,0,0:00:00,0,0:00:00,0,0
20160220-ccc_link_script,2016/02/20,ccc_link_script,0,0,0:00:00,0,0:00:00,0,0
20160220-ccc_media_line_script,2016/02/20,ccc_media_line_script,0,0,0:00:00,0,0:00:00,0,0
20160220-ccc_priority_script,2016/02/20,ccc_priority_script,17,17,0:00:04,4,0:00:12,0,68
20160220-ccc_tax_script,2016/02/20,ccc_tax_script,3,2,0:00:08,8,0:00:09,1,16
20160220-ccc_waste_recycling_script,2016/02/20,ccc_waste_recycling_script,0,0,0:00:00,0,0:00:00,0,0
20160221-ccc_311_calgary_script,2016/02/21,ccc_311_calgary_script,826,814,0:00:12,12,0:04:42,12,9768
20160221-ccc_311_lobby_ph_script,2016/02/21,ccc_311_lobby_ph_script,0,0,0:00:00,0,0:00:00,0,0
20160221-ccc_aserv_info_script,2016/02/21,ccc_aserv_info_script,0,0,0:00:00,0,0:00:00,0,0
20160221-ccc_bylaw_script,2016/02/21,ccc_bylaw_script,0,0,0:00:00,0,0:00:00,0,0
20160221-ccc_city_script,2016/02/21,ccc_city_script,0,0,0:00:00,0,0:00:00,0,0
20160221-ccc_cty_online_script,2016/02/21,ccc_cty_online_script,0,0,0:00:00,0,0:00:00,0,0
20160221-ccc_feedback_script,2016/02/21,ccc_feedback_script,0,0,0:00:00,0,0:00:00,0,0
20160221-ccc_fpb_script,2016/02/21,ccc_fpb_script,0,0,0:00:00,0,0:00:00,0,0
20160221-ccc_help_script,2016/02/21,ccc_help_script,3,3,0:00:04,4,0:00:06,0,12
20160221-ccc_link_script,2016/02/21,ccc_link_script,0,0,0:00:00,0,0:00:00,0,0
20160221-ccc_media_line_script,2016/02/21,ccc_media_line_script,0,0,0:00:00,0,0:00:00,0,0
20160221-ccc_priority_script,2016/02/21,ccc_priority_script,18,18,0:00:16,16,0:02:17,0,288
20160221-ccc_tax_script,2016/02/21,ccc_tax_script,0,0,0:00:00,0,0:00:00,0,0
20160221-ccc_waste_recycling_script,2016/02/21,ccc_waste_recycling_script,0,0,0:00:00,0,0:00:00,0,0
2017-08-27-ccc_311_calgary_script,2017/08/27,ccc_311_calgary_script,1080,1023,00:00:39,39,00:17:53,59,39897
2017-08-27-ccc_311_lobby_ph_script,2017/08/27,ccc_311_lobby_ph_script,0,0,00:00:00,0,00:00:00,0,0
2017-08-27-ccc_aserv_info_script,2017/08/27,ccc_aserv_info_script,0,0,00:00:00,0,00:00:00,0,0
2017-08-27-ccc_bylaw_script,2017/08/27,ccc_bylaw_script,0,0,00:00:00,0,00:00:00,0,0
2017-08-27-ccc_city_script,2017/08/27,ccc_city_script,0,0,00:00:00,0,00:00:00,0,0
2017-08-27-ccc_cty_online_script,2017/08/27,ccc_cty_online_script,0,0,00:00:00,0,00:00:00,0,0
2017-08-27-ccc_feedback_script,2017/08/27,ccc_feedback_script,0,0,00:00:00,0,00:00:00,0,0
2017-08-27-ccc_fpb_script,2017/08/27,ccc_fpb_script,3,3,00:04:00,240,00:09:52,0,720
2017-08-27-ccc_help_script,2017/08/27,ccc_help_script,11,7,00:00:39,39,00:02:33,4,273
2017-08-27-ccc_link_script,2017/08/27,ccc_link_script,0,0,00:00:00,0,00:00:00,0,0
2017-08-27-ccc_media_line_script,2017/08/27,ccc_media_line_script,3,3,00:00:09,9,00:00:18,0,27
2017-08-27-ccc_priority_script,2017/08/27,ccc_priority_script,20,19,00:00:10,10,00:01:19,1,190
2017-08-27-ccc_tax_script,2017/08/27,ccc_tax_script,0,0,00:00:00,0,00:00:00,0,0
2017-08-27-ccc_waste_recycling_script,2017/08/27,ccc_waste_recycling_script,0,0,00:00:00,0,00:00:00,0,0
2017-08-28-ccc_311_calgary_script,2017/08/28,ccc_311_calgary_script,3783,3517,00:01:17,77,00:08:32,266,270809
2017-08-28-ccc_311_lobby_ph_script,2017/08/28,ccc_311_lobby_ph_script,5,4,00:00:09,9,00:00:16,1,36
2017-08-28-ccc_aserv_info_script,2017/08/28,ccc_aserv_info_script,0,0,00:00:00,0,00:00:00,0,0
2017-08-28-ccc_bylaw_script,2017/08/28,ccc_bylaw_script,0,0,00:00:00,0,00:00:00,0,0
2017-08-28-ccc_city_script,2017/08/28,ccc_city_script,23,23,00:00:12,12,00:00:26,0,276
2017-08-28-ccc_cty_online_script,2017/08/28,ccc_cty_online_script,0,0,00:00:00,0,00:00:00,0,0
2017-08-28-ccc_feedback_script,2017/08/28,ccc_feedback_script,0,0,00:00:00,0,00:00:00,0,0
2017-08-28-ccc_fpb_script,2017/08/28,ccc_fpb_script,2,2,00:00:03,3,00:00:04,0,6
2017-08-28-ccc_help_script,2017/08/28,ccc_help_script,12,12,00:00:08,8,00:00:24,0,96
2017-08-28-ccc_link_script,2017/08/28,ccc_link_script,0,0,00:00:00,0,00:00:00,0,0
2017-08-28-ccc_media_line_script,2017/08/28,ccc_media_line_script,2,2,00:00:18,18,00:00:31,0,36
2017-08-28-ccc_priority_script,2017/08/28,ccc_priority_script,41,41,00:00:15,15,00:02:34,0,615
2017-08-28-ccc_tax_script,2017/08/28,ccc_tax_script,17,15,00:01:37,97,00:07:04,2,1455
2017-08-28-ccc_waste_recycling_script,2017/08/28,ccc_waste_recycling_script,0,0,00:00:00,0,00:00:00,0,0
2017-08-29-ccc_311_calgary_script,2017/08/29,ccc_311_calgary_script,3959,3271,00:02:54,174,00:14:12,688,569154
2017-08-29-ccc_311_lobby_ph_script,2017/08/29,ccc_311_lobby_ph_script,1,1,00:00:04,4,00:00:04,0,4
2017-08-29-ccc_aserv_info_script,2017/08/29,ccc_aserv_info_script,0,0,00:00:00,0,00:00:00,0,0
2017-08-29-ccc_bylaw_script,2017/08/29,ccc_bylaw_script,0,0,00:00:00,0,00:00:00,0,0
2017-08-29-ccc_city_script,2017/08/29,ccc_city_script,17,14,00:00:29,29,00:01:45,3,406
2017-08-29-ccc_cty_online_script,2017/08/29,ccc_cty_online_script,0,0,00:00:00,0,00:00:00,0,0
2017-08-29-ccc_feedback_script,2017/08/29,ccc_feedback_script,0,0,00:00:00,0,00:00:00,0,0
2017-08-29-ccc_fpb_script,2017/08/29,ccc_fpb_script,2,1,00:00:58,58,00:00:58,1,58
2017-08-29-ccc_help_script,2017/08/29,ccc_help_script,14,12,00:00:18,18,00:00:51,2,216
2017-08-29-ccc_link_script,2017/08/29,ccc_link_script,0,0,00:00:00,0,00:00:00,0,0
2017-08-29-ccc_media_line_script,2017/08/29,ccc_media_line_script,0,0,00:00:00,0,00:00:00,0,0
2017-08-29-ccc_priority_script,2017/08/29,ccc_priority_script,23,23,00:00:07,7,00:00:25,0,161
2017-08-29-ccc_tax_script,2017/08/29,ccc_tax_script,30,26,00:02:59,179,00:06:06,4,4654
2017-08-29-ccc_waste_recycling_script,2017/08/29,ccc_waste_recycling_script,0,0,00:00:00,0,00:00:00,0,0
2017-08-30-ccc_311_calgary_script,2017/08/30,ccc_311_calgary_script,3969,3375,00:02:29,149,00:10:57,594,502875
2017-08-30-ccc_311_lobby_ph_script,2017/08/30,ccc_311_lobby_ph_script,1,0,00:00:00,0,00:00:00,1,0
2017-08-30-ccc_aserv_info_script,2017/08/30,ccc_aserv_info_script,0,0,00:00:00,0,00:00:00,0,0
2017-08-30-ccc_bylaw_script,2017/08/30,ccc_bylaw_script,0,0,00:00:00,0,00:00:00,0,0
2017-08-30-ccc_city_script,2017/08/30,ccc_city_script,8,8,00:01:20,80,00:04:06,0,640
2017-08-30-ccc_cty_online_script,2017/08/30,ccc_cty_online_script,0,0,00:00:00,0,00:00:00,0,0
2017-08-30-ccc_feedback_script,2017/08/30,ccc_feedback_script,0,0,00:00:00,0,00:00:00,0,0
2017-08-30-ccc_fpb_script,2017/08/30,ccc_fpb_script,1,1,00:02:55,175,00:02:55,0,175
2017-08-30-ccc_help_script,2017/08/30,ccc_help_script,16,15,00:00:13,13,00:00:37,1,195
2017-08-30-ccc_link_script,2017/08/30,ccc_link_script,0,0,00:00:00,0,00:00:00,0,0
2017-08-30-ccc_media_line_script,2017/08/30,ccc_media_line_script,4,3,00:00:51,51,00:01:38,1,153
2017-08-30-ccc_priority_script,2017/08/30,ccc_priority_script,26,26,00:00:12,12,00:00:44,0,312
2017-08-30-ccc_tax_script,2017/08/30,ccc_tax_script,27,24,00:01:56,116,00:05:09,3,2784
2017-08-30-ccc_waste_recycling_script,2017/08/30,ccc_waste_recycling_script,0,0,00:00:00,0,00:00:00,0,0
2017-08-31-ccc_311_calgary_script,2017/08/31,ccc_311_calgary_script,3740,3193,00:02:20,140,00:09:36,547,447020
2017-08-31-ccc_311_lobby_ph_script,2017/08/31,ccc_311_lobby_ph_script,2,2,00:00:10,10,00:00:13,0,20
2017-08-31-ccc_aserv_info_script,2017/08/31,ccc_aserv_info_script,0,0,00:00:00,0,00:00:00,0,0
2017-08-31-ccc_bylaw_script,2017/08/31,ccc_bylaw_script,0,0,00:00:00,0,00:00:00,0,0
2017-08-31-ccc_city_script,2017/08/31,ccc_city_script,13,13,00:00:12,12,00:00:25,0,156
2017-08-31-ccc_cty_online_script,2017/08/31,ccc_cty_online_script,0,0,00:00:00,0,00:00:00,0,0
2017-08-31-ccc_feedback_script,2017/08/31,ccc_feedback_script,0,0,00:00:00,0,00:00:00,0,0
2017-08-31-ccc_fpb_script,2017/08/31,ccc_fpb_script,4,2,00:00:03,3,00:00:04,2,6
2017-08-31-ccc_help_script,2017/08/31,ccc_help_script,14,14,00:00:17,17,00:00:38,0,238
2017-08-31-ccc_link_script,2017/08/31,ccc_link_script,0,0,00:00:00,0,00:00:00,0,0
2017-08-31-ccc_media_line_script,2017/08/31,ccc_media_line_script,2,2,00:00:07,7,00:00:07,0,14
2017-08-31-ccc_priority_script,2017/08/31,ccc_priority_script,35,33,00:00:14,14,00:01:00,2,462
2017-08-31-ccc_tax_script,2017/08/31,ccc_tax_script,27,25,00:01:56,116,00:04:46,2,2900
2017-08-31-ccc_waste_recycling_script,2017/08/31,ccc_waste_recycling_script,0,0,00:00:00,0,00:00:00,0,0
2017-09-01-ccc_311_calgary_script,2017/09/01,ccc_311_calgary_script,3208,2869,00:01:52,112,00:09:27,339,321328
2017-09-01-ccc_311_lobby_ph_script,2017/09/01,ccc_311_lobby_ph_script,2,1,00:00:16,16,00:00:16,1,16
2017-09-01-ccc_aserv_info_script,2017/09/01,ccc_aserv_info_script,0,0,00:00:00,0,00:00:00,0,0
2017-09-01-ccc_bylaw_script,2017/09/01,ccc_bylaw_script,0,0,00:00:00,0,00:00:00,0,0
2017-09-01-ccc_city_script,2017/09/01,ccc_city_script,31,24,00:00:17,17,00:00:58,7,408
2017-09-01-ccc_cty_online_script,2017/09/01,ccc_cty_online_script,0,0,00:00:00,0,00:00:00,0,0
2017-09-01-ccc_feedback_script,2017/09/01,ccc_feedback_script,0,0,00:00:00,0,00:00:00,0,0
2017-09-01-ccc_fpb_script,2017/09/01,ccc_fpb_script,5,4,00:00:27,27,00:01:37,1,108
2017-09-01-ccc_help_script,2017/09/01,ccc_help_script,7,6,00:00:08,8,00:00:25,1,48
2017-09-01-ccc_link_script,2017/09/01,ccc_link_script,0,0,00:00:00,0,00:00:00,0,0
2017-09-01-ccc_media_line_script,2017/09/01,ccc_media_line_script,2,2,00:00:05,5,00:00:06,0,10
2017-09-01-ccc_priority_script,2017/09/01,ccc_priority_script,27,27,00:00:08,8,00:00:53,0,216
2017-09-01-ccc_tax_script,2017/09/01,ccc_tax_script,23,19,00:01:20,80,00:06:59,4,1520
2017-09-01-ccc_waste_recycling_script,2017/09/01,ccc_waste_recycling_script,0,0,00:00:00,0,00:00:00,0,0
2017-09-02-ccc_311_calgary_script,2017/09/02,ccc_311_calgary_script,1398,1344,00:00:26,26,00:06:29,54,34944
2017-09-02-ccc_311_lobby_ph_script,2017/09/02,ccc_311_lobby_ph_script,0,0,00:00:00,0,00:00:00,0,0
2017-09-02-ccc_aserv_info_script,2017/09/02,ccc_aserv_info_script,0,0,00:00:00,0,00:00:00,0,0
2017-09-02-ccc_bylaw_script,2017/09/02,ccc_bylaw_script,0,0,00:00:00,0,00:00:00,0,0
2017-09-02-ccc_city_script,2017/09/02,ccc_city_script,0,0,00:00:00,0,00:00:00,0,0
2017-09-02-ccc_cty_online_script,2017/09/02,ccc_cty_online_script,0,0,00:00:00,0,00:00:00,0,0
2017-09-02-ccc_feedback_script,2017/09/02,ccc_feedback_script,0,0,00:00:00,0,00:00:00,0,0
2017-09-02-ccc_fpb_script,2017/09/02,ccc_fpb_script,1,1,00:00:09,9,00:00:09,0,9
2017-09-02-ccc_help_script,2017/09/02,ccc_help_script,1,1,00:00:04,4,00:00:04,0,4
2017-09-02-ccc_link_script,2017/09/02,ccc_link_script,0,0,00:00:00,0,00:00:00,0,0
2017-09-02-ccc_media_line_script,2017/09/02,ccc_media_line_script,1,1,00:00:05,5,00:00:05,0,5
2017-09-02-ccc_priority_script,2017/09/02,ccc_priority_script,23,22,00:00:05,5,00:00:16,1,110
2017-09-02-ccc_tax_script,2017/09/02,ccc_tax_script,1,1,00:00:02,2,00:00:02,0,2
2017-09-02-ccc_waste_recycling_script,2017/09/02,ccc_waste_recycling_script,0,0,00:00:00,0,00:00:00,0,0
2017-09-03-ccc_311_calgary_script,2017/09/03,ccc_311_calgary_script,1039,1021,00:00:15,15,00:06:19,18,15315
2017-09-03-ccc_311_lobby_ph_script,2017/09/03,ccc_311_lobby_ph_script,0,0,00:00:00,0,00:00:00,0,0
2017-09-03-ccc_aserv_info_script,2017/09/03,ccc_aserv_info_script,0,0,00:00:00,0,00:00:00,0,0
2017-09-03-ccc_bylaw_script,2017/09/03,ccc_bylaw_script,0,0,00:00:00,0,00:00:00,0,0
2017-09-03-ccc_city_script,2017/09/03,ccc_city_script,0,0,00:00:00,0,00:00:00,0,0
2017-09-03-ccc_cty_online_script,2017/09/03,ccc_cty_online_script,0,0,00:00:00,0,00:00:00,0,0
2017-09-03-ccc_feedback_script,2017/09/03,ccc_feedback_script,0,0,00:00:00,0,00:00:00,0,0
2017-09-03-ccc_fpb_script,2017/09/03,ccc_fpb_script,2,2,00:00:06,6,00:00:07,0,12
2017-09-03-ccc_help_script,2017/09/03,ccc_help_script,4,4,00:00:06,6,00:00:07,0,24
2017-09-03-ccc_link_script,2017/09/03,ccc_link_script,0,0,00:00:00,0,00:00:00,0,0
2017-09-03-ccc_media_line_script,2017/09/03,ccc_media_line_script,5,5,00:00:11,11,00:00:41,0,55
2017-09-03-ccc_priority_script,2017/09/03,ccc_priority_script,15,15,00:00:06,6,00:00:12,0,90
2017-09-03-ccc_tax_script,2017/09/03,ccc_tax_script,0,0,00:00:00,0,00:00:00,0,0
2017-09-03-ccc_waste_recycling_script,2017/09/03,ccc_waste_recycling_script,0,0,00:00:00,0,00:00:00,0,0
2017-09-04-ccc_311_calgary_script,2017/09/04,ccc_311_calgary_script,1301,1285,00:00:14,14,00:11:49,16,17990
2017-09-04-ccc_311_lobby_ph_script,2017/09/04,ccc_311_lobby_ph_script,0,0,00:00:00,0,00:00:00,0,0
2017-09-04-ccc_aserv_info_script,2017/09/04,ccc_aserv_info_script,0,0,00:00:00,0,00:00:00,0,0
2017-09-04-ccc_bylaw_script,2017/09/04,ccc_bylaw_script,0,0,00:00:00,0,00:00:00,0,0
2017-09-04-ccc_city_script,2017/09/04,ccc_city_script,0,0,00:00:00,0,00:00:00,0,0
2017-09-04-ccc_cty_online_script,2017/09/04,ccc_cty_online_script,0,0,00:00:00,0,00:00:00,0,0
2017-09-04-ccc_feedback_script,2017/09/04,ccc_feedback_script,0,0,00:00:00,0,00:00:00,0,0
2017-09-04-ccc_fpb_script,2017/09/04,ccc_fpb_script,1,1,00:00:15,15,00:00:15,0,15
2017-09-04-ccc_help_script,2017/09/04,ccc_help_script,8,8,00:00:09,9,00:00:19,0,72
2017-09-04-ccc_link_script,2017/09/04,ccc_link_script,0,0,00:00:00,0,00:00:00,0,0
2017-09-04-ccc_media_line_script,2017/09/04,ccc_media_line_script,1,1,00:00:35,35,00:00:35,0,35
2017-09-04-ccc_priority_script,2017/09/04,ccc_priority_script,16,15,00:00:06,6,00:00:10,1,90
2017-09-04-ccc_tax_script,2017/09/04,ccc_tax_script,0,0,00:00:00,0,00:00:00,0,0
2017-09-04-ccc_waste_recycling_script,2017/09/04,ccc_waste_recycling_script,0,0,00:00:00,0,00:00:00,0,0
2017-09-05-ccc_311_calgary_script,2017/09/05,ccc_311_calgary_script,4149,3780,00:01:18,78,00:11:05,369,294840
2017-09-05-ccc_311_lobby_ph_script,2017/09/05,ccc_311_lobby_ph_script,2,2,00:00:04,4,00:00:06,0,8
2017-09-05-ccc_aserv_info_script,2017/09/05,ccc_aserv_info_script,0,0,00:00:00,0,00:00:00,0,0
2017-09-05-ccc_bylaw_script,2017/09/05,ccc_bylaw_script,0,0,00:00:00,0,00:00:00,0,0
2017-09-05-ccc_city_script,2017/09/05,ccc_city_script,21,20,00:00:27,27,00:03:40,1,540
2017-09-05-ccc_cty_online_script,2017/09/05,ccc_cty_online_script,0,0,00:00:00,0,00:00:00,0,0
2017-09-05-ccc_feedback_script,2017/09/05,ccc_feedback_script,0,0,00:00:00,0,00:00:00,0,0
2017-09-05-ccc_fpb_script,2017/09/05,ccc_fpb_script,4,3,00:00:04,4,00:00:09,1,12
2017-09-05-ccc_help_script,2017/09/05,ccc_help_script,20,18,00:00:12,12,00:00:50,2,216
2017-09-05-ccc_link_script,2017/09/05,ccc_link_script,0,0,00:00:00,0,00:00:00,0,0
2017-09-05-ccc_media_line_script,2017/09/05,ccc_media_line_script,0,0,00:00:00,0,00:00:00,0,0
2017-09-05-ccc_priority_script,2017/09/05,ccc_priority_script,40,39,00:00:10,10,00:00:56,1,390
2017-09-05-ccc_tax_script,2017/09/05,ccc_tax_script,23,22,00:00:48,48,00:05:44,1,1056
2017-09-05-ccc_waste_recycling_script,2017/09/05,ccc_waste_recycling_script,0,0,00:00:00,0,00:00:00,0,0
2017-09-06-ccc_311_calgary_script,2017/09/06,ccc_311_calgary_script,4174,3115,00:04:45,285,00:17:58,1059,887775
2017-09-06-ccc_311_lobby_ph_script,2017/09/06,ccc_311_lobby_ph_script,4,3,00:00:07,7,00:00:10,1,21
2017-09-06-ccc_aserv_info_script,2017/09/06,ccc_aserv_info_script,0,0,00:00:00,0,00:00:00,0,0
2017-09-06-ccc_bylaw_script,2017/09/06,ccc_bylaw_script,0,0,00:00:00,0,00:00:00,0,0
2017-09-06-ccc_city_script,2017/09/06,ccc_city_script,5,5,00:00:20,20,00:00:44,0,100
2017-09-06-ccc_cty_online_script,2017/09/06,ccc_cty_online_script,0,0,00:00:00,0,00:00:00,0,0
2017-09-06-ccc_feedback_script,2017/09/06,ccc_feedback_script,0,0,00:00:00,0,00:00:00,0,0
2017-09-06-ccc_fpb_script,2017/09/06,ccc_fpb_script,5,3,00:04:38,278,00:06:06,2,834
2017-09-06-ccc_help_script,2017/09/06,ccc_help_script,33,29,00:00:18,18,00:01:10,4,522
2017-09-06-ccc_link_script,2017/09/06,ccc_link_script,0,0,00:00:00,0,00:00:00,0,0
2017-09-06-ccc_media_line_script,2017/09/06,ccc_media_line_script,0,0,00:00:00,0,00:00:00,0,0
2017-09-06-ccc_priority_script,2017/09/06,ccc_priority_script,30,30,00:00:14,14,00:01:06,0,420
2017-09-06-ccc_tax_script,2017/09/06,ccc_tax_script,29,19,00:04:21,261,00:09:03,10,4959
2017-09-06-ccc_waste_recycling_script,2017/09/06,ccc_waste_recycling_script,0,0,00:00:00,0,00:00:00,0,0
2017-09-07-ccc_311_calgary_script,2017/09/07,ccc_311_calgary_script,3782,3438,00:01:19,79,00:13:07,344,271602
2017-09-07-ccc_311_lobby_ph_script,2017/09/07,ccc_311_lobby_ph_script,4,4,00:00:11,11,00:00:15,0,44
2017-09-07-ccc_aserv_info_script,2017/09/07,ccc_aserv_info_script,0,0,00:00:00,0,00:00:00,0,0
2017-09-07-ccc_bylaw_script,2017/09/07,ccc_bylaw_script,0,0,00:00:00,0,00:00:00,0,0
2017-09-07-ccc_city_script,2017/09/07,ccc_city_script,12,11,00:00:13,13,00:00:21,1,143
2017-09-07-ccc_cty_online_script,2017/09/07,ccc_cty_online_script,0,0,00:00:00,0,00:00:00,0,0
2017-09-07-ccc_feedback_script,2017/09/07,ccc_feedback_script,0,0,00:00:00,0,00:00:00,0,0
2017-09-07-ccc_fpb_script,2017/09/07,ccc_fpb_script,3,3,00:01:03,63,00:02:54,0,189
2017-09-07-ccc_help_script,2017/09/07,ccc_help_script,17,16,00:00:15,15,00:01:10,1,240
2017-09-07-ccc_link_script,2017/09/07,ccc_link_script,0,0,00:00:00,0,00:00:00,0,0
2017-09-07-ccc_media_line_script,2017/09/07,ccc_media_line_script,0,0,00:00:00,0,00:00:00,0,0
2017-09-07-ccc_priority_script,2017/09/07,ccc_priority_script,32,32,00:00:09,9,00:00:42,0,288
2017-09-07-ccc_tax_script,2017/09/07,ccc_tax_script,29,28,00:01:25,85,00:04:37,1,2380
2017-09-07-ccc_waste_recycling_script,2017/09/07,ccc_waste_recycling_script,0,0,00:00:00,0,00:00:00,0,0
2017-09-08-ccc_311_calgary_script,2017/09/08,ccc_311_calgary_script,3601,2973,00:02:04,124,00:14:59,628,368652
2017-09-08-ccc_311_lobby_ph_script,2017/09/08,ccc_311_lobby_ph_script,1,1,00:00:12,12,00:00:12,0,12
2017-09-08-ccc_aserv_info_script,2017/09/08,ccc_aserv_info_script,0,0,00:00:00,0,00:00:00,0,0
2017-09-08-ccc_bylaw_script,2017/09/08,ccc_bylaw_script,0,0,00:00:00,0,00:00:00,0,0
2017-09-08-ccc_city_script,2017/09/08,ccc_city_script,21,21,00:00:33,33,00:02:39,0,693
2017-09-08-ccc_cty_online_script,2017/09/08,ccc_cty_online_script,0,0,00:00:00,0,00:00:00,0,0
2017-09-08-ccc_feedback_script,2017/09/08,ccc_feedback_script,0,0,00:00:00,0,00:00:00,0,0
2017-09-08-ccc_fpb_script,2017/09/08,ccc_fpb_script,2,2,00:03:24,204,00:06:38,0,408
2017-09-08-ccc_help_script,2017/09/08,ccc_help_script,9,7,00:00:16,16,00:00:41,2,112
2017-09-08-ccc_link_script,2017/09/08,ccc_link_script,0,0,00:00:00,0,00:00:00,0,0
2017-09-08-ccc_media_line_script,2017/09/08,ccc_media_line_script,0,0,00:00:00,0,00:00:00,0,0
2017-09-08-ccc_priority_script,2017/09/08,ccc_priority_script,28,28,00:00:11,11,00:01:08,0,308
2017-09-08-ccc_tax_script,2017/09/08,ccc_tax_script,21,19,00:02:17,137,00:04:20,2,2603
2017-09-08-ccc_waste_recycling_script,2017/09/08,ccc_waste_recycling_script,0,0,00:00:00,0,00:00:00,0,0
2017-09-09-ccc_311_calgary_script,2017/09/09,ccc_311_calgary_script,1443,1392,00:00:26,26,00:05:53,51,36192
2017-09-09-ccc_311_lobby_ph_script,2017/09/09,ccc_311_lobby_ph_script,0,0,00:00:00,0,00:00:00,0,0
2017-09-09-ccc_aserv_info_script,2017/09/09,ccc_aserv_info_script,0,0,00:00:00,0,00:00:00,0,0
2017-09-09-ccc_bylaw_script,2017/09/09,ccc_bylaw_script,0,0,00:00:00,0,00:00:00,0,0
2017-09-09-ccc_city_script,2017/09/09,ccc_city_script,0,0,00:00:00,0,00:00:00,0,0
2017-09-09-ccc_cty_online_script,2017/09/09,ccc_cty_online_script,0,0,00:00:00,0,00:00:00,0,0
2017-09-09-ccc_feedback_script,2017/09/09,ccc_feedback_script,0,0,00:00:00,0,00:00:00,0,0
2017-09-09-ccc_fpb_script,2017/09/09,ccc_fpb_script,3,2,00:00:03,3,00:00:05,1,6
2017-09-09-ccc_help_script,2017/09/09,ccc_help_script,8,8,00:00:17,17,00:01:28,0,136
2017-09-09-ccc_link_script,2017/09/09,ccc_link_script,0,0,00:00:00,0,00:00:00,0,0
2017-09-09-ccc_media_line_script,2017/09/09,ccc_media_line_script,0,0,00:00:00,0,00:00:00,0,0
2017-09-09-ccc_priority_script,2017/09/09,ccc_priority_script,24,24,00:00:06,6,00:00:30,0,144
2017-09-09-ccc_tax_script,2017/09/09,ccc_tax_script,1,1,00:00:06,6,00:00:06,0,6
2017-09-09-ccc_waste_recycling_script,2017/09/09,ccc_waste_recycling_script,0,0,00:00:00,0,00:00:00,0,0
2017-09-10-ccc_311_calgary_script,2017/09/10,ccc_311_calgary_script,1099,1072,00:00:27,27,00:09:26,27,28944
2017-09-10-ccc_311_lobby_ph_script,2017/09/10,ccc_311_lobby_ph_script,0,0,00:00:00,0,00:00:00,0,0
2017-09-10-ccc_aserv_info_script,2017/09/10,ccc_aserv_info_script,0,0,00:00:00,0,00:00:00,0,0
2017-09-10-ccc_bylaw_script,2017/09/10,ccc_bylaw_script,0,0,00:00:00,0,00:00:00,0,0
2017-09-10-ccc_city_script,2017/09/10,ccc_city_script,0,0,00:00:00,0,00:00:00,0,0
2017-09-10-ccc_cty_online_script,2017/09/10,ccc_cty_online_script,0,0,00:00:00,0,00:00:00,0,0
2017-09-10-ccc_feedback_script,2017/09/10,ccc_feedback_script,0,0,00:00:00,0,00:00:00,0,0
2017-09-10-ccc_fpb_script,2017/09/10,ccc_fpb_script,1,1,00:00:09,9,00:00:09,0,9
2017-09-10-ccc_help_script,2017/09/10,ccc_help_script,8,8,00:00:08,8,00:00:35,0,64
2017-09-10-ccc_link_script,2017/09/10,ccc_link_script,0,0,00:00:00,0,00:00:00,0,0
2017-09-10-ccc_media_line_script,2017/09/10,ccc_media_line_script,1,1,00:00:04,4,00:00:04,0,4
2017-09-10-ccc_priority_script,2017/09/10,ccc_priority_script,19,18,00:00:16,16,00:01:43,1,288
2017-09-10-ccc_tax_script,2017/09/10,ccc_tax_script,2,1,00:00:07,7,00:00:07,1,7
2017-09-10-ccc_waste_recycling_script,2017/09/10,ccc_waste_recycling_script,0,0,00:00:00,0,00:00:00,0,0
2017-09-11-ccc_311_calgary_script,2017/09/11,ccc_311_calgary_script,3590,3305,00:01:17,77,00:06:56,285,254485
2017-09-11-ccc_311_lobby_ph_script,2017/09/11,ccc_311_lobby_ph_script,0,0,00:00:00,0,00:00:00,0,0
2017-09-11-ccc_aserv_info_script,2017/09/11,ccc_aserv_info_script,0,0,00:00:00,0,00:00:00,0,0
2017-09-11-ccc_bylaw_script,2017/09/11,ccc_bylaw_script,0,0,00:00:00,0,00:00:00,0,0
2017-09-11-ccc_city_script,2017/09/11,ccc_city_script,37,36,00:00:35,35,00:04:06,1,1260
2017-09-11-ccc_cty_online_script,2017/09/11,ccc_cty_online_script,0,0,00:00:00,0,00:00:00,0,0
2017-09-11-ccc_feedback_script,2017/09/11,ccc_feedback_script,0,0,00:00:00,0,00:00:00,0,0
2017-09-11-ccc_fpb_script,2017/09/11,ccc_fpb_script,3,2,00:02:14,134,00:04:21,1,268
2017-09-11-ccc_help_script,2017/09/11,ccc_help_script,21,18,00:00:07,7,00:00:13,3,126
2017-09-11-ccc_link_script,2017/09/11,ccc_link_script,0,0,00:00:00,0,00:00:00,0,0
2017-09-11-ccc_media_line_script,2017/09/11,ccc_media_line_script,1,1,00:00:41,41,00:00:41,0,41
2017-09-11-ccc_priority_script,2017/09/11,ccc_priority_script,35,35,00:00:11,11,00:02:01,0,385
2017-09-11-ccc_tax_script,2017/09/11,ccc_tax_script,19,17,00:01:26,86,00:03:41,2,1462
2017-09-11-ccc_waste_recycling_script,2017/09/11,ccc_waste_recycling_script,0,0,00:00:00,0,00:00:00,0,0
2017-09-12-ccc_311_calgary_script,2017/09/12,ccc_311_calgary_script,3575,2996,00:02:37,157,00:14:34,579,470372
2017-09-12-ccc_311_lobby_ph_script,2017/09/12,ccc_311_lobby_ph_script,4,4,00:00:07,7,00:00:11,0,28
2017-09-12-ccc_aserv_info_script,2017/09/12,ccc_aserv_info_script,0,0,00:00:00,0,00:00:00,0,0
2017-09-12-ccc_bylaw_script,2017/09/12,ccc_bylaw_script,0,0,00:00:00,0,00:00:00,0,0
2017-09-12-ccc_city_script,2017/09/12,ccc_city_script,18,17,00:00:24,24,00:01:44,1,408
2017-09-12-ccc_cty_online_script,2017/09/12,ccc_cty_online_script,0,0,00:00:00,0,00:00:00,0,0
2017-09-12-ccc_feedback_script,2017/09/12,ccc_feedback_script,0,0,00:00:00,0,00:00:00,0,0
2017-09-12-ccc_fpb_script,2017/09/12,ccc_fpb_script,3,0,00:00:00,0,00:00:00,3,0
2017-09-12-ccc_help_script,2017/09/12,ccc_help_script,10,7,00:00:11,11,00:00:21,3,77
2017-09-12-ccc_link_script,2017/09/12,ccc_link_script,0,0,00:00:00,0,00:00:00,0,0
2017-09-12-ccc_media_line_script,2017/09/12,ccc_media_line_script,0,0,00:00:00,0,00:00:00,0,0
2017-09-12-ccc_priority_script,2017/09/12,ccc_priority_script,36,36,00:00:16,16,00:02:06,0,576
2017-09-12-ccc_tax_script,2017/09/12,ccc_tax_script,20,16,00:03:00,180,00:07:20,4,2880
2017-09-12-ccc_waste_recycling_script,2017/09/12,ccc_waste_recycling_script,0,0,00:00:00,0,00:00:00,0,0
2017-09-13-ccc_311_calgary_script,2017/09/13,ccc_311_calgary_script,3218,3084,00:00:37,37,00:07:05,134,114108
2017-09-13-ccc_311_lobby_ph_script,2017/09/13,ccc_311_lobby_ph_script,1,1,00:00:04,4,00:00:04,0,4
2017-09-13-ccc_aserv_info_script,2017/09/13,ccc_aserv_info_script,0,0,00:00:00,0,00:00:00,0,0
2017-09-13-ccc_bylaw_script,2017/09/13,ccc_bylaw_script,0,0,00:00:00,0,00:00:00,0,0
2017-09-13-ccc_city_script,2017/09/13,ccc_city_script,22,22,00:00:14,14,00:00:34,0,308
2017-09-13-ccc_cty_online_script,2017/09/13,ccc_cty_online_script,0,0,00:00:00,0,00:00:00,0,0
2017-09-13-ccc_feedback_script,2017/09/13,ccc_feedback_script,0,0,00:00:00,0,00:00:00,0,0
2017-09-13-ccc_fpb_script,2017/09/13,ccc_fpb_script,3,2,00:00:05,5,00:00:06,1,10
2017-09-14-ccc_311_calgary_script,2017/09/14,ccc_311_calgary_script,3315,3155,00:00:40,40,00:07:56,160,126200
2017-09-14-ccc_311_lobby_ph_script,2017/09/14,ccc_311_lobby_ph_script,3,3,00:00:18,18,00:00:21,0,54
2017-09-14-ccc_aserv_info_script,2017/09/14,ccc_aserv_info_script,0,0,00:00:00,0,00:00:00,0,0
2017-09-14-ccc_bylaw_script,2017/09/14,ccc_bylaw_script,0,0,00:00:00,0,00:00:00,0,0
2017-09-14-ccc_city_script,2017/09/14,ccc_city_script,19,19,00:00:24,24,00:02:18,0,456
2017-09-14-ccc_cty_online_script,2017/09/14,ccc_cty_online_script,0,0,00:00:00,0,00:00:00,0,0
2017-09-14-ccc_feedback_script,2017/09/14,ccc_feedback_script,0,0,00:00:00,0,00:00:00,0,0
2017-09-14-ccc_fpb_script,2017/09/14,ccc_fpb_script,8,7,00:01:16,76,00:04:47,1,532
2017-09-14-ccc_help_script,2017/09/14,ccc_help_script,13,12,00:00:07,7,00:00:15,1,84
2017-09-14-ccc_link_script,2017/09/14,ccc_link_script,0,0,00:00:00,0,00:00:00,0,0
2017-09-14-ccc_media_line_script,2017/09/14,ccc_media_line_script,0,0,00:00:00,0,00:00:00,0,0
2017-09-14-ccc_priority_script,2017/09/14,ccc_priority_script,32,32,00:00:13,13,00:02:50,0,416
2017-09-14-ccc_tax_script,2017/09/14,ccc_tax_script,22,19,00:00:23,23,00:01:11,3,437
2017-09-13-ccc_help_script,2017/09/13,ccc_help_script,9,9,00:00:18,18,00:02:03,0,162
2017-09-13-ccc_link_script,2017/09/13,ccc_link_script,0,0,00:00:00,0,00:00:00,0,0
2017-09-13-ccc_media_line_script,2017/09/13,ccc_media_line_script,0,0,00:00:00,0,00:00:00,0,0
2017-09-13-ccc_priority_script,2017/09/13,ccc_priority_script,14,14,00:00:05,5,00:00:09,0,70
2017-09-13-ccc_tax_script,2017/09/13,ccc_tax_script,19,19,00:00:55,55,00:05:39,0,1045
2017-09-13-ccc_waste_recycling_script,2017/09/13,ccc_waste_recycling_script,0,0,00:00:00,0,00:00:00,0,0
2017-09-14-ccc_waste_recycling_script,2017/09/14,ccc_waste_recycling_script,0,0,00:00:00,0,00:00:00,0,0
2017-09-15-ccc_311_calgary_script,2017/09/15,ccc_311_calgary_script,3095,2874,00:01:02,62,00:05:36,221,178188
2017-09-15-ccc_311_lobby_ph_script,2017/09/15,ccc_311_lobby_ph_script,2,2,00:00:07,7,00:00:09,0,14
2017-09-15-ccc_aserv_info_script,2017/09/15,ccc_aserv_info_script,0,0,00:00:00,0,00:00:00,0,0
2017-09-15-ccc_bylaw_script,2017/09/15,ccc_bylaw_script,0,0,00:00:00,0,00:00:00,0,0
2017-09-15-ccc_city_script,2017/09/15,ccc_city_script,27,26,00:00:28,28,00:02:54,1,728
2017-09-15-ccc_cty_online_script,2017/09/15,ccc_cty_online_script,0,0,00:00:00,0,00:00:00,0,0
2017-09-15-ccc_feedback_script,2017/09/15,ccc_feedback_script,0,0,00:00:00,0,00:00:00,0,0
2017-09-15-ccc_fpb_script,2017/09/15,ccc_fpb_script,2,2,00:00:05,5,00:00:05,0,10
2017-09-15-ccc_help_script,2017/09/15,ccc_help_script,27,23,00:00:15,15,00:01:09,4,345
2017-09-15-ccc_link_script,2017/09/15,ccc_link_script,0,0,00:00:00,0,00:00:00,0,0
2017-09-15-ccc_media_line_script,2017/09/15,ccc_media_line_script,0,0,00:00:00,0,00:00:00,0,0
2017-09-15-ccc_priority_script,2017/09/15,ccc_priority_script,22,22,00:00:15,15,00:03:08,0,330
2017-09-15-ccc_tax_script,2017/09/15,ccc_tax_script,24,23,00:01:39,99,00:04:05,1,2277
2017-09-15-ccc_waste_recycling_script,2017/09/15,ccc_waste_recycling_script,0,0,00:00:00,0,00:00:00,0,0
2017-09-16-ccc_311_calgary_script,2017/09/16,ccc_311_calgary_script,1294,1256,00:00:21,21,00:04:10,38,26376
2017-09-16-ccc_311_lobby_ph_script,2017/09/16,ccc_311_lobby_ph_script,0,0,00:00:00,0,00:00:00,0,0
2017-09-16-ccc_aserv_info_script,2017/09/16,ccc_aserv_info_script,0,0,00:00:00,0,00:00:00,0,0
2017-09-16-ccc_bylaw_script,2017/09/16,ccc_bylaw_script,0,0,00:00:00,0,00:00:00,0,0
2017-09-16-ccc_city_script,2017/09/16,ccc_city_script,0,0,00:00:00,0,00:00:00,0,0
2017-09-16-ccc_cty_online_script,2017/09/16,ccc_cty_online_script,0,0,00:00:00,0,00:00:00,0,0
2017-09-16-ccc_feedback_script,2017/09/16,ccc_feedback_script,0,0,00:00:00,0,00:00:00,0,0
2017-09-16-ccc_fpb_script,2017/09/16,ccc_fpb_script,6,6,00:00:08,8,00:00:13,0,48
2017-09-16-ccc_help_script,2017/09/16,ccc_help_script,9,8,00:00:24,24,00:01:17,1,192
2017-09-16-ccc_link_script,2017/09/16,ccc_link_script,0,0,00:00:00,0,00:00:00,0,0
2017-09-16-ccc_media_line_script,2017/09/16,ccc_media_line_script,0,0,00:00:00,0,00:00:00,0,0
2017-09-16-ccc_priority_script,2017/09/16,ccc_priority_script,18,18,00:00:06,6,00:00:19,0,108
2017-09-16-ccc_tax_script,2017/09/16,ccc_tax_script,0,0,00:00:00,0,00:00:00,0,0
2017-09-16-ccc_waste_recycling_script,2017/09/16,ccc_waste_recycling_script,0,0,00:00:00,0,00:00:00,0,0
2017-09-17-ccc_311_calgary_script,2017/09/17,ccc_311_calgary_script,985,946,00:00:25,25,00:04:13,39,23650
2017-09-17-ccc_311_lobby_ph_script,2017/09/17,ccc_311_lobby_ph_script,0,0,00:00:00,0,00:00:00,0,0
2017-09-17-ccc_aserv_info_script,2017/09/17,ccc_aserv_info_script,0,0,00:00:00,0,00:00:00,0,0
2017-09-17-ccc_bylaw_script,2017/09/17,ccc_bylaw_script,0,0,00:00:00,0,00:00:00,0,0
2017-09-17-ccc_city_script,2017/09/17,ccc_city_script,0,0,00:00:00,0,00:00:00,0,0
2017-09-17-ccc_cty_online_script,2017/09/17,ccc_cty_online_script,0,0,00:00:00,0,00:00:00,0,0
2017-09-17-ccc_feedback_script,2017/09/17,ccc_feedback_script,0,0,00:00:00,0,00:00:00,0,0
2017-09-17-ccc_fpb_script,2017/09/17,ccc_fpb_script,1,1,00:00:25,25,00:00:25,0,25
2017-09-17-ccc_help_script,2017/09/17,ccc_help_script,6,4,00:00:24,24,00:01:28,2,96
2017-09-17-ccc_link_script,2017/09/17,ccc_link_script,0,0,00:00:00,0,00:00:00,0,0
2017-09-17-ccc_media_line_script,2017/09/17,ccc_media_line_script,0,0,00:00:00,0,00:00:00,0,0
2017-09-17-ccc_priority_script,2017/09/17,ccc_priority_script,33,32,00:00:05,5,00:00:16,1,160
2017-09-17-ccc_tax_script,2017/09/17,ccc_tax_script,0,0,00:00:00,0,00:00:00,0,0
2017-09-17-ccc_waste_recycling_script,2017/09/17,ccc_waste_recycling_script,0,0,00:00:00,0,00:00:00,0,0
2017-09-18-ccc_311_calgary_script,2017/09/18,ccc_311_calgary_script,3411,3222,00:01:06,66,00:06:05,189,212652
2017-09-18-ccc_311_lobby_ph_script,2017/09/18,ccc_311_lobby_ph_script,2,2,00:00:13,13,00:00:15,0,26
2017-09-18-ccc_aserv_info_script,2017/09/18,ccc_aserv_info_script,0,0,00:00:00,0,00:00:00,0,0
2017-09-18-ccc_bylaw_script,2017/09/18,ccc_bylaw_script,0,0,00:00:00,0,00:00:00,0,0
2017-09-18-ccc_city_script,2017/09/18,ccc_city_script,14,14,00:00:13,13,00:00:36,0,182
2017-09-18-ccc_cty_online_script,2017/09/18,ccc_cty_online_script,0,0,00:00:00,0,00:00:00,0,0
2017-09-18-ccc_feedback_script,2017/09/18,ccc_feedback_script,1,0,00:00:00,0,00:00:00,1,0
2017-09-18-ccc_fpb_script,2017/09/18,ccc_fpb_script,11,10,00:00:34,34,00:02:12,1,340
2017-09-18-ccc_help_script,2017/09/18,ccc_help_script,13,13,00:00:11,11,00:00:38,0,143
2017-09-18-ccc_link_script,2017/09/18,ccc_link_script,0,0,00:00:00,0,00:00:00,0,0
2017-09-18-ccc_media_line_script,2017/09/18,ccc_media_line_script,0,0,00:00:00,0,00:00:00,0,0
2017-09-18-ccc_priority_script,2017/09/18,ccc_priority_script,27,27,00:00:07,7,00:00:23,0,189
2017-09-18-ccc_tax_script,2017/09/18,ccc_tax_script,20,19,00:01:31,91,00:05:17,1,1729
2017-09-18-ccc_waste_recycling_script,2017/09/18,ccc_waste_recycling_script,0,0,00:00:00,0,00:00:00,0,0
2017-09-20-ccc_311_calgary_script,2017/09/20,ccc_311_calgary_script,3085,2935,00:00:47,47,00:08:04,150,137945
2017-09-20-ccc_311_lobby_ph_script,2017/09/20,ccc_311_lobby_ph_script,1,1,00:00:07,7,00:00:07,0,7
2017-09-20-ccc_aserv_info_script,2017/09/20,ccc_aserv_info_script,0,0,00:00:00,0,00:00:00,0,0
2017-09-20-ccc_bylaw_script,2017/09/20,ccc_bylaw_script,0,0,00:00:00,0,00:00:00,0,0
2017-09-20-ccc_city_script,2017/09/20,ccc_city_script,9,9,00:00:10,10,00:00:19,0,90
2017-09-20-ccc_cty_online_script,2017/09/20,ccc_cty_online_script,0,0,00:00:00,0,00:00:00,0,0
2017-09-20-ccc_feedback_script,2017/09/20,ccc_feedback_script,0,0,00:00:00,0,00:00:00,0,0
2017-09-20-ccc_fpb_script,2017/09/20,ccc_fpb_script,3,3,00:00:06,6,00:00:07,0,18
2017-09-20-ccc_help_script,2017/09/20,ccc_help_script,17,16,00:00:06,6,00:00:13,1,96
2017-09-20-ccc_link_script,2017/09/20,ccc_link_script,0,0,00:00:00,0,00:00:00,0,0
2017-09-20-ccc_media_line_script,2017/09/20,ccc_media_line_script,0,0,00:00:00,0,00:00:00,0,0
2017-09-20-ccc_priority_script,2017/09/20,ccc_priority_script,30,30,00:00:08,8,00:00:42,0,240
2017-09-20-ccc_tax_script,2017/09/20,ccc_tax_script,24,24,00:00:58,58,00:04:35,0,1392
2017-09-20-ccc_waste_recycling_script,2017/09/20,ccc_waste_recycling_script,0,0,00:00:00,0,00:00:00,0,0
2017-09-21-ccc_help_script,2017/09/21,ccc_help_script,15,14,00:00:09,9,00:00:39,1,126
2017-09-21-ccc_link_script,2017/09/21,ccc_link_script,0,0,00:00:00,0,00:00:00,0,0
2017-09-21-ccc_media_line_script,2017/09/21,ccc_media_line_script,0,0,00:00:00,0,00:00:00,0,0
2017-09-21-ccc_priority_script,2017/09/21,ccc_priority_script,21,20,00:00:10,10,00:00:31,1,200
2017-09-21-ccc_tax_script,2017/09/21,ccc_tax_script,28,24,00:00:36,36,00:03:29,4,864
2017-09-21-ccc_waste_recycling_script,2017/09/21,ccc_waste_recycling_script,0,0,00:00:00,0,00:00:00,0,0
2017-09-21-ccc_311_calgary_script,2017/09/21,ccc_311_calgary_script,2877,2762,00:00:31,31,00:04:07,115,85622
2017-09-21-ccc_311_lobby_ph_script,2017/09/21,ccc_311_lobby_ph_script,0,0,00:00:00,0,00:00:00,0,0
2017-09-21-ccc_aserv_info_script,2017/09/21,ccc_aserv_info_script,0,0,00:00:00,0,00:00:00,0,0
2017-09-21-ccc_bylaw_script,2017/09/21,ccc_bylaw_script,0,0,00:00:00,0,00:00:00,0,0
2017-09-21-ccc_city_script,2017/09/21,ccc_city_script,9,9,00:00:13,13,00:00:31,0,117
2017-09-21-ccc_cty_online_script,2017/09/21,ccc_cty_online_script,0,0,00:00:00,0,00:00:00,0,0
2017-09-21-ccc_feedback_script,2017/09/21,ccc_feedback_script,0,0,00:00:00,0,00:00:00,0,0
2017-09-21-ccc_fpb_script,2017/09/21,ccc_fpb_script,7,6,00:00:17,17,00:00:40,1,102
2017-09-22-ccc_311_calgary_script,2017/09/22,ccc_311_calgary_script,2759,2673,00:00:30,30,00:07:08,86,80190
2017-09-22-ccc_311_lobby_ph_script,2017/09/22,ccc_311_lobby_ph_script,1,1,00:00:03,3,00:00:03,0,3
2017-09-22-ccc_aserv_info_script,2017/09/22,ccc_aserv_info_script,0,0,00:00:00,0,00:00:00,0,0
2017-09-22-ccc_bylaw_script,2017/09/22,ccc_bylaw_script,0,0,00:00:00,0,00:00:00,0,0
2017-09-22-ccc_city_script,2017/09/22,ccc_city_script,11,11,00:00:12,12,00:00:19,0,132
2017-09-22-ccc_cty_online_script,2017/09/22,ccc_cty_online_script,0,0,00:00:00,0,00:00:00,0,0
2017-09-22-ccc_feedback_script,2017/09/22,ccc_feedback_script,0,0,00:00:00,0,00:00:00,0,0
2017-09-22-ccc_fpb_script,2017/09/22,ccc_fpb_script,4,4,00:00:56,56,00:02:56,0,224
2017-09-22-ccc_help_script,2017/09/22,ccc_help_script,9,9,00:00:07,7,00:00:23,0,63
2017-09-22-ccc_link_script,2017/09/22,ccc_link_script,0,0,00:00:00,0,00:00:00,0,0
2017-09-22-ccc_media_line_script,2017/09/22,ccc_media_line_script,0,0,00:00:00,0,00:00:00,0,0
2017-09-22-ccc_priority_script,2017/09/22,ccc_priority_script,22,21,00:00:06,6,00:00:14,1,126
2017-09-22-ccc_tax_script,2017/09/22,ccc_tax_script,19,17,00:00:42,42,00:03:08,2,714
2017-09-22-ccc_waste_recycling_script,2017/09/22,ccc_waste_recycling_script,0,0,00:00:00,0,00:00:00,0,0
2017-09-23-ccc_311_lobby_ph_script,2017/09/23,ccc_311_lobby_ph_script,0,0,00:00:00,0,00:00:00,0,0
2017-09-23-ccc_waste_recycling_script,2017/09/23,ccc_waste_recycling_script,0,0,00:00:00,0,00:00:00,0,0
2017-09-23-ccc_311_calgary_script,2017/09/23,ccc_311_calgary_script,1146,1097,00:00:26,26,00:05:45,49,28522
2017-09-23-ccc_aserv_info_script,2017/09/23,ccc_aserv_info_script,0,0,00:00:00,0,00:00:00,0,0
2017-09-23-ccc_bylaw_script,2017/09/23,ccc_bylaw_script,0,0,00:00:00,0,00:00:00,0,0
2017-09-23-ccc_city_script,2017/09/23,ccc_city_script,0,0,00:00:00,0,00:00:00,0,0
2017-09-23-ccc_cty_online_script,2017/09/23,ccc_cty_online_script,0,0,00:00:00,0,00:00:00,0,0
2017-09-23-ccc_feedback_script,2017/09/23,ccc_feedback_script,0,0,00:00:00,0,00:00:00,0,0
2017-09-23-ccc_fpb_script,2017/09/23,ccc_fpb_script,0,0,00:00:00,0,00:00:00,0,0
2017-09-23-ccc_help_script,2017/09/23,ccc_help_script,5,4,00:00:07,7,00:00:11,1,28
2017-09-23-ccc_link_script,2017/09/23,ccc_link_script,0,0,00:00:00,0,00:00:00,0,0
2017-09-23-ccc_media_line_script,2017/09/23,ccc_media_line_script,0,0,00:00:00,0,00:00:00,0,0
2017-09-23-ccc_priority_script,2017/09/23,ccc_priority_script,16,16,00:00:04,4,00:00:10,0,64
2017-09-23-ccc_tax_script,2017/09/23,ccc_tax_script,3,3,00:00:54,54,00:02:30,0,162
2017-09-24-ccc_311_calgary_script,2017/09/24,ccc_311_calgary_script,968,951,00:00:17,17,00:06:37,17,16167
2017-09-24-ccc_311_lobby_ph_script,2017/09/24,ccc_311_lobby_ph_script,0,0,00:00:00,0,00:00:00,0,0
2017-09-24-ccc_aserv_info_script,2017/09/24,ccc_aserv_info_script,0,0,00:00:00,0,00:00:00,0,0
2017-09-24-ccc_bylaw_script,2017/09/24,ccc_bylaw_script,0,0,00:00:00,0,00:00:00,0,0
2017-09-24-ccc_city_script,2017/09/24,ccc_city_script,0,0,00:00:00,0,00:00:00,0,0
2017-09-24-ccc_cty_online_script,2017/09/24,ccc_cty_online_script,0,0,00:00:00,0,00:00:00,0,0
2017-09-24-ccc_feedback_script,2017/09/24,ccc_feedback_script,0,0,00:00:00,0,00:00:00,0,0
2017-09-24-ccc_fpb_script,2017/09/24,ccc_fpb_script,0,0,00:00:00,0,00:00:00,0,0
2017-09-24-ccc_help_script,2017/09/24,ccc_help_script,4,4,00:00:21,21,00:00:43,0,84
2017-09-24-ccc_link_script,2017/09/24,ccc_link_script,0,0,00:00:00,0,00:00:00,0,0
2017-09-26-ccc_bylaw_script,2017/09/26,ccc_bylaw_script,0,0,00:00:00,0,00:00:00,0,0
2017-09-24-ccc_media_line_script,2017/09/24,ccc_media_line_script,0,0,00:00:00,0,00:00:00,0,0
2017-09-24-ccc_priority_script,2017/09/24,ccc_priority_script,18,18,00:00:06,6,00:00:23,0,108
2017-09-24-ccc_tax_script,2017/09/24,ccc_tax_script,0,0,00:00:00,0,00:00:00,0,0
2017-09-24-ccc_waste_recycling_script,2017/09/24,ccc_waste_recycling_script,0,0,00:00:00,0,00:00:00,0,0
2017-09-25-ccc_311_calgary_script,2017/09/25,ccc_311_calgary_script,3435,3239,00:00:55,55,00:05:10,196,178145
2017-09-25-ccc_311_lobby_ph_script,2017/09/25,ccc_311_lobby_ph_script,3,2,00:00:06,6,00:00:06,1,12
2017-09-25-ccc_aserv_info_script,2017/09/25,ccc_aserv_info_script,0,0,00:00:00,0,00:00:00,0,0
2017-09-25-ccc_bylaw_script,2017/09/25,ccc_bylaw_script,0,0,00:00:00,0,00:00:00,0,0
2017-09-25-ccc_city_script,2017/09/25,ccc_city_script,25,25,00:00:35,35,00:03:34,0,875
2017-09-25-ccc_cty_online_script,2017/09/25,ccc_cty_online_script,0,0,00:00:00,0,00:00:00,0,0
2017-09-25-ccc_feedback_script,2017/09/25,ccc_feedback_script,0,0,00:00:00,0,00:00:00,0,0
2017-09-25-ccc_fpb_script,2017/09/25,ccc_fpb_script,4,4,00:01:12,72,00:01:39,0,288
2017-09-25-ccc_help_script,2017/09/25,ccc_help_script,12,10,00:00:07,7,00:00:17,2,70
2017-09-25-ccc_link_script,2017/09/25,ccc_link_script,0,0,00:00:00,0,00:00:00,0,0
2017-09-25-ccc_media_line_script,2017/09/25,ccc_media_line_script,1,1,00:01:34,94,00:01:34,0,94
2017-09-25-ccc_priority_script,2017/09/25,ccc_priority_script,36,36,00:00:10,10,00:02:16,0,360
2017-09-25-ccc_tax_script,2017/09/25,ccc_tax_script,26,25,00:01:11,71,00:04:27,1,1775
2017-09-25-ccc_waste_recycling_script,2017/09/25,ccc_waste_recycling_script,0,0,00:00:00,0,00:00:00,0,0
2017-09-26-ccc_waste_recycling_script,2017/09/26,ccc_waste_recycling_script,0,0,00:00:00,0,00:00:00,0,0
2017-09-26-ccc_311_calgary_script,2017/09/26,ccc_311_calgary_script,3383,3257,00:00:32,32,00:04:51,126,104224
2017-09-26-ccc_311_lobby_ph_script,2017/09/26,ccc_311_lobby_ph_script,0,0,00:00:00,0,00:00:00,0,0
2017-09-26-ccc_aserv_info_script,2017/09/26,ccc_aserv_info_script,0,0,00:00:00,0,00:00:00,0,0
2017-09-26-ccc_city_script,2017/09/26,ccc_city_script,26,26,00:00:12,12,00:00:44,0,312
2017-09-26-ccc_cty_online_script,2017/09/26,ccc_cty_online_script,0,0,00:00:00,0,00:00:00,0,0
2017-09-26-ccc_feedback_script,2017/09/26,ccc_feedback_script,0,0,00:00:00,0,00:00:00,0,0
2017-09-26-ccc_fpb_script,2017/09/26,ccc_fpb_script,5,5,00:00:06,6,00:00:11,0,30
2017-09-26-ccc_help_script,2017/09/26,ccc_help_script,21,19,00:00:13,13,00:00:53,2,247
2017-09-26-ccc_link_script,2017/09/26,ccc_link_script,0,0,00:00:00,0,00:00:00,0,0
2017-09-26-ccc_media_line_script,2017/09/26,ccc_media_line_script,1,1,00:00:10,10,00:00:10,0,10
2017-09-26-ccc_priority_script,2017/09/26,ccc_priority_script,14,14,00:00:07,7,00:00:49,0,98
2017-09-26-ccc_tax_script,2017/09/26,ccc_tax_script,31,31,00:00:31,31,00:03:34,0,961
2017-09-27-ccc_311_calgary_script,2017/09/27,ccc_311_calgary_script,3276,3037,00:00:54,54,00:11:47,238,163998
2017-09-27-ccc_311_lobby_ph_script,2017/09/27,ccc_311_lobby_ph_script,3,3,00:00:05,5,00:00:06,0,15
2017-09-27-ccc_aserv_info_script,2017/09/27,ccc_aserv_info_script,0,0,00:00:00,0,00:00:00,0,0
2017-09-27-ccc_bylaw_script,2017/09/27,ccc_bylaw_script,0,0,00:00:00,0,00:00:00,0,0
2017-09-27-ccc_city_script,2017/09/27,ccc_city_script,22,22,00:00:11,11,00:00:28,0,242
2017-09-27-ccc_cty_online_script,2017/09/27,ccc_cty_online_script,0,0,00:00:00,0,00:00:00,0,0
2017-09-27-ccc_feedback_script,2017/09/27,ccc_feedback_script,0,0,00:00:00,0,00:00:00,0,0
2017-09-27-ccc_fpb_script,2017/09/27,ccc_fpb_script,3,3,00:00:05,5,00:00:06,0,15
2017-09-27-ccc_help_script,2017/09/27,ccc_help_script,19,16,00:00:26,26,00:01:53,3,416
2017-09-27-ccc_link_script,2017/09/27,ccc_link_script,1,0,00:00:00,0,00:00:00,0,0
2017-09-27-ccc_media_line_script,2017/09/27,ccc_media_line_script,0,0,00:00:00,0,00:00:00,0,0
2017-09-27-ccc_priority_script,2017/09/27,ccc_priority_script,18,18,00:00:08,8,00:00:53,0,144
2017-09-27-ccc_tax_script,2017/09/27,ccc_tax_script,23,21,00:00:43,43,00:02:41,2,903
2017-09-27-ccc_waste_recycling_script,2017/09/27,ccc_waste_recycling_script,0,0,00:00:00,0,00:00:00,0,0
2017-09-28-ccc_311_calgary_script,2017/09/28,ccc_311_calgary_script,3472,3118,00:01:12,72,00:16:19,355,224496
2017-09-28-ccc_311_lobby_ph_script,2017/09/28,ccc_311_lobby_ph_script,2,2,00:00:24,24,00:00:25,0,48
2017-09-28-ccc_aserv_info_script,2017/09/28,ccc_aserv_info_script,0,0,00:00:00,0,00:00:00,0,0
2017-09-28-ccc_bylaw_script,2017/09/28,ccc_bylaw_script,0,0,00:00:00,0,00:00:00,0,0
2017-09-28-ccc_city_script,2017/09/28,ccc_city_script,19,19,00:00:15,15,00:00:54,0,285
2017-09-28-ccc_cty_online_script,2017/09/28,ccc_cty_online_script,0,0,00:00:00,0,00:00:00,0,0
2017-09-28-ccc_feedback_script,2017/09/28,ccc_feedback_script,0,0,00:00:00,0,00:00:00,0,0
2017-09-28-ccc_fpb_script,2017/09/28,ccc_fpb_script,12,7,00:01:14,74,00:03:19,5,518
2017-09-28-ccc_help_script,2017/09/28,ccc_help_script,23,23,00:00:16,16,00:00:39,0,368
2017-09-28-ccc_link_script,2017/09/28,ccc_link_script,0,0,00:00:00,0,00:00:00,0,0
2017-09-28-ccc_media_line_script,2017/09/28,ccc_media_line_script,0,0,00:00:00,0,00:00:00,0,0
2017-09-28-ccc_priority_script,2017/09/28,ccc_priority_script,31,31,00:00:13,13,00:01:09,0,403
2017-09-28-ccc_tax_script,2017/09/28,ccc_tax_script,25,25,00:00:24,24,00:01:56,0,600
2017-09-28-ccc_waste_recycling_script,2017/09/28,ccc_waste_recycling_script,0,0,00:00:00,0,00:00:00,0,0
2017-09-29-ccc_311_calgary_script,2017/09/29,ccc_311_calgary_script,3167,2978,00:00:49,49,00:05:46,189,145922
2017-09-29-ccc_311_lobby_ph_script,2017/09/29,ccc_311_lobby_ph_script,0,0,00:00:00,0,00:00:00,0,0
2017-09-29-ccc_aserv_info_script,2017/09/29,ccc_aserv_info_script,0,0,00:00:00,0,00:00:00,0,0
2017-09-29-ccc_bylaw_script,2017/09/29,ccc_bylaw_script,0,0,00:00:00,0,00:00:00,0,0
2017-09-29-ccc_city_script,2017/09/29,ccc_city_script,17,17,00:00:15,15,00:01:15,0,255
2017-09-29-ccc_cty_online_script,2017/09/29,ccc_cty_online_script,0,0,00:00:00,0,00:00:00,0,0
2017-09-29-ccc_feedback_script,2017/09/29,ccc_feedback_script,0,0,00:00:00,0,00:00:00,0,0
2017-09-29-ccc_fpb_script,2017/09/29,ccc_fpb_script,2,2,00:01:25,85,00:02:45,0,170
2017-09-29-ccc_help_script,2017/09/29,ccc_help_script,19,19,00:00:10,10,00:00:31,0,190
2017-09-29-ccc_link_script,2017/09/29,ccc_link_script,0,0,00:00:00,0,00:00:00,0,0
2017-09-29-ccc_media_line_script,2017/09/29,ccc_media_line_script,0,0,00:00:00,0,00:00:00,0,0
2017-09-29-ccc_priority_script,2017/09/29,ccc_priority_script,18,18,00:00:06,6,00:00:17,0,108
2017-09-29-ccc_tax_script,2017/09/29,ccc_tax_script,22,20,00:01:12,72,00:03:20,2,1440
2017-09-29-ccc_waste_recycling_script,2017/09/29,ccc_waste_recycling_script,0,0,00:00:00,0,00:00:00,0,0
2017-09-30-ccc_311_calgary_script,2017/09/30,ccc_311_calgary_script,1310,1234,00:00:46,46,00:11:05,76,56764
2017-09-30-ccc_311_lobby_ph_script,2017/09/30,ccc_311_lobby_ph_script,0,0,00:00:00,0,00:00:00,0,0
2017-09-30-ccc_aserv_info_script,2017/09/30,ccc_aserv_info_script,0,0,00:00:00,0,00:00:00,0,0
2017-09-30-ccc_bylaw_script,2017/09/30,ccc_bylaw_script,0,0,00:00:00,0,00:00:00,0,0
2017-09-30-ccc_city_script,2017/09/30,ccc_city_script,0,0,00:00:00,0,00:00:00,0,0
2017-09-30-ccc_cty_online_script,2017/09/30,ccc_cty_online_script,0,0,00:00:00,0,00:00:00,0,0
2017-09-30-ccc_feedback_script,2017/09/30,ccc_feedback_script,0,0,00:00:00,0,00:00:00,0,0
2017-09-30-ccc_fpb_script,2017/09/30,ccc_fpb_script,1,1,00:01:23,83,00:01:23,0,83
2017-09-30-ccc_help_script,2017/09/30,ccc_help_script,15,15,00:00:24,24,00:03:33,0,360
2017-09-30-ccc_link_script,2017/09/30,ccc_link_script,0,0,00:00:00,0,00:00:00,0,0
2017-09-30-ccc_media_line_script,2017/09/30,ccc_media_line_script,0,0,00:00:00,0,00:00:00,0,0
2017-09-30-ccc_priority_script,2017/09/30,ccc_priority_script,12,12,00:00:04,4,00:00:08,0,48
2017-09-30-ccc_tax_script,2017/09/30,ccc_tax_script,1,1,00:00:13,13,00:00:13,0,13
2017-09-30-ccc_waste_recycling_script,2017/09/30,ccc_waste_recycling_script,0,0,00:00:00,0,00:00:00,0,0
2017-10-01-ccc_help_script,2017/10/01,ccc_help_script,6,6,00:00:16,16,00:00:58,0,96
2017-10-01-ccc_link_script,2017/10/01,ccc_link_script,0,0,00:00:00,0,00:00:00,0,0
2017-10-01-ccc_media_line_script,2017/10/01,ccc_media_line_script,1,1,00:00:04,4,00:00:04,0,4
2017-10-01-ccc_priority_script,2017/10/01,ccc_priority_script,12,12,00:00:10,10,00:01:00,0,120
2017-10-01-ccc_tax_script,2017/10/01,ccc_tax_script,0,0,00:00:00,0,00:00:00,0,0
2017-10-01-ccc_waste_recycling_script,2017/10/01,ccc_waste_recycling_script,0,0,00:00:00,0,00:00:00,0,0
2017-10-01-ccc_311_calgary_script,2017/10/01,ccc_311_calgary_script,978,951,00:00:23,23,00:05:31,27,21873
2017-10-01-ccc_311_lobby_ph_script,2017/10/01,ccc_311_lobby_ph_script,0,0,00:00:00,0,00:00:00,0,0
2017-10-01-ccc_aserv_info_script,2017/10/01,ccc_aserv_info_script,0,0,00:00:00,0,00:00:00,0,0
2017-10-01-ccc_bylaw_script,2017/10/01,ccc_bylaw_script,0,0,00:00:00,0,00:00:00,0,0
2017-10-01-ccc_city_script,2017/10/01,ccc_city_script,0,0,00:00:00,0,00:00:00,0,0
2017-10-01-ccc_cty_online_script,2017/10/01,ccc_cty_online_script,0,0,00:00:00,0,00:00:00,0,0
2017-10-01-ccc_feedback_script,2017/10/01,ccc_feedback_script,0,0,00:00:00,0,00:00:00,0,0
2017-10-01-ccc_fpb_script,2017/10/01,ccc_fpb_script,2,2,00:00:10,10,00:00:12,0,20
2017-10-02-ccc_311_calgary_script,2017/10/02,ccc_311_calgary_script,3001,2923,00:00:16,16,00:03:10,78,46768
2017-10-02-ccc_311_lobby_ph_script,2017/10/02,ccc_311_lobby_ph_script,4,4,00:00:12,12,00:00:36,0,48
2017-10-02-ccc_aserv_info_script,2017/10/02,ccc_aserv_info_script,0,0,00:00:00,0,00:00:00,0,0
2017-10-02-ccc_bylaw_script,2017/10/02,ccc_bylaw_script,0,0,00:00:00,0,00:00:00,0,0
2017-10-02-ccc_city_script,2017/10/02,ccc_city_script,16,16,00:00:10,10,00:00:19,0,160
2017-10-02-ccc_cty_online_script,2017/10/02,ccc_cty_online_script,0,0,00:00:00,0,00:00:00,0,0
2017-10-02-ccc_feedback_script,2017/10/02,ccc_feedback_script,0,0,00:00:00,0,00:00:00,0,0
2017-10-02-ccc_fpb_script,2017/10/02,ccc_fpb_script,1,1,00:00:31,31,00:00:31,0,31
2017-10-02-ccc_help_script,2017/10/02,ccc_help_script,17,15,00:00:10,10,00:00:26,2,150
2017-10-02-ccc_link_script,2017/10/02,ccc_link_script,0,0,00:00:00,0,00:00:00,0,0
2017-10-02-ccc_media_line_script,2017/10/02,ccc_media_line_script,1,1,00:00:06,6,00:00:06,0,6
2017-10-02-ccc_priority_script,2017/10/02,ccc_priority_script,64,57,00:00:06,6,00:00:15,7,342
2017-10-02-ccc_tax_script,2017/10/02,ccc_tax_script,18,18,00:00:10,10,00:00:43,0,180
2017-10-02-ccc_waste_recycling_script,2017/10/02,ccc_waste_recycling_script,0,0,00:00:00,0,00:00:00,0,0
2017-10-03-ccc_311_calgary_script,2017/10/03,ccc_311_calgary_script,3170,2927,00:01:17,77,00:08:02,243,225379
2017-10-03-ccc_311_lobby_ph_script,2017/10/03,ccc_311_lobby_ph_script,0,0,00:00:00,0,00:00:00,0,0
2017-10-03-ccc_aserv_info_script,2017/10/03,ccc_aserv_info_script,0,0,00:00:00,0,00:00:00,0,0
2017-10-03-ccc_bylaw_script,2017/10/03,ccc_bylaw_script,0,0,00:00:00,0,00:00:00,0,0
2017-10-03-ccc_city_script,2017/10/03,ccc_city_script,19,18,00:00:19,19,00:01:55,1,342
2017-10-03-ccc_cty_online_script,2017/10/03,ccc_cty_online_script,0,0,00:00:00,0,00:00:00,0,0
2017-10-03-ccc_feedback_script,2017/10/03,ccc_feedback_script,0,0,00:00:00,0,00:00:00,0,0
2017-10-03-ccc_fpb_script,2017/10/03,ccc_fpb_script,3,1,00:00:06,6,00:00:06,2,6
2017-10-03-ccc_help_script,2017/10/03,ccc_help_script,16,15,00:00:09,9,00:00:42,1,135
2017-10-03-ccc_link_script,2017/10/03,ccc_link_script,0,0,00:00:00,0,00:00:00,0,0
2017-10-03-ccc_media_line_script,2017/10/03,ccc_media_line_script,3,1,00:00:03,3,00:00:03,2,3
2017-10-03-ccc_priority_script,2017/10/03,ccc_priority_script,31,31,00:00:08,8,00:00:33,0,248
2017-10-03-ccc_tax_script,2017/10/03,ccc_tax_script,19,18,00:01:15,75,00:03:54,1,1350
2017-10-03-ccc_waste_recycling_script,2017/10/03,ccc_waste_recycling_script,0,0,00:00:00,0,00:00:00,0,0
2017-10-04-ccc_311_calgary_script,2017/10/04,ccc_311_calgary_script,3420,3025,00:01:36,96,00:15:23,395,290400
2017-10-04-ccc_311_lobby_ph_script,2017/10/04,ccc_311_lobby_ph_script,5,4,00:00:14,14,00:00:20,1,56
2017-10-04-ccc_aserv_info_script,2017/10/04,ccc_aserv_info_script,0,0,00:00:00,0,00:00:00,0,0
2017-10-04-ccc_bylaw_script,2017/10/04,ccc_bylaw_script,0,0,00:00:00,0,00:00:00,0,0
2017-10-04-ccc_city_script,2017/10/04,ccc_city_script,14,11,00:00:42,42,00:04:27,3,462
2017-10-04-ccc_cty_online_script,2017/10/04,ccc_cty_online_script,0,0,00:00:00,0,00:00:00,0,0
2017-10-04-ccc_feedback_script,2017/10/04,ccc_feedback_script,0,0,00:00:00,0,00:00:00,0,0
2017-10-04-ccc_fpb_script,2017/10/04,ccc_fpb_script,8,1,00:00:47,47,00:00:47,7,47
2017-10-04-ccc_help_script,2017/10/04,ccc_help_script,23,23,00:00:11,11,00:00:44,0,253
2017-10-04-ccc_link_script,2017/10/04,ccc_link_script,0,0,00:00:00,0,00:00:00,0,0
2017-10-04-ccc_media_line_script,2017/10/04,ccc_media_line_script,0,0,00:00:00,0,00:00:00,0,0
2017-10-04-ccc_priority_script,2017/10/04,ccc_priority_script,30,30,00:00:10,10,00:00:36,0,300
2017-10-04-ccc_tax_script,2017/10/04,ccc_tax_script,36,35,00:00:52,52,00:06:55,1,1820
2017-10-04-ccc_waste_recycling_script,2017/10/04,ccc_waste_recycling_script,0,0,00:00:00,0,00:00:00,0,0
2017-10-05-ccc_311_calgary_script,2017/10/05,ccc_311_calgary_script,3451,3072,00:01:35,95,00:09:28,379,291840
2017-10-05-ccc_311_lobby_ph_script,2017/10/05,ccc_311_lobby_ph_script,1,1,00:00:12,12,00:00:12,0,12
2017-10-05-ccc_aserv_info_script,2017/10/05,ccc_aserv_info_script,0,0,00:00:00,0,00:00:00,0,0
2017-10-05-ccc_bylaw_script,2017/10/05,ccc_bylaw_script,0,0,00:00:00,0,00:00:00,0,0
2017-10-05-ccc_city_script,2017/10/05,ccc_city_script,13,13,00:00:13,13,00:00:32,0,169
2017-10-05-ccc_cty_online_script,2017/10/05,ccc_cty_online_script,0,0,00:00:00,0,00:00:00,0,0
2017-10-05-ccc_feedback_script,2017/10/05,ccc_feedback_script,0,0,00:00:00,0,00:00:00,0,0
2017-10-05-ccc_fpb_script,2017/10/05,ccc_fpb_script,2,1,00:02:39,159,00:02:39,1,159
2017-10-05-ccc_help_script,2017/10/05,ccc_help_script,32,29,00:00:16,16,00:00:53,3,464
2017-10-05-ccc_link_script,2017/10/05,ccc_link_script,0,0,00:00:00,0,00:00:00,0,0
2017-10-05-ccc_media_line_script,2017/10/05,ccc_media_line_script,1,0,00:00:00,0,00:00:00,1,0
2017-10-05-ccc_priority_script,2017/10/05,ccc_priority_script,42,40,00:00:12,12,00:01:25,2,480
2017-10-05-ccc_tax_script,2017/10/05,ccc_tax_script,15,14,00:02:20,140,00:07:14,1,1960
2017-10-05-ccc_waste_recycling_script,2017/10/05,ccc_waste_recycling_script,0,0,00:00:00,0,00:00:00,0,0
2017-10-06-ccc_311_calgary_script,2017/10/06,ccc_311_calgary_script,3126,2888,00:01:07,67,00:08:12,238,193496
2017-10-06-ccc_311_lobby_ph_script,2017/10/06,ccc_311_lobby_ph_script,2,1,00:00:10,10,00:00:10,1,10
2017-10-06-ccc_aserv_info_script,2017/10/06,ccc_aserv_info_script,0,0,00:00:00,0,00:00:00,0,0
2017-10-06-ccc_bylaw_script,2017/10/06,ccc_bylaw_script,0,0,00:00:00,0,00:00:00,0,0
2017-10-06-ccc_city_script,2017/10/06,ccc_city_script,19,17,00:00:26,26,00:03:01,2,442
2017-10-06-ccc_cty_online_script,2017/10/06,ccc_cty_online_script,0,0,00:00:00,0,00:00:00,0,0
2017-10-06-ccc_feedback_script,2017/10/06,ccc_feedback_script,0,0,00:00:00,0,00:00:00,0,0
2017-10-06-ccc_fpb_script,2017/10/06,ccc_fpb_script,5,4,00:00:17,17,00:00:53,1,68
2017-10-06-ccc_help_script,2017/10/06,ccc_help_script,14,14,00:00:10,10,00:00:41,0,140
2017-10-06-ccc_link_script,2017/10/06,ccc_link_script,0,0,00:00:00,0,00:00:00,0,0
2017-10-06-ccc_media_line_script,2017/10/06,ccc_media_line_script,2,1,00:00:05,5,00:00:05,1,5
2017-10-06-ccc_priority_script,2017/10/06,ccc_priority_script,23,23,00:00:08,8,00:00:21,0,184
2017-10-06-ccc_tax_script,2017/10/06,ccc_tax_script,26,25,00:01:04,64,00:03:49,1,1600
2017-10-06-ccc_waste_recycling_script,2017/10/06,ccc_waste_recycling_script,0,0,00:00:00,0,00:00:00,0,0
2017-10-07-ccc_311_calgary_script,2017/10/07,ccc_311_calgary_script,1166,1144,00:00:13,13,00:07:06,22,14872
2017-10-07-ccc_311_lobby_ph_script,2017/10/07,ccc_311_lobby_ph_script,0,0,00:00:00,0,00:00:00,0,0
2017-10-07-ccc_aserv_info_script,2017/10/07,ccc_aserv_info_script,0,0,00:00:00,0,00:00:00,0,0
2017-10-07-ccc_bylaw_script,2017/10/07,ccc_bylaw_script,0,0,00:00:00,0,00:00:00,0,0
2017-10-07-ccc_city_script,2017/10/07,ccc_city_script,0,0,00:00:00,0,00:00:00,0,0
2017-10-07-ccc_cty_online_script,2017/10/07,ccc_cty_online_script,0,0,00:00:00,0,00:00:00,0,0
2017-10-07-ccc_feedback_script,2017/10/07,ccc_feedback_script,0,0,00:00:00,0,00:00:00,0,0
2017-10-07-ccc_fpb_script,2017/10/07,ccc_fpb_script,2,2,00:00:04,4,00:00:06,0,8
2017-10-07-ccc_help_script,2017/10/07,ccc_help_script,7,7,00:00:06,6,00:00:11,0,42
2017-10-07-ccc_link_script,2017/10/07,ccc_link_script,0,0,00:00:00,0,00:00:00,0,0
2017-10-07-ccc_media_line_script,2017/10/07,ccc_media_line_script,0,0,00:00:00,0,00:00:00,0,0
2017-10-07-ccc_priority_script,2017/10/07,ccc_priority_script,14,14,00:00:07,7,00:00:20,0,98
2017-10-07-ccc_tax_script,2017/10/07,ccc_tax_script,1,1,00:00:06,6,00:00:06,0,6
2017-10-07-ccc_waste_recycling_script,2017/10/07,ccc_waste_recycling_script,0,0,00:00:00,0,00:00:00,0,0
2017-10-08-ccc_311_calgary_script,2017/10/08,ccc_311_calgary_script,709,699,00:00:15,15,00:11:20,10,10485
2017-10-08-ccc_311_lobby_ph_script,2017/10/08,ccc_311_lobby_ph_script,0,0,00:00:00,0,00:00:00,0,0
2017-10-08-ccc_aserv_info_script,2017/10/08,ccc_aserv_info_script,0,0,00:00:00,0,00:00:00,0,0
2017-10-08-ccc_bylaw_script,2017/10/08,ccc_bylaw_script,0,0,00:00:00,0,00:00:00,0,0
2017-10-08-ccc_city_script,2017/10/08,ccc_city_script,0,0,00:00:00,0,00:00:00,0,0
2017-10-08-ccc_cty_online_script,2017/10/08,ccc_cty_online_script,0,0,00:00:00,0,00:00:00,0,0
2017-10-08-ccc_feedback_script,2017/10/08,ccc_feedback_script,0,0,00:00:00,0,00:00:00,0,0
2017-10-08-ccc_fpb_script,2017/10/08,ccc_fpb_script,0,0,00:00:00,0,00:00:00,0,0
2017-10-08-ccc_help_script,2017/10/08,ccc_help_script,6,4,00:00:06,6,00:00:08,2,24
2017-10-08-ccc_link_script,2017/10/08,ccc_link_script,0,0,00:00:00,0,00:00:00,0,0
2017-10-08-ccc_media_line_script,2017/10/08,ccc_media_line_script,0,0,00:00:00,0,00:00:00,0,0
2017-10-08-ccc_priority_script,2017/10/08,ccc_priority_script,20,20,00:00:06,6,00:00:11,0,120
2017-10-08-ccc_tax_script,2017/10/08,ccc_tax_script,0,0,00:00:00,0,00:00:00,0,0
2017-10-08-ccc_waste_recycling_script,2017/10/08,ccc_waste_recycling_script,0,0,00:00:00,0,00:00:00,0,0
2017-10-09-ccc_311_calgary_script,2017/10/09,ccc_311_calgary_script,914,895,00:00:16,16,00:04:28,19,14320
2017-10-09-ccc_311_lobby_ph_script,2017/10/09,ccc_311_lobby_ph_script,0,0,00:00:00,0,00:00:00,0,0
2017-10-09-ccc_aserv_info_script,2017/10/09,ccc_aserv_info_script,0,0,00:00:00,0,00:00:00,0,0
2017-10-09-ccc_bylaw_script,2017/10/09,ccc_bylaw_script,0,0,00:00:00,0,00:00:00,0,0
2017-10-09-ccc_city_script,2017/10/09,ccc_city_script,0,0,00:00:00,0,00:00:00,0,0
2017-10-09-ccc_cty_online_script,2017/10/09,ccc_cty_online_script,0,0,00:00:00,0,00:00:00,0,0
2017-10-09-ccc_feedback_script,2017/10/09,ccc_feedback_script,0,0,00:00:00,0,00:00:00,0,0
2017-10-09-ccc_fpb_script,2017/10/09,ccc_fpb_script,1,1,00:00:05,5,00:00:05,0,5
2017-10-09-ccc_help_script,2017/10/09,ccc_help_script,6,5,00:00:07,7,00:00:11,1,35
2017-10-09-ccc_link_script,2017/10/09,ccc_link_script,0,0,00:00:00,0,00:00:00,0,0
2017-10-09-ccc_media_line_script,2017/10/09,ccc_media_line_script,0,0,00:00:00,0,00:00:00,0,0
2017-10-09-ccc_priority_script,2017/10/09,ccc_priority_script,11,11,00:00:06,6,00:00:13,0,66
2017-10-09-ccc_tax_script,2017/10/09,ccc_tax_script,0,0,00:00:00,0,00:00:00,0,0
2017-10-09-ccc_waste_recycling_script,2017/10/09,ccc_waste_recycling_script,0,0,00:00:00,0,00:00:00,0,0
2017-10-10-ccc_311_calgary_script,2017/10/10,ccc_311_calgary_script,3608,3426,00:00:44,44,00:07:58,182,150744
2017-10-10-ccc_311_lobby_ph_script,2017/10/10,ccc_311_lobby_ph_script,4,4,00:00:07,7,00:00:12,0,28
2017-10-10-ccc_aserv_info_script,2017/10/10,ccc_aserv_info_script,0,0,00:00:00,0,00:00:00,0,0
2017-10-10-ccc_bylaw_script,2017/10/10,ccc_bylaw_script,0,0,00:00:00,0,00:00:00,0,0
2017-10-10-ccc_city_script,2017/10/10,ccc_city_script,26,25,00:00:13,13,00:01:56,1,325
2017-10-10-ccc_cty_online_script,2017/10/10,ccc_cty_online_script,0,0,00:00:00,0,00:00:00,0,0
2017-10-10-ccc_feedback_script,2017/10/10,ccc_feedback_script,0,0,00:00:00,0,00:00:00,0,0
2017-10-10-ccc_fpb_script,2017/10/10,ccc_fpb_script,11,6,00:00:32,32,00:02:00,5,192
2017-10-10-ccc_help_script,2017/10/10,ccc_help_script,17,16,00:00:07,7,00:00:18,1,112
2017-10-10-ccc_link_script,2017/10/10,ccc_link_script,0,0,00:00:00,0,00:00:00,0,0
2017-10-10-ccc_media_line_script,2017/10/10,ccc_media_line_script,0,0,00:00:00,0,00:00:00,0,0
2017-10-10-ccc_priority_script,2017/10/10,ccc_priority_script,25,23,00:00:11,11,00:01:02,2,253
2017-10-10-ccc_tax_script,2017/10/10,ccc_tax_script,18,18,00:00:24,24,00:02:16,0,432
2017-10-10-ccc_waste_recycling_script,2017/10/10,ccc_waste_recycling_script,0,0,00:00:00,0,00:00:00,0,0
2017-10-11-ccc_311_calgary_script,2017/10/11,ccc_311_calgary_script,3405,3065,00:01:31,91,00:06:32,340,278915
2017-10-11-ccc_311_lobby_ph_script,2017/10/11,ccc_311_lobby_ph_script,8,6,00:00:17,17,00:00:42,2,102
2017-10-11-ccc_aserv_info_script,2017/10/11,ccc_aserv_info_script,0,0,00:00:00,0,00:00:00,0,0
2017-10-11-ccc_bylaw_script,2017/10/11,ccc_bylaw_script,0,0,00:00:00,0,00:00:00,0,0
2017-10-11-ccc_city_script,2017/10/11,ccc_city_script,30,29,00:00:47,47,00:04:17,1,1363
2017-10-11-ccc_cty_online_script,2017/10/11,ccc_cty_online_script,0,0,00:00:00,0,00:00:00,0,0
2017-10-11-ccc_feedback_script,2017/10/11,ccc_feedback_script,0,0,00:00:00,0,00:00:00,0,0
2017-10-11-ccc_fpb_script,2017/10/11,ccc_fpb_script,6,3,00:00:37,37,00:01:26,3,111
2017-10-11-ccc_help_script,2017/10/11,ccc_help_script,24,24,00:00:16,16,00:01:22,0,384
2017-10-11-ccc_link_script,2017/10/11,ccc_link_script,0,0,00:00:00,0,00:00:00,0,0
2017-10-11-ccc_media_line_script,2017/10/11,ccc_media_line_script,0,0,00:00:00,0,00:00:00,0,0
2017-10-11-ccc_priority_script,2017/10/11,ccc_priority_script,22,22,00:00:07,7,00:00:15,0,154
2017-10-11-ccc_tax_script,2017/10/11,ccc_tax_script,24,24,00:01:47,107,00:03:57,0,2568
2017-10-11-ccc_waste_recycling_script,2017/10/11,ccc_waste_recycling_script,0,0,00:00:00,0,00:00:00,0,0
2017-10-12-ccc_311_calgary_script,2017/10/12,ccc_311_calgary_script,3385,3001,00:01:42,102,00:12:27,384,306102
2017-10-12-ccc_311_lobby_ph_script,2017/10/12,ccc_311_lobby_ph_script,5,5,00:00:10,10,00:00:18,0,50
2017-10-12-ccc_aserv_info_script,2017/10/12,ccc_aserv_info_script,0,0,00:00:00,0,00:00:00,0,0
2017-10-12-ccc_bylaw_script,2017/10/12,ccc_bylaw_script,0,0,00:00:00,0,00:00:00,0,0
2017-10-12-ccc_city_script,2017/10/12,ccc_city_script,24,23,00:00:14,14,00:00:55,1,322
2017-10-12-ccc_cty_online_script,2017/10/12,ccc_cty_online_script,0,0,00:00:00,0,00:00:00,0,0
2017-10-12-ccc_feedback_script,2017/10/12,ccc_feedback_script,0,0,00:00:00,0,00:00:00,0,0
2017-10-12-ccc_fpb_script,2017/10/12,ccc_fpb_script,3,2,00:01:08,68,00:01:55,1,136
2017-10-12-ccc_help_script,2017/10/12,ccc_help_script,24,23,00:00:10,10,00:00:30,1,230
2017-10-12-ccc_link_script,2017/10/12,ccc_link_script,0,0,00:00:00,0,00:00:00,0,0
2017-10-12-ccc_media_line_script,2017/10/12,ccc_media_line_script,0,0,00:00:00,0,00:00:00,0,0
2017-10-12-ccc_priority_script,2017/10/12,ccc_priority_script,27,26,00:00:07,7,00:00:23,1,182
2017-10-12-ccc_tax_script,2017/10/12,ccc_tax_script,21,17,00:02:08,128,00:07:24,4,2176
2017-10-12-ccc_waste_recycling_script,2017/10/12,ccc_waste_recycling_script,0,0,00:00:00,0,00:00:00,0,0
2017-10-13-ccc_311_calgary_script,2017/10/13,ccc_311_calgary_script,3094,3010,00:00:28,28,00:05:58,84,84280
2017-10-13-ccc_311_lobby_ph_script,2017/10/13,ccc_311_lobby_ph_script,3,3,00:00:19,19,00:00:39,0,57
2017-10-13-ccc_aserv_info_script,2017/10/13,ccc_aserv_info_script,0,0,00:00:00,0,00:00:00,0,0
2017-10-13-ccc_bylaw_script,2017/10/13,ccc_bylaw_script,0,0,00:00:00,0,00:00:00,0,0
2017-10-13-ccc_city_script,2017/10/13,ccc_city_script,15,15,00:00:12,12,00:00:49,0,180
2017-10-13-ccc_cty_online_script,2017/10/13,ccc_cty_online_script,0,0,00:00:00,0,00:00:00,0,0
2017-10-13-ccc_feedback_script,2017/10/13,ccc_feedback_script,0,0,00:00:00,0,00:00:00,0,0
2017-10-13-ccc_fpb_script,2017/10/13,ccc_fpb_script,2,2,00:00:07,7,00:00:09,0,14
2017-10-13-ccc_help_script,2017/10/13,ccc_help_script,15,15,00:00:08,8,00:00:22,0,120
2017-10-13-ccc_link_script,2017/10/13,ccc_link_script,0,0,00:00:00,0,00:00:00,0,0
2017-10-13-ccc_media_line_script,2017/10/13,ccc_media_line_script,0,0,00:00:00,0,00:00:00,0,0
2017-10-13-ccc_priority_script,2017/10/13,ccc_priority_script,23,23,00:00:07,7,00:00:53,0,161
2017-10-13-ccc_tax_script,2017/10/13,ccc_tax_script,15,15,00:00:12,12,00:00:35,0,180
2017-10-13-ccc_waste_recycling_script,2017/10/13,ccc_waste_recycling_script,0,0,00:00:00,0,00:00:00,0,0
2017-10-14-ccc_311_calgary_script,2017/10/14,ccc_311_calgary_script,1216,1198,00:00:12,12,00:03:02,18,14376
2017-10-14-ccc_311_lobby_ph_script,2017/10/14,ccc_311_lobby_ph_script,0,0,00:00:00,0,00:00:00,0,0
2017-10-14-ccc_aserv_info_script,2017/10/14,ccc_aserv_info_script,0,0,00:00:00,0,00:00:00,0,0
2017-10-14-ccc_bylaw_script,2017/10/14,ccc_bylaw_script,0,0,00:00:00,0,00:00:00,0,0
2017-10-14-ccc_city_script,2017/10/14,ccc_city_script,0,0,00:00:00,0,00:00:00,0,0
2017-10-14-ccc_cty_online_script,2017/10/14,ccc_cty_online_script,0,0,00:00:00,0,00:00:00,0,0
2017-10-14-ccc_feedback_script,2017/10/14,ccc_feedback_script,0,0,00:00:00,0,00:00:00,0,0
2017-10-14-ccc_fpb_script,2017/10/14,ccc_fpb_script,1,1,00:00:14,14,00:00:14,0,14
2017-10-14-ccc_help_script,2017/10/14,ccc_help_script,3,3,00:00:05,5,00:00:08,0,15
2017-10-14-ccc_link_script,2017/10/14,ccc_link_script,0,0,00:00:00,0,00:00:00,0,0
2017-10-14-ccc_media_line_script,2017/10/14,ccc_media_line_script,5,5,00:00:22,22,00:01:29,0,110
2017-10-14-ccc_priority_script,2017/10/14,ccc_priority_script,17,16,00:00:07,7,00:00:21,1,112
2017-10-14-ccc_tax_script,2017/10/14,ccc_tax_script,3,3,00:00:11,11,00:00:28,0,33
2017-10-14-ccc_waste_recycling_script,2017/10/14,ccc_waste_recycling_script,0,0,00:00:00,0,00:00:00,0,0
2017-10-15-ccc_311_calgary_script,2017/10/15,ccc_311_calgary_script,1052,1041,00:00:15,15,00:02:40,11,15615
2017-10-15-ccc_311_lobby_ph_script,2017/10/15,ccc_311_lobby_ph_script,0,0,00:00:00,0,00:00:00,0,0
2017-10-15-ccc_aserv_info_script,2017/10/15,ccc_aserv_info_script,0,0,00:00:00,0,00:00:00,0,0
2017-10-15-ccc_bylaw_script,2017/10/15,ccc_bylaw_script,0,0,00:00:00,0,00:00:00,0,0
2017-10-15-ccc_city_script,2017/10/15,ccc_city_script,0,0,00:00:00,0,00:00:00,0,0
2017-10-15-ccc_cty_online_script,2017/10/15,ccc_cty_online_script,0,0,00:00:00,0,00:00:00,0,0
2017-10-15-ccc_feedback_script,2017/10/15,ccc_feedback_script,0,0,00:00:00,0,00:00:00,0,0
2017-10-15-ccc_fpb_script,2017/10/15,ccc_fpb_script,1,1,00:00:01,1,00:00:01,0,1
2017-10-15-ccc_help_script,2017/10/15,ccc_help_script,5,5,00:00:05,5,00:00:10,0,25
2017-10-15-ccc_link_script,2017/10/15,ccc_link_script,0,0,00:00:00,0,00:00:00,0,0
2017-10-15-ccc_media_line_script,2017/10/15,ccc_media_line_script,0,0,00:00:00,0,00:00:00,0,0
2017-10-15-ccc_priority_script,2017/10/15,ccc_priority_script,19,19,00:00:05,5,00:00:16,0,95
2017-10-15-ccc_tax_script,2017/10/15,ccc_tax_script,0,0,00:00:00,0,00:00:00,0,0
2017-10-15-ccc_waste_recycling_script,2017/10/15,ccc_waste_recycling_script,0,0,00:00:00,0,00:00:00,0,0
2017-10-16-ccc_311_calgary_script,2017/10/16,ccc_311_calgary_script,4399,4245,00:00:27,27,00:04:46,154,114615
2017-10-16-ccc_311_lobby_ph_script,2017/10/16,ccc_311_lobby_ph_script,4,2,00:00:16,16,00:00:29,2,32
2017-10-16-ccc_aserv_info_script,2017/10/16,ccc_aserv_info_script,0,0,00:00:00,0,00:00:00,0,0
2017-10-16-ccc_bylaw_script,2017/10/16,ccc_bylaw_script,0,0,00:00:00,0,00:00:00,0,0
2017-10-16-ccc_city_script,2017/10/16,ccc_city_script,6,6,00:00:10,10,00:00:18,0,60
2017-10-16-ccc_cty_online_script,2017/10/16,ccc_cty_online_script,0,0,00:00:00,0,00:00:00,0,0
2017-10-16-ccc_feedback_script,2017/10/16,ccc_feedback_script,0,0,00:00:00,0,00:00:00,0,0
2017-10-16-ccc_fpb_script,2017/10/16,ccc_fpb_script,0,0,00:00:00,0,00:00:00,0,0
2017-10-16-ccc_help_script,2017/10/16,ccc_help_script,26,23,00:00:10,10,00:00:30,3,230
2017-10-16-ccc_link_script,2017/10/16,ccc_link_script,0,0,00:00:00,0,00:00:00,0,0
2017-10-16-ccc_media_line_script,2017/10/16,ccc_media_line_script,26,25,00:00:16,16,00:01:35,1,400
2017-10-16-ccc_priority_script,2017/10/16,ccc_priority_script,27,26,00:00:05,5,00:00:17,1,130
2017-10-16-ccc_tax_script,2017/10/16,ccc_tax_script,17,17,00:00:55,55,00:04:36,0,935
2017-10-16-ccc_waste_recycling_script,2017/10/16,ccc_waste_recycling_script,0,0,00:00:00,0,00:00:00,0,0
2017-10-17-ccc_311_calgary_script,2017/10/17,ccc_311_calgary_script,4053,3519,00:01:17,77,00:10:33,534,270963
2017-10-17-ccc_311_lobby_ph_script,2017/10/17,ccc_311_lobby_ph_script,3,3,00:00:04,4,00:00:07,0,12
2017-10-17-ccc_aserv_info_script,2017/10/17,ccc_aserv_info_script,0,0,00:00:00,0,00:00:00,0,0
2017-10-17-ccc_bylaw_script,2017/10/17,ccc_bylaw_script,0,0,00:00:00,0,00:00:00,0,0
2017-10-17-ccc_city_script,2017/10/17,ccc_city_script,16,15,00:00:37,37,00:06:11,1,555
2017-10-17-ccc_cty_online_script,2017/10/17,ccc_cty_online_script,0,0,00:00:00,0,00:00:00,0,0
2017-10-17-ccc_feedback_script,2017/10/17,ccc_feedback_script,0,0,00:00:00,0,00:00:00,0,0
2017-10-17-ccc_fpb_script,2017/10/17,ccc_fpb_script,3,3,00:05:37,337,00:09:53,0,1011
2017-10-17-ccc_help_script,2017/10/17,ccc_help_script,23,19,00:00:07,7,00:00:23,4,133
2017-10-17-ccc_link_script,2017/10/17,ccc_link_script,0,0,00:00:00,0,00:00:00,0,0
2017-10-17-ccc_media_line_script,2017/10/17,ccc_media_line_script,4,4,00:00:22,22,00:00:51,0,88
2017-10-17-ccc_priority_script,2017/10/17,ccc_priority_script,53,50,00:00:11,11,00:00:44,3,550
2017-10-17-ccc_tax_script,2017/10/17,ccc_tax_script,36,36,00:00:53,53,00:09:05,0,1908
2017-10-17-ccc_waste_recycling_script,2017/10/17,ccc_waste_recycling_script,0,0,00:00:00,0,00:00:00,0,0
2017-10-18-ccc_311_calgary_script,2017/10/18,ccc_311_calgary_script,3342,3151,00:00:55,55,00:05:48,191,173305
2017-10-18-ccc_311_lobby_ph_script,2017/10/18,ccc_311_lobby_ph_script,1,1,00:00:03,3,00:00:03,0,3
2017-10-18-ccc_aserv_info_script,2017/10/18,ccc_aserv_info_script,0,0,00:00:00,0,00:00:00,0,0
2017-10-18-ccc_bylaw_script,2017/10/18,ccc_bylaw_script,0,0,00:00:00,0,00:00:00,0,0
2017-10-18-ccc_city_script,2017/10/18,ccc_city_script,9,9,00:00:30,30,00:02:51,0,270
2017-10-18-ccc_cty_online_script,2017/10/18,ccc_cty_online_script,0,0,00:00:00,0,00:00:00,0,0
2017-10-18-ccc_feedback_script,2017/10/18,ccc_feedback_script,0,0,00:00:00,0,00:00:00,0,0
2017-10-18-ccc_fpb_script,2017/10/18,ccc_fpb_script,3,3,00:00:24,24,00:00:59,0,72
2017-10-18-ccc_help_script,2017/10/18,ccc_help_script,13,13,00:00:12,12,00:00:43,0,156
2017-10-18-ccc_link_script,2017/10/18,ccc_link_script,0,0,00:00:00,0,00:00:00,0,0
2017-10-18-ccc_media_line_script,2017/10/18,ccc_media_line_script,0,0,00:00:00,0,00:00:00,0,0
2017-10-18-ccc_priority_script,2017/10/18,ccc_priority_script,43,40,00:00:07,7,00:00:42,3,280
2017-10-18-ccc_tax_script,2017/10/18,ccc_tax_script,22,21,00:01:09,69,00:04:04,1,1449
2017-10-18-ccc_waste_recycling_script,2017/10/18,ccc_waste_recycling_script,0,0,00:00:00,0,00:00:00,0,0
2017-10-19-ccc_311_calgary_script,2017/10/19,ccc_311_calgary_script,3291,3049,00:01:05,65,00:08:00,242,198185
2017-10-19-ccc_311_lobby_ph_script,2017/10/19,ccc_311_lobby_ph_script,5,5,00:00:16,16,00:00:55,0,80
2017-10-19-ccc_aserv_info_script,2017/10/19,ccc_aserv_info_script,0,0,00:00:00,0,00:00:00,0,0
2017-10-19-ccc_bylaw_script,2017/10/19,ccc_bylaw_script,0,0,00:00:00,0,00:00:00,0,0
2017-10-19-ccc_city_script,2017/10/19,ccc_city_script,9,9,00:00:17,17,00:00:30,0,153
2017-10-19-ccc_cty_online_script,2017/10/19,ccc_cty_online_script,0,0,00:00:00,0,00:00:00,0,0
2017-10-19-ccc_feedback_script,2017/10/19,ccc_feedback_script,0,0,00:00:00,0,00:00:00,0,0
2017-10-19-ccc_fpb_script,2017/10/19,ccc_fpb_script,3,2,00:00:04,4,00:00:04,1,8
2017-10-19-ccc_help_script,2017/10/19,ccc_help_script,7,6,00:00:10,10,00:00:27,1,60
2017-10-19-ccc_link_script,2017/10/19,ccc_link_script,0,0,00:00:00,0,00:00:00,0,0
2017-10-19-ccc_media_line_script,2017/10/19,ccc_media_line_script,1,1,00:00:22,22,00:00:22,0,22
2017-10-19-ccc_priority_script,2017/10/19,ccc_priority_script,33,30,00:00:08,8,00:00:58,3,240
2017-10-19-ccc_tax_script,2017/10/19,ccc_tax_script,24,19,00:00:33,33,00:02:38,5,627
2017-10-19-ccc_waste_recycling_script,2017/10/19,ccc_waste_recycling_script,0,0,00:00:00,0,00:00:00,0,0
2017-10-20-ccc_311_calgary_script,2017/10/20,ccc_311_calgary_script,3291,3049,00:01:05,65,00:08:00,242,198185
2017-10-20-ccc_311_lobby_ph_script,2017/10/20,ccc_311_lobby_ph_script,5,5,00:00:16,16,00:00:55,0,80
2017-10-20-ccc_aserv_info_script,2017/10/20,ccc_aserv_info_script,0,0,00:00:00,0,00:00:00,0,0
2017-10-20-ccc_bylaw_script,2017/10/20,ccc_bylaw_script,0,0,00:00:00,0,00:00:00,0,0
2017-10-20-ccc_city_script,2017/10/20,ccc_city_script,9,9,00:00:17,17,00:00:30,0,153
2017-10-20-ccc_cty_online_script,2017/10/20,ccc_cty_online_script,0,0,00:00:00,0,00:00:00,0,0
2017-10-20-ccc_feedback_script,2017/10/20,ccc_feedback_script,0,0,00:00:00,0,00:00:00,0,0
2017-10-20-ccc_fpb_script,2017/10/20,ccc_fpb_script,3,2,00:00:04,4,00:00:04,1,8
2017-10-20-ccc_help_script,2017/10/20,ccc_help_script,7,6,00:00:10,10,00:00:27,1,60
2017-10-20-ccc_link_script,2017/10/20,ccc_link_script,0,0,00:00:00,0,00:00:00,0,0
2017-10-20-ccc_media_line_script,2017/10/20,ccc_media_line_script,1,1,00:00:22,22,00:00:22,0,22
2017-10-20-ccc_priority_script,2017/10/20,ccc_priority_script,33,30,00:00:08,8,00:00:58,3,240
2017-10-20-ccc_tax_script,2017/10/20,ccc_tax_script,24,19,00:00:33,33,00:02:38,5,627
2017-10-20-ccc_waste_recycling_script,2017/10/20,ccc_waste_recycling_script,0,0,00:00:00,0,00:00:00,0,0
2017-10-21-ccc_311_calgary_script,2017/10/21,ccc_311_calgary_script,3291,3049,00:01:05,65,00:08:00,242,198185
2017-10-21-ccc_311_lobby_ph_script,2017/10/21,ccc_311_lobby_ph_script,5,5,00:00:16,16,00:00:55,0,80
2017-10-21-ccc_aserv_info_script,2017/10/21,ccc_aserv_info_script,0,0,00:00:00,0,00:00:00,0,0
2017-10-21-ccc_bylaw_script,2017/10/21,ccc_bylaw_script,0,0,00:00:00,0,00:00:00,0,0
2017-10-21-ccc_city_script,2017/10/21,ccc_city_script,9,9,00:00:17,17,00:00:30,0,153
2017-10-21-ccc_cty_online_script,2017/10/21,ccc_cty_online_script,0,0,00:00:00,0,00:00:00,0,0
2017-10-21-ccc_feedback_script,2017/10/21,ccc_feedback_script,0,0,00:00:00,0,00:00:00,0,0
2017-10-21-ccc_fpb_script,2017/10/21,ccc_fpb_script,3,2,00:00:04,4,00:00:04,1,8
2017-10-21-ccc_help_script,2017/10/21,ccc_help_script,7,6,00:00:10,10,00:00:27,1,60
2017-10-21-ccc_link_script,2017/10/21,ccc_link_script,0,0,00:00:00,0,00:00:00,0,0
2017-10-21-ccc_media_line_script,2017/10/21,ccc_media_line_script,1,1,00:00:22,22,00:00:22,0,22
2017-10-21-ccc_priority_script,2017/10/21,ccc_priority_script,33,30,00:00:08,8,00:00:58,3,240
2017-10-21-ccc_tax_script,2017/10/21,ccc_tax_script,24,19,00:00:33,33,00:02:38,5,627
2017-10-21-ccc_waste_recycling_script,2017/10/21,ccc_waste_recycling_script,0,0,00:00:00,0,00:00:00,0,0
2017-10-22-ccc_311_calgary_script,2017/10/22,ccc_311_calgary_script,851,836,00:00:13,13,00:03:43,15,10868
2017-10-22-ccc_311_lobby_ph_script,2017/10/22,ccc_311_lobby_ph_script,0,0,00:00:00,0,00:00:00,0,0
2017-10-22-ccc_aserv_info_script,2017/10/22,ccc_aserv_info_script,0,0,00:00:00,0,00:00:00,0,0
2017-10-22-ccc_bylaw_script,2017/10/22,ccc_bylaw_script,0,0,00:00:00,0,00:00:00,0,0
2017-10-22-ccc_city_script,2017/10/22,ccc_city_script,0,0,00:00:00,0,00:00:00,0,0
2017-10-22-ccc_cty_online_script,2017/10/22,ccc_cty_online_script,0,0,00:00:00,0,00:00:00,0,0
2017-10-22-ccc_feedback_script,2017/10/22,ccc_feedback_script,0,0,00:00:00,0,00:00:00,0,0
2017-10-22-ccc_fpb_script,2017/10/22,ccc_fpb_script,1,0,00:00:00,0,00:00:00,1,0
2017-10-22-ccc_help_script,2017/10/22,ccc_help_script,5,5,00:00:16,16,00:00:45,0,80
2017-10-22-ccc_link_script,2017/10/22,ccc_link_script,0,0,00:00:00,0,00:00:00,0,0
2017-10-22-ccc_media_line_script,2017/10/22,ccc_media_line_script,0,0,00:00:00,0,00:00:00,0,0
2017-10-22-ccc_priority_script,2017/10/22,ccc_priority_script,17,16,00:00:06,6,00:00:12,1,96
2017-10-22-ccc_tax_script,2017/10/22,ccc_tax_script,0,0,00:00:00,0,00:00:00,0,0
2017-10-22-ccc_waste_recycling_script,2017/10/22,ccc_waste_recycling_script,0,0,00:00:00,0,00:00:00,0,0
2017-10-23-ccc_311_calgary_script,2017/10/23,ccc_311_calgary_script,3191,3023,00:00:52,52,00:06:52,168,157196
2017-10-23-ccc_311_lobby_ph_script,2017/10/23,ccc_311_lobby_ph_script,3,3,00:00:04,4,00:00:05,0,12
2017-10-23-ccc_aserv_info_script,2017/10/23,ccc_aserv_info_script,0,0,00:00:00,0,00:00:00,0,0
2017-10-23-ccc_bylaw_script,2017/10/23,ccc_bylaw_script,0,0,00:00:00,0,00:00:00,0,0
2017-10-23-ccc_city_script,2017/10/23,ccc_city_script,25,24,00:00:20,20,00:02:27,1,480
2017-10-23-ccc_cty_online_script,2017/10/23,ccc_cty_online_script,0,0,00:00:00,0,00:00:00,0,0
2017-10-23-ccc_feedback_script,2017/10/23,ccc_feedback_script,0,0,00:00:00,0,00:00:00,0,0
2017-10-23-ccc_fpb_script,2017/10/23,ccc_fpb_script,5,2,00:00:02,2,00:00:02,3,4
2017-10-23-ccc_help_script,2017/10/23,ccc_help_script,4,3,00:00:10,10,00:00:11,1,30
2017-10-23-ccc_link_script,2017/10/23,ccc_link_script,0,0,00:00:00,0,00:00:00,0,0
2017-10-23-ccc_media_line_script,2017/10/23,ccc_media_line_script,0,0,00:00:00,0,00:00:00,0,0
2017-10-23-ccc_priority_script,2017/10/23,ccc_priority_script,12,12,00:00:06,6,00:00:13,0,72
2017-10-23-ccc_tax_script,2017/10/23,ccc_tax_script,18,16,00:01:53,113,00:07:15,2,1808
2017-10-23-ccc_waste_recycling_script,2017/10/23,ccc_waste_recycling_script,0,0,00:00:00,0,00:00:00,0,0
2017-10-24-ccc_311_calgary_script,2017/10/24,ccc_311_calgary_script,3040,2969,00:00:27,27,00:05:00,71,80163
2017-10-24-ccc_311_lobby_ph_script,2017/10/24,ccc_311_lobby_ph_script,2,2,00:00:11,11,00:00:15,0,22
2017-10-24-ccc_aserv_info_script,2017/10/24,ccc_aserv_info_script,0,0,00:00:00,0,00:00:00,0,0
2017-10-24-ccc_bylaw_script,2017/10/24,ccc_bylaw_script,0,0,00:00:00,0,00:00:00,0,0
2017-10-24-ccc_city_script,2017/10/24,ccc_city_script,13,13,00:00:15,15,00:01:26,0,195
2017-10-24-ccc_cty_online_script,2017/10/24,ccc_cty_online_script,0,0,00:00:00,0,00:00:00,0,0
2017-10-24-ccc_feedback_script,2017/10/24,ccc_feedback_script,0,0,00:00:00,0,00:00:00,0,0
2017-10-24-ccc_fpb_script,2017/10/24,ccc_fpb_script,5,5,00:00:06,6,00:00:08,0,30
2017-10-24-ccc_help_script,2017/10/24,ccc_help_script,24,21,00:00:06,6,00:00:12,3,126
2017-10-24-ccc_link_script,2017/10/24,ccc_link_script,0,0,00:00:00,0,00:00:00,0,0
2017-10-24-ccc_media_line_script,2017/10/24,ccc_media_line_script,1,1,00:00:06,6,00:00:06,0,6
2017-10-24-ccc_priority_script,2017/10/24,ccc_priority_script,27,27,00:00:09,9,00:00:37,0,243
2017-10-24-ccc_tax_script,2017/10/24,ccc_tax_script,24,24,00:00:17,17,00:01:55,0,408
2017-10-24-ccc_waste_recycling_script,2017/10/24,ccc_waste_recycling_script,0,0,00:00:00,0,00:00:00,0,0
2017-10-25-ccc_311_calgary_script,2017/10/25,ccc_311_calgary_script,2997,2935,00:00:21,21,00:03:53,62,61635
2017-10-25-ccc_311_lobby_ph_script,2017/10/25,ccc_311_lobby_ph_script,3,3,00:00:11,11,00:00:16,0,33
2017-10-25-ccc_aserv_info_script,2017/10/25,ccc_aserv_info_script,0,0,00:00:00,0,00:00:00,0,0
2017-10-25-ccc_bylaw_script,2017/10/25,ccc_bylaw_script,0,0,00:00:00,0,00:00:00,0,0
2017-10-25-ccc_city_script,2017/10/25,ccc_city_script,20,20,00:00:14,14,00:01:12,0,280
2017-10-25-ccc_cty_online_script,2017/10/25,ccc_cty_online_script,0,0,00:00:00,0,00:00:00,0,0
2017-10-25-ccc_feedback_script,2017/10/25,ccc_feedback_script,0,0,00:00:00,0,00:00:00,0,0
2017-10-25-ccc_fpb_script,2017/10/25,ccc_fpb_script,7,5,00:00:03,3,00:00:05,2,15
2017-10-25-ccc_help_script,2017/10/25,ccc_help_script,8,8,00:00:07,7,00:00:11,0,56
2017-10-25-ccc_link_script,2017/10/25,ccc_link_script,0,0,00:00:00,0,00:00:00,0,0
2017-10-25-ccc_media_line_script,2017/10/25,ccc_media_line_script,1,1,00:00:03,3,00:00:03,0,3
2017-10-25-ccc_priority_script,2017/10/25,ccc_priority_script,37,37,00:00:08,8,00:00:44,0,296
2017-10-25-ccc_tax_script,2017/10/25,ccc_tax_script,15,12,00:00:27,27,00:03:18,3,324
2017-10-25-ccc_waste_recycling_script,2017/10/25,ccc_waste_recycling_script,0,0,00:00:00,0,00:00:00,0,0
2017-10-26-ccc_311_calgary_script,2017/10/26,ccc_311_calgary_script,3016,2916,00:00:28,28,00:10:21,100,81648
2017-10-26-ccc_311_lobby_ph_script,2017/10/26,ccc_311_lobby_ph_script,1,1,00:00:03,3,00:00:03,0,3
2017-10-26-ccc_aserv_info_script,2017/10/26,ccc_aserv_info_script,0,0,00:00:00,0,00:00:00,0,0
2017-10-26-ccc_bylaw_script,2017/10/26,ccc_bylaw_script,0,0,00:00:00,0,00:00:00,0,0
2017-10-26-ccc_city_script,2017/10/26,ccc_city_script,12,12,00:00:10,10,00:00:22,0,120
2017-10-26-ccc_cty_online_script,2017/10/26,ccc_cty_online_script,0,0,00:00:00,0,00:00:00,0,0
2017-10-26-ccc_feedback_script,2017/10/26,ccc_feedback_script,0,0,00:00:00,0,00:00:00,0,0
2017-10-26-ccc_fpb_script,2017/10/26,ccc_fpb_script,4,4,00:00:50,50,00:03:14,0,200
2017-10-26-ccc_help_script,2017/10/26,ccc_help_script,13,13,00:00:07,7,00:00:17,0,91
2017-10-26-ccc_link_script,2017/10/26,ccc_link_script,0,0,00:00:00,0,00:00:00,0,0
2017-10-26-ccc_media_line_script,2017/10/26,ccc_media_line_script,0,0,00:00:00,0,00:00:00,0,0
2017-10-26-ccc_priority_script,2017/10/26,ccc_priority_script,25,24,00:00:09,9,00:00:30,1,216
2017-10-26-ccc_tax_script,2017/10/26,ccc_tax_script,24,21,00:00:30,30,00:03:12,3,630
2017-10-26-ccc_waste_recycling_script,2017/10/26,ccc_waste_recycling_script,0,0,00:00:00,0,00:00:00,0,0
2017-10-27-ccc_311_calgary_script,2017/10/27,ccc_311_calgary_script,2704,2621,00:00:31,31,00:06:35,83,81251
2017-10-27-ccc_311_lobby_ph_script,2017/10/27,ccc_311_lobby_ph_script,0,0,00:00:00,0,00:00:00,0,0
2017-10-27-ccc_aserv_info_script,2017/10/27,ccc_aserv_info_script,0,0,00:00:00,0,00:00:00,0,0
2017-10-27-ccc_bylaw_script,2017/10/27,ccc_bylaw_script,0,0,00:00:00,0,00:00:00,0,0
2017-10-27-ccc_city_script,2017/10/27,ccc_city_script,24,22,00:00:13,13,00:00:45,2,286
2017-10-27-ccc_cty_online_script,2017/10/27,ccc_cty_online_script,0,0,00:00:00,0,00:00:00,0,0
2017-10-27-ccc_feedback_script,2017/10/27,ccc_feedback_script,0,0,00:00:00,0,00:00:00,0,0
2017-10-27-ccc_fpb_script,2017/10/27,ccc_fpb_script,4,2,00:01:02,62,00:02:02,2,124
2017-10-27-ccc_help_script,2017/10/27,ccc_help_script,29,26,00:00:15,15,00:00:58,3,390
2017-10-27-ccc_link_script,2017/10/27,ccc_link_script,0,0,00:00:00,0,00:00:00,0,0
2017-10-27-ccc_media_line_script,2017/10/27,ccc_media_line_script,0,0,00:00:00,0,00:00:00,0,0
2017-10-27-ccc_priority_script,2017/10/27,ccc_priority_script,22,22,00:00:10,10,00:00:55,0,220
2017-10-27-ccc_tax_script,2017/10/27,ccc_tax_script,19,19,00:00:25,25,00:02:54,0,475
2017-10-27-ccc_waste_recycling_script,2017/10/27,ccc_waste_recycling_script,0,0,00:00:00,0,00:00:00,0,0
2017-10-28-ccc_311_calgary_script,2017/10/28,ccc_311_calgary_script,1147,1081,00:00:46,46,00:06:25,66,49726
2017-10-28-ccc_311_lobby_ph_script,2017/10/28,ccc_311_lobby_ph_script,0,0,00:00:00,0,00:00:00,0,0
2017-10-28-ccc_aserv_info_script,2017/10/28,ccc_aserv_info_script,0,0,00:00:00,0,00:00:00,0,0
2017-10-28-ccc_bylaw_script,2017/10/28,ccc_bylaw_script,0,0,00:00:00,0,00:00:00,0,0
2017-10-28-ccc_city_script,2017/10/28,ccc_city_script,0,0,00:00:00,0,00:00:00,0,0
2017-10-28-ccc_cty_online_script,2017/10/28,ccc_cty_online_script,0,0,00:00:00,0,00:00:00,0,0
2017-10-28-ccc_feedback_script,2017/10/28,ccc_feedback_script,0,0,00:00:00,0,00:00:00,0,0
2017-10-28-ccc_fpb_script,2017/10/28,ccc_fpb_script,6,2,00:00:04,4,00:00:05,4,8
2017-10-28-ccc_help_script,2017/10/28,ccc_help_script,13,13,00:00:30,30,00:01:43,0,390
2017-10-28-ccc_link_script,2017/10/28,ccc_link_script,0,0,00:00:00,0,00:00:00,0,0
2017-10-28-ccc_media_line_script,2017/10/28,ccc_media_line_script,0,0,00:00:00,0,00:00:00,0,0
2017-10-28-ccc_priority_script,2017/10/28,ccc_priority_script,28,28,00:00:08,8,00:01:17,0,224
2017-10-28-ccc_tax_script,2017/10/28,ccc_tax_script,0,0,00:00:00,0,00:00:00,0,0
2017-10-28-ccc_waste_recycling_script,2017/10/28,ccc_waste_recycling_script,0,0,00:00:00,0,00:00:00,0,0
2017-10-29-ccc_311_calgary_script,2017/10/29,ccc_311_calgary_script,836,828,00:00:13,13,00:03:49,8,10764
2017-10-29-ccc_311_lobby_ph_script,2017/10/29,ccc_311_lobby_ph_script,0,0,00:00:00,0,00:00:00,0,0
2017-10-29-ccc_aserv_info_script,2017/10/29,ccc_aserv_info_script,0,0,00:00:00,0,00:00:00,0,0
2017-10-29-ccc_bylaw_script,2017/10/29,ccc_bylaw_script,0,0,00:00:00,0,00:00:00,0,0
2017-10-29-ccc_city_script,2017/10/29,ccc_city_script,0,0,00:00:00,0,00:00:00,0,0
2017-10-29-ccc_cty_online_script,2017/10/29,ccc_cty_online_script,0,0,00:00:00,0,00:00:00,0,0
2017-10-29-ccc_feedback_script,2017/10/29,ccc_feedback_script,0,0,00:00:00,0,00:00:00,0,0
2017-10-29-ccc_fpb_script,2017/10/29,ccc_fpb_script,0,0,00:00:00,0,00:00:00,0,0
2017-10-29-ccc_help_script,2017/10/29,ccc_help_script,7,7,00:00:07,7,00:00:14,0,49
2017-10-29-ccc_link_script,2017/10/29,ccc_link_script,0,0,00:00:00,0,00:00:00,0,0
2017-10-29-ccc_media_line_script,2017/10/29,ccc_media_line_script,8,7,00:00:10,10,00:00:25,1,70
2017-10-29-ccc_priority_script,2017/10/29,ccc_priority_script,15,15,00:00:08,8,00:00:47,0,120
2017-10-29-ccc_tax_script,2017/10/29,ccc_tax_script,0,0,00:00:00,0,00:00:00,0,0
2017-10-29-ccc_waste_recycling_script,2017/10/29,ccc_waste_recycling_script,0,0,00:00:00,0,00:00:00,0,0
2017-10-30-ccc_waste_recycling_script,2017/10/30,ccc_waste_recycling_script,0,0,00:00:00,0,00:00:00,0,0
2017-10-30-ccc_311_calgary_script,2017/10/30,ccc_311_calgary_script,3168,2980,00:00:50,50,00:05:31,188,149000
2017-10-30-ccc_311_lobby_ph_script,2017/10/30,ccc_311_lobby_ph_script,0,0,00:00:00,0,00:00:00,0,0
2017-10-30-ccc_aserv_info_script,2017/10/30,ccc_aserv_info_script,0,0,00:00:00,0,00:00:00,0,0
2017-10-30-ccc_bylaw_script,2017/10/30,ccc_bylaw_script,0,0,00:00:00,0,00:00:00,0,0
2017-10-30-ccc_city_script,2017/10/30,ccc_city_script,9,8,00:00:12,12,00:00:22,1,96
2017-10-30-ccc_cty_online_script,2017/10/30,ccc_cty_online_script,0,0,00:00:00,0,00:00:00,0,0
2017-10-30-ccc_feedback_script,2017/10/30,ccc_feedback_script,1,0,00:00:00,0,00:00:00,0,0
2017-10-30-ccc_fpb_script,2017/10/30,ccc_fpb_script,1,0,00:00:00,0,00:00:00,1,0
2017-10-30-ccc_help_script,2017/10/30,ccc_help_script,3,3,00:00:09,9,00:00:11,0,27
2017-10-30-ccc_link_script,2017/10/30,ccc_link_script,0,0,00:00:00,0,00:00:00,0,0
2017-10-30-ccc_media_line_script,2017/10/30,ccc_media_line_script,1,1,00:00:23,23,00:00:23,0,23
2017-10-30-ccc_priority_script,2017/10/30,ccc_priority_script,33,32,00:00:08,8,00:00:30,1,256
2017-10-30-ccc_tax_script,2017/10/30,ccc_tax_script,20,19,00:00:42,42,00:02:37,1,798
2017-10-31-ccc_311_calgary_script,2017/10/31,ccc_311_calgary_script,2893,2717,00:00:50,50,00:05:16,176,135850
2017-10-31-ccc_311_lobby_ph_script,2017/10/31,ccc_311_lobby_ph_script,2,2,00:00:16,16,00:00:21,0,32
2017-10-31-ccc_aserv_info_script,2017/10/31,ccc_aserv_info_script,0,0,00:00:00,0,00:00:00,0,0
2017-10-31-ccc_bylaw_script,2017/10/31,ccc_bylaw_script,0,0,00:00:00,0,00:00:00,0,0
2017-10-31-ccc_city_script,2017/10/31,ccc_city_script,8,8,00:00:20,20,00:00:48,0,160
2017-10-31-ccc_cty_online_script,2017/10/31,ccc_cty_online_script,0,0,00:00:00,0,00:00:00,0,0
2017-10-31-ccc_feedback_script,2017/10/31,ccc_feedback_script,1,0,00:00:00,0,00:00:00,0,0
2017-10-31-ccc_fpb_script,2017/10/31,ccc_fpb_script,1,1,00:01:17,77,00:01:17,0,77
2017-10-31-ccc_help_script,2017/10/31,ccc_help_script,3,3,00:00:18,18,00:00:45,0,54
2017-10-31-ccc_link_script,2017/10/31,ccc_link_script,0,0,00:00:00,0,00:00:00,0,0
2017-10-31-ccc_media_line_script,2017/10/31,ccc_media_line_script,0,0,00:00:00,0,00:00:00,0,0
2017-10-31-ccc_priority_script,2017/10/31,ccc_priority_script,25,25,00:00:05,5,00:00:11,0,125
2017-10-31-ccc_tax_script,2017/10/31,ccc_tax_script,26,24,00:01:07,67,00:04:01,2,1608
2017-10-31-ccc_waste_recycling_script,2017/10/31,ccc_waste_recycling_script,0,0,00:00:00,0,00:00:00,0,0
2017-11-01-ccc_waste_recycling_script,2017/11/01,ccc_waste_recycling_script,0,0,00:00:00,0,00:00:00,0,0
2017-11-01-ccc_311_calgary_script,2017/11/01,ccc_311_calgary_script,2886,2732,00:00:41,41,00:10:30,154,112012
2017-11-01-ccc_311_lobby_ph_script,2017/11/01,ccc_311_lobby_ph_script,4,3,00:00:10,10,00:00:15,1,30
2017-11-01-ccc_aserv_info_script,2017/11/01,ccc_aserv_info_script,0,0,00:00:00,0,00:00:00,0,0
2017-11-01-ccc_bylaw_script,2017/11/01,ccc_bylaw_script,0,0,00:00:00,0,00:00:00,0,0
2017-11-01-ccc_city_script,2017/11/01,ccc_city_script,5,5,00:00:29,29,00:01:14,0,145
2017-11-01-ccc_cty_online_script,2017/11/01,ccc_cty_online_script,0,0,00:00:00,0,00:00:00,0,0
2017-11-01-ccc_feedback_script,2017/11/01,ccc_feedback_script,0,0,00:00:00,0,00:00:00,0,0
2017-11-01-ccc_fpb_script,2017/11/01,ccc_fpb_script,3,3,00:00:04,4,00:00:06,0,12
2017-11-01-ccc_help_script,2017/11/01,ccc_help_script,12,12,00:00:07,7,00:00:11,0,84
2017-11-01-ccc_link_script,2017/11/01,ccc_link_script,0,0,00:00:00,0,00:00:00,0,0
2017-11-01-ccc_media_line_script,2017/11/01,ccc_media_line_script,1,1,00:00:09,9,00:00:09,0,9
2017-11-01-ccc_priority_script,2017/11/01,ccc_priority_script,25,25,00:00:06,6,00:00:13,0,150
2017-11-01-ccc_tax_script,2017/11/01,ccc_tax_script,19,19,00:00:15,15,00:01:13,0,285
2017-11-02-ccc_311_calgary_script,2017/11/02,ccc_311_calgary_script,2720,2613,00:00:31,31,00:07:53,107,81003
2017-11-02-ccc_311_lobby_ph_script,2017/11/02,ccc_311_lobby_ph_script,2,2,00:00:04,4,00:00:04,0,8
2017-11-02-ccc_aserv_info_script,2017/11/02,ccc_aserv_info_script,0,0,00:00:00,0,00:00:00,0,0
2017-11-02-ccc_bylaw_script,2017/11/02,ccc_bylaw_script,0,0,00:00:00,0,00:00:00,0,0
2017-11-02-ccc_city_script,2017/11/02,ccc_city_script,10,10,00:00:12,12,00:00:28,0,120
2017-11-02-ccc_cty_online_script,2017/11/02,ccc_cty_online_script,0,0,00:00:00,0,00:00:00,0,0
2017-11-02-ccc_feedback_script,2017/11/02,ccc_feedback_script,0,0,00:00:00,0,00:00:00,0,0
2017-11-02-ccc_fpb_script,2017/11/02,ccc_fpb_script,0,0,00:00:00,0,00:00:00,0,0
2017-11-02-ccc_help_script,2017/11/02,ccc_help_script,28,24,00:00:13,13,00:01:09,4,312
2017-11-02-ccc_link_script,2017/11/02,ccc_link_script,0,0,00:00:00,0,00:00:00,0,0
2017-11-02-ccc_media_line_script,2017/11/02,ccc_media_line_script,0,0,00:00:00,0,00:00:00,0,0
2017-11-02-ccc_priority_script,2017/11/02,ccc_priority_script,37,34,00:00:06,6,00:00:15,2,204
2017-11-02-ccc_tax_script,2017/11/02,ccc_tax_script,20,20,00:00:05,5,00:00:11,0,100
2017-11-02-ccc_waste_recycling_script,2017/11/02,ccc_waste_recycling_script,0,0,00:00:00,0,00:00:00,0,0
2017-11-03-ccc_waste_recycling_script,2017/11/03,ccc_waste_recycling_script,0,0,00:00:00,0,00:00:00,0,0
2017-11-03-ccc_311_calgary_script,2017/11/03,ccc_311_calgary_script,2554,2452,00:00:30,30,00:06:02,102,73560
2017-11-03-ccc_311_lobby_ph_script,2017/11/03,ccc_311_lobby_ph_script,1,1,00:00:04,4,00:00:04,0,4
2017-11-03-ccc_aserv_info_script,2017/11/03,ccc_aserv_info_script,0,0,00:00:00,0,00:00:00,0,0
2017-11-03-ccc_bylaw_script,2017/11/03,ccc_bylaw_script,0,0,00:00:00,0,00:00:00,0,0
2017-11-03-ccc_city_script,2017/11/03,ccc_city_script,8,8,00:00:15,15,00:00:29,0,120
2017-11-03-ccc_cty_online_script,2017/11/03,ccc_cty_online_script,0,0,00:00:00,0,00:00:00,0,0
2017-11-03-ccc_feedback_script,2017/11/03,ccc_feedback_script,0,0,00:00:00,0,00:00:00,0,0
2017-11-03-ccc_fpb_script,2017/11/03,ccc_fpb_script,4,4,00:00:41,41,00:01:23,0,164
2017-11-03-ccc_help_script,2017/11/03,ccc_help_script,16,16,00:00:08,8,00:00:20,0,128
2017-11-03-ccc_link_script,2017/11/03,ccc_link_script,0,0,00:00:00,0,00:00:00,0,0
2017-11-03-ccc_media_line_script,2017/11/03,ccc_media_line_script,0,0,00:00:00,0,00:00:00,0,0
2017-11-03-ccc_priority_script,2017/11/03,ccc_priority_script,42,38,00:00:07,7,00:00:21,4,266
2017-11-03-ccc_tax_script,2017/11/03,ccc_tax_script,13,13,00:00:35,35,00:04:07,0,455
2017-11-04-ccc_311_calgary_script,2017/11/04,ccc_311_calgary_script,1050,1020,00:00:16,16,00:03:25,30,16320
2017-11-04-ccc_311_lobby_ph_script,2017/11/04,ccc_311_lobby_ph_script,0,0,00:00:00,0,00:00:00,0,0
2017-11-04-ccc_aserv_info_script,2017/11/04,ccc_aserv_info_script,0,0,00:00:00,0,00:00:00,0,0
2017-11-04-ccc_bylaw_script,2017/11/04,ccc_bylaw_script,0,0,00:00:00,0,00:00:00,0,0
2017-11-04-ccc_city_script,2017/11/04,ccc_city_script,0,0,00:00:00,0,00:00:00,0,0
2017-11-04-ccc_cty_online_script,2017/11/04,ccc_cty_online_script,0,0,00:00:00,0,00:00:00,0,0
2017-11-04-ccc_feedback_script,2017/11/04,ccc_feedback_script,0,0,00:00:00,0,00:00:00,0,0
2017-11-04-ccc_fpb_script,2017/11/04,ccc_fpb_script,3,3,00:00:36,36,00:01:24,0,108
2017-11-04-ccc_help_script,2017/11/04,ccc_help_script,2,2,00:00:07,7,00:00:07,0,14
2017-11-06-ccc_311_calgary_script,2017/11/06,ccc_311_calgary_script,2807,2713,00:00:26,26,00:07:29,94,70538
2017-11-06-ccc_311_lobby_ph_script,2017/11/06,ccc_311_lobby_ph_script,0,0,00:00:00,0,00:00:00,0,0
2017-11-06-ccc_aserv_info_script,2017/11/06,ccc_aserv_info_script,0,0,00:00:00,0,00:00:00,0,0
2017-11-06-ccc_bylaw_script,2017/11/06,ccc_bylaw_script,0,0,00:00:00,0,00:00:00,0,0
2017-11-06-ccc_city_script,2017/11/06,ccc_city_script,24,23,00:00:16,16,00:01:21,1,368
2017-11-06-ccc_cty_online_script,2017/11/06,ccc_cty_online_script,0,0,00:00:00,0,00:00:00,0,0
2017-11-06-ccc_feedback_script,2017/11/06,ccc_feedback_script,0,0,00:00:00,0,00:00:00,0,0
2017-11-06-ccc_fpb_script,2017/11/06,ccc_fpb_script,3,2,00:00:03,3,00:00:03,1,6
2017-11-06-ccc_help_script,2017/11/06,ccc_help_script,11,11,00:00:04,4,00:00:16,0,44
2017-11-06-ccc_link_script,2017/11/06,ccc_link_script,0,0,00:00:00,0,00:00:00,0,0
2017-11-06-ccc_media_line_script,2017/11/06,ccc_media_line_script,1,1,00:00:03,3,00:00:03,0,3
2017-11-06-ccc_priority_script,2017/11/06,ccc_priority_script,30,30,00:00:09,9,00:01:12,0,270
2017-11-06-ccc_tax_script,2017/11/06,ccc_tax_script,18,18,00:00:34,34,00:04:08,0,612
2017-11-04-ccc_link_script,2017/11/04,ccc_link_script,0,0,00:00:00,0,00:00:00,0,0
2017-11-04-ccc_media_line_script,2017/11/04,ccc_media_line_script,0,0,00:00:00,0,00:00:00,0,0
2017-11-04-ccc_priority_script,2017/11/04,ccc_priority_script,24,23,00:00:05,5,00:00:08,1,115
2017-11-04-ccc_tax_script,2017/11/04,ccc_tax_script,0,0,00:00:00,0,00:00:00,0,0
2017-11-04-ccc_waste_recycling_script,2017/11/04,ccc_waste_recycling_script,0,0,00:00:00,0,00:00:00,0,0
2017-11-05-ccc_311_calgary_script,2017/11/05,ccc_311_calgary_script,815,805,00:00:13,13,00:02:59,10,10465
2017-11-05-ccc_311_lobby_ph_script,2017/11/05,ccc_311_lobby_ph_script,0,0,00:00:00,0,00:00:00,0,0
2017-11-05-ccc_aserv_info_script,2017/11/05,ccc_aserv_info_script,0,0,00:00:00,0,00:00:00,0,0
2017-11-05-ccc_bylaw_script,2017/11/05,ccc_bylaw_script,0,0,00:00:00,0,00:00:00,0,0
2017-11-05-ccc_city_script,2017/11/05,ccc_city_script,0,0,00:00:00,0,00:00:00,0,0
2017-11-05-ccc_cty_online_script,2017/11/05,ccc_cty_online_script,0,0,00:00:00,0,00:00:00,0,0
2017-11-05-ccc_feedback_script,2017/11/05,ccc_feedback_script,0,0,00:00:00,0,00:00:00,0,0
2017-11-05-ccc_fpb_script,2017/11/05,ccc_fpb_script,2,2,00:00:12,12,00:00:16,0,24
2017-11-05-ccc_help_script,2017/11/05,ccc_help_script,6,6,00:00:07,7,00:00:11,0,42
2017-11-05-ccc_link_script,2017/11/05,ccc_link_script,0,0,00:00:00,0,00:00:00,0,0
2017-11-05-ccc_media_line_script,2017/11/05,ccc_media_line_script,0,0,00:00:00,0,00:00:00,0,0
2017-11-05-ccc_priority_script,2017/11/05,ccc_priority_script,10,10,00:00:05,5,00:00:08,0,50
2017-11-05-ccc_tax_script,2017/11/05,ccc_tax_script,0,0,00:00:00,0,00:00:00,0,0
2017-11-05-ccc_waste_recycling_script,2017/11/05,ccc_waste_recycling_script,0,0,00:00:00,0,00:00:00,0,0
2017-11-06-ccc_waste_recycling_script,2017/11/06,ccc_waste_recycling_script,0,0,00:00:00,0,00:00:00,0,0
20160711-ccc_311_lobby_ph_script,2016/07/11,ccc_311_lobby_ph_script,8,7,0:00:09,9,0:00:21,1,63
20160711-ccc_aserv_info_script,2016/07/11,ccc_aserv_info_script,0,0,0:00:00,0,0:00:00,0,0
20160711-ccc_bylaw_script,2016/07/11,ccc_bylaw_script,0,0,0:00:00,0,0:00:00,0,0
20160711-ccc_city_script,2016/07/11,ccc_city_script,33,31,0:00:29,29,0:03:59,2,899
20160711-ccc_cty_online_script,2016/07/11,ccc_cty_online_script,0,0,0:00:00,0,0:00:00,0,0
20160711-ccc_feedback_script,2016/07/11,ccc_feedback_script,0,0,0:00:00,0,0:00:00,0,0
20160711-ccc_fpb_script,2016/07/11,ccc_fpb_script,0,0,0:00:00,0,0:00:00,0,0
20160711-ccc_help_script,2016/07/11,ccc_help_script,12,12,0:00:07,7,0:00:37,0,84
20160711-ccc_link_script,2016/07/11,ccc_link_script,0,0,0:00:00,0,0:00:00,0,0
2017-11-07-ccc_311_calgary_script,2017/11/07,ccc_311_calgary_script,2832,2756,00:00:18,18,00:07:34,76,49608
2017-11-07-ccc_311_lobby_ph_script,2017/11/07,ccc_311_lobby_ph_script,2,1,00:00:10,10,00:00:10,1,10
2017-11-07-ccc_aserv_info_script,2017/11/07,ccc_aserv_info_script,0,0,00:00:00,0,00:00:00,0,0
2017-11-07-ccc_bylaw_script,2017/11/07,ccc_bylaw_script,0,0,00:00:00,0,00:00:00,0,0
2017-11-07-ccc_city_script,2017/11/07,ccc_city_script,18,18,00:00:11,11,00:00:31,0,198
2017-11-07-ccc_cty_online_script,2017/11/07,ccc_cty_online_script,0,0,00:00:00,0,00:00:00,0,0
2017-11-07-ccc_feedback_script,2017/11/07,ccc_feedback_script,0,0,00:00:00,0,00:00:00,0,0
2017-11-07-ccc_fpb_script,2017/11/07,ccc_fpb_script,5,5,00:00:04,4,00:00:10,0,20
2017-11-07-ccc_help_script,2017/11/07,ccc_help_script,15,15,00:00:06,6,00:00:15,0,90
2017-11-07-ccc_link_script,2017/11/07,ccc_link_script,0,0,00:00:00,0,00:00:00,0,0
2017-11-07-ccc_media_line_script,2017/11/07,ccc_media_line_script,0,0,00:00:00,0,00:00:00,0,0
2017-11-07-ccc_priority_script,2017/11/07,ccc_priority_script,23,22,00:00:05,5,00:00:14,1,110
2017-11-07-ccc_tax_script,2017/11/07,ccc_tax_script,16,16,00:00:27,27,00:03:32,0,432
2017-11-07-ccc_waste_recycling_script,2017/11/07,ccc_waste_recycling_script,0,0,00:00:00,0,00:00:00,0,0
20160713-ccc_311_calgary_script,2016/07/13,ccc_311_calgary_script,3416,3073,0:01:21,81,0:13:57,343,248913
20160713-ccc_311_lobby_ph_script,2016/07/13,ccc_311_lobby_ph_script,5,4,0:00:14,14,0:00:20,1,56
20160713-ccc_aserv_info_script,2016/07/13,ccc_aserv_info_script,0,0,0:00:00,0,0:00:00,0,0
20160713-ccc_bylaw_script,2016/07/13,ccc_bylaw_script,0,0,0:00:00,0,0:00:00,0,0
20160713-ccc_city_script,2016/07/13,ccc_city_script,18,15,0:00:13,13,0:00:48,3,195
2017-11-08-ccc_311_calgary_script,2017/11/08,ccc_311_calgary_script,2730,2668,00:00:21,21,00:06:13,62,56028
2017-11-08-ccc_311_lobby_ph_script,2017/11/08,ccc_311_lobby_ph_script,3,3,00:00:04,4,00:00:05,0,12
2017-11-08-ccc_aserv_info_script,2017/11/08,ccc_aserv_info_script,0,0,00:00:00,0,00:00:00,0,0
2017-11-08-ccc_bylaw_script,2017/11/08,ccc_bylaw_script,0,0,00:00:00,0,00:00:00,0,0
2017-11-08-ccc_city_script,2017/11/08,ccc_city_script,27,27,00:00:13,13,00:00:48,0,351
2017-11-08-ccc_cty_online_script,2017/11/08,ccc_cty_online_script,0,0,00:00:00,0,00:00:00,0,0
2017-11-08-ccc_feedback_script,2017/11/08,ccc_feedback_script,0,0,00:00:00,0,00:00:00,0,0
2017-11-08-ccc_fpb_script,2017/11/08,ccc_fpb_script,4,4,00:00:20,20,00:00:55,0,80
2017-11-08-ccc_help_script,2017/11/08,ccc_help_script,6,6,00:00:05,5,00:00:06,0,30
2017-11-08-ccc_link_script,2017/11/08,ccc_link_script,0,0,00:00:00,0,00:00:00,0,0
2017-11-08-ccc_media_line_script,2017/11/08,ccc_media_line_script,0,0,00:00:00,0,00:00:00,0,0
2017-11-08-ccc_priority_script,2017/11/08,ccc_priority_script,16,15,00:00:06,6,00:00:13,1,90
2017-11-08-ccc_tax_script,2017/11/08,ccc_tax_script,19,19,00:00:12,12,00:01:16,0,228
2017-11-08-ccc_waste_recycling_script,2017/11/08,ccc_waste_recycling_script,0,0,00:00:00,0,00:00:00,0,0
2017-11-09-ccc_311_calgary_script,2017/11/09,ccc_311_calgary_script,2708,2591,00:00:38,38,00:05:43,117,98458
2017-11-09-ccc_311_lobby_ph_script,2017/11/09,ccc_311_lobby_ph_script,0,0,00:00:00,0,00:00:00,0,0
2017-11-09-ccc_aserv_info_script,2017/11/09,ccc_aserv_info_script,0,0,00:00:00,0,00:00:00,0,0
2017-11-09-ccc_bylaw_script,2017/11/09,ccc_bylaw_script,0,0,00:00:00,0,00:00:00,0,0
2017-11-09-ccc_city_script,2017/11/09,ccc_city_script,22,21,00:00:28,28,00:02:09,1,588
2017-11-09-ccc_cty_online_script,2017/11/09,ccc_cty_online_script,0,0,00:00:00,0,00:00:00,0,0
2017-11-09-ccc_feedback_script,2017/11/09,ccc_feedback_script,0,0,00:00:00,0,00:00:00,0,0
2017-11-09-ccc_fpb_script,2017/11/09,ccc_fpb_script,4,3,00:01:37,97,00:02:51,1,291
2017-11-09-ccc_help_script,2017/11/09,ccc_help_script,16,16,00:00:13,13,00:01:00,0,208
2017-11-09-ccc_link_script,2017/11/09,ccc_link_script,0,0,00:00:00,0,00:00:00,0,0
2017-11-09-ccc_media_line_script,2017/11/09,ccc_media_line_script,1,1,00:00:05,5,00:00:05,0,5
2017-11-09-ccc_priority_script,2017/11/09,ccc_priority_script,32,32,00:00:06,6,00:00:29,0,192
2017-11-09-ccc_tax_script,2017/11/09,ccc_tax_script,21,20,00:00:40,40,00:03:39,1,800
2017-11-09-ccc_waste_recycling_script,2017/11/09,ccc_waste_recycling_script,0,0,00:00:00,0,00:00:00,0,0
2017-11-10-ccc_media_line_script,2017/11/10,ccc_media_line_script,0,0,00:00:00,0,00:00:00,0,0
2017-11-10-ccc_priority_script,2017/11/10,ccc_priority_script,38,36,00:00:08,8,00:00:47,2,288
2017-11-10-ccc_tax_script,2017/11/10,ccc_tax_script,19,18,00:00:40,40,00:03:36,1,720
2017-11-10-ccc_waste_recycling_script,2017/11/10,ccc_waste_recycling_script,0,0,00:00:00,0,00:00:00,0,0
2017-11-10-ccc_311_calgary_script,2017/11/10,ccc_311_calgary_script,2591,2489,00:00:30,30,00:05:31,102,74670
2017-11-10-ccc_311_lobby_ph_script,2017/11/10,ccc_311_lobby_ph_script,2,2,00:00:09,9,00:00:14,0,18
2017-11-10-ccc_aserv_info_script,2017/11/10,ccc_aserv_info_script,0,0,00:00:00,0,00:00:00,0,0
2017-11-10-ccc_bylaw_script,2017/11/10,ccc_bylaw_script,0,0,00:00:00,0,00:00:00,0,0
2017-11-10-ccc_city_script,2017/11/10,ccc_city_script,8,8,00:00:16,16,00:00:31,0,128
2017-11-10-ccc_cty_online_script,2017/11/10,ccc_cty_online_script,0,0,00:00:00,0,00:00:00,0,0
2017-11-10-ccc_feedback_script,2017/11/10,ccc_feedback_script,0,0,00:00:00,0,00:00:00,0,0
2017-11-10-ccc_fpb_script,2017/11/10,ccc_fpb_script,8,5,00:00:06,6,00:00:11,3,30
2017-11-10-ccc_help_script,2017/11/10,ccc_help_script,6,6,00:00:07,7,00:00:15,0,42
2017-11-10-ccc_link_script,2017/11/10,ccc_link_script,0,0,00:00:00,0,00:00:00,0,0
2017-11-11-ccc_311_calgary_script,2017/11/11,ccc_311_calgary_script,1194,1173,00:00:12,12,00:08:43,21,14076
2017-11-11-ccc_311_lobby_ph_script,2017/11/11,ccc_311_lobby_ph_script,0,0,00:00:00,0,00:00:00,0,0
2017-11-11-ccc_aserv_info_script,2017/11/11,ccc_aserv_info_script,0,0,00:00:00,0,00:00:00,0,0
2017-11-11-ccc_bylaw_script,2017/11/11,ccc_bylaw_script,0,0,00:00:00,0,00:00:00,0,0
2017-11-11-ccc_city_script,2017/11/11,ccc_city_script,0,0,00:00:00,0,00:00:00,0,0
2017-11-11-ccc_cty_online_script,2017/11/11,ccc_cty_online_script,0,0,00:00:00,0,00:00:00,0,0
2017-11-11-ccc_feedback_script,2017/11/11,ccc_feedback_script,0,0,00:00:00,0,00:00:00,0,0
2017-11-11-ccc_fpb_script,2017/11/11,ccc_fpb_script,2,2,00:00:03,3,00:00:03,0,6
2017-11-11-ccc_help_script,2017/11/11,ccc_help_script,11,11,00:00:11,11,00:01:03,0,121
2017-11-11-ccc_link_script,2017/11/11,ccc_link_script,0,0,00:00:00,0,00:00:00,0,0
2017-11-11-ccc_media_line_script,2017/11/11,ccc_media_line_script,0,0,00:00:00,0,00:00:00,0,0
2017-11-11-ccc_priority_script,2017/11/11,ccc_priority_script,12,11,00:00:06,6,00:00:14,1,66
2017-11-11-ccc_tax_script,2017/11/11,ccc_tax_script,0,0,00:00:00,0,00:00:00,0,0
2017-11-11-ccc_waste_recycling_script,2017/11/11,ccc_waste_recycling_script,0,0,00:00:00,0,00:00:00,0,0
2017-11-12-ccc_311_calgary_script,2017/11/12,ccc_311_calgary_script,904,803,00:01:15,75,00:16:45,101,60225
2017-11-12-ccc_311_lobby_ph_script,2017/11/12,ccc_311_lobby_ph_script,0,0,00:00:00,0,00:00:00,0,0
2017-11-12-ccc_aserv_info_script,2017/11/12,ccc_aserv_info_script,0,0,00:00:00,0,00:00:00,0,0
2017-11-12-ccc_bylaw_script,2017/11/12,ccc_bylaw_script,0,0,00:00:00,0,00:00:00,0,0
2017-11-12-ccc_city_script,2017/11/12,ccc_city_script,0,0,00:00:00,0,00:00:00,0,0
2017-11-12-ccc_cty_online_script,2017/11/12,ccc_cty_online_script,0,0,00:00:00,0,00:00:00,0,0
2017-11-12-ccc_feedback_script,2017/11/12,ccc_feedback_script,0,0,00:00:00,0,00:00:00,0,0
2017-11-12-ccc_fpb_script,2017/11/12,ccc_fpb_script,1,1,00:00:04,4,00:00:04,0,4
2017-11-12-ccc_help_script,2017/11/12,ccc_help_script,9,9,00:00:27,27,00:02:43,0,243
2017-11-12-ccc_link_script,2017/11/12,ccc_link_script,0,0,00:00:00,0,00:00:00,0,0
2017-11-12-ccc_media_line_script,2017/11/12,ccc_media_line_script,1,1,00:00:56,56,00:00:56,0,56
2017-11-12-ccc_priority_script,2017/11/12,ccc_priority_script,21,21,00:00:19,19,00:02:53,0,399
2017-11-12-ccc_tax_script,2017/11/12,ccc_tax_script,1,1,00:00:06,6,00:00:06,0,6
2017-11-12-ccc_waste_recycling_script,2017/11/12,ccc_waste_recycling_script,0,0,00:00:00,0,00:00:00,0,0
2017-11-13-ccc_311_calgary_script,2017/11/13,ccc_311_calgary_script,2600,2557,00:00:13,13,00:02:04,42,33241
2017-11-13-ccc_311_lobby_ph_script,2017/11/13,ccc_311_lobby_ph_script,2,1,00:00:10,10,00:00:10,1,10
2017-11-13-ccc_aserv_info_script,2017/11/13,ccc_aserv_info_script,0,0,00:00:00,0,00:00:00,0,0
2017-11-13-ccc_bylaw_script,2017/11/13,ccc_bylaw_script,0,0,00:00:00,0,00:00:00,0,0
2017-11-13-ccc_city_script,2017/11/13,ccc_city_script,9,9,00:00:13,13,00:00:42,0,117
2017-11-13-ccc_cty_online_script,2017/11/13,ccc_cty_online_script,0,0,00:00:00,0,00:00:00,0,0
2017-11-13-ccc_feedback_script,2017/11/13,ccc_feedback_script,0,0,00:00:00,0,00:00:00,0,0
2017-11-13-ccc_fpb_script,2017/11/13,ccc_fpb_script,1,1,00:00:02,2,00:00:02,0,2
2017-11-13-ccc_help_script,2017/11/13,ccc_help_script,3,3,00:00:05,5,00:00:09,0,15
2017-11-13-ccc_link_script,2017/11/13,ccc_link_script,0,0,00:00:00,0,00:00:00,0,0
2017-11-13-ccc_media_line_script,2017/11/13,ccc_media_line_script,1,1,00:00:01,1,00:00:01,0,1
2017-11-13-ccc_priority_script,2017/11/13,ccc_priority_script,17,17,00:00:07,7,00:00:18,0,119
2017-11-13-ccc_tax_script,2017/11/13,ccc_tax_script,4,4,00:00:20,20,00:00:47,0,80
2017-11-13-ccc_waste_recycling_script,2017/11/13,ccc_waste_recycling_script,0,0,00:00:00,0,00:00:00,0,0
2017-11-14-ccc_311_calgary_script,2017/11/14,ccc_311_calgary_script,2595,2514,00:00:27,27,00:03:58,81,67878
2017-11-14-ccc_311_lobby_ph_script,2017/11/14,ccc_311_lobby_ph_script,2,2,00:00:03,3,00:00:03,0,6
2017-11-14-ccc_aserv_info_script,2017/11/14,ccc_aserv_info_script,0,0,00:00:00,0,00:00:00,0,0
2017-11-14-ccc_bylaw_script,2017/11/14,ccc_bylaw_script,0,0,00:00:00,0,00:00:00,0,0
2017-11-14-ccc_city_script,2017/11/14,ccc_city_script,18,18,00:00:15,15,00:01:01,0,270
2017-11-14-ccc_cty_online_script,2017/11/14,ccc_cty_online_script,0,0,00:00:00,0,00:00:00,0,0
2017-11-14-ccc_feedback_script,2017/11/14,ccc_feedback_script,0,0,00:00:00,0,00:00:00,0,0
2017-11-14-ccc_fpb_script,2017/11/14,ccc_fpb_script,6,5,00:00:07,7,00:00:18,1,35
2017-11-14-ccc_help_script,2017/11/14,ccc_help_script,10,10,00:00:11,11,00:00:29,0,110
2017-11-14-ccc_link_script,2017/11/14,ccc_link_script,0,0,00:00:00,0,00:00:00,0,0
2017-11-14-ccc_media_line_script,2017/11/14,ccc_media_line_script,0,0,00:00:00,0,00:00:00,0,0
2017-11-14-ccc_priority_script,2017/11/14,ccc_priority_script,18,17,00:00:07,7,00:00:21,1,119
2017-11-14-ccc_tax_script,2017/11/14,ccc_tax_script,19,18,00:00:18,18,00:01:12,1,324
2017-11-14-ccc_waste_recycling_script,2017/11/14,ccc_waste_recycling_script,0,0,00:00:00,0,00:00:00,0,0
2017-11-15-ccc_311_calgary_script,2017/11/15,ccc_311_calgary_script,2555,2513,00:00:13,13,00:02:12,42,32669
2017-11-15-ccc_311_lobby_ph_script,2017/11/15,ccc_311_lobby_ph_script,0,0,00:00:00,0,00:00:00,0,0
2017-11-15-ccc_aserv_info_script,2017/11/15,ccc_aserv_info_script,0,0,00:00:00,0,00:00:00,0,0
2017-11-15-ccc_bylaw_script,2017/11/15,ccc_bylaw_script,0,0,00:00:00,0,00:00:00,0,0
2017-11-15-ccc_city_script,2017/11/15,ccc_city_script,17,17,00:00:08,8,00:00:12,0,136
2017-11-15-ccc_cty_online_script,2017/11/15,ccc_cty_online_script,0,0,00:00:00,0,00:00:00,0,0
2017-11-15-ccc_feedback_script,2017/11/15,ccc_feedback_script,0,0,00:00:00,0,00:00:00,0,0
2017-11-15-ccc_fpb_script,2017/11/15,ccc_fpb_script,3,3,00:00:07,7,00:00:09,0,21
2017-11-15-ccc_help_script,2017/11/15,ccc_help_script,7,7,00:00:10,10,00:00:21,0,70
2017-11-15-ccc_link_script,2017/11/15,ccc_link_script,0,0,00:00:00,0,00:00:00,0,0
2017-11-15-ccc_media_line_script,2017/11/15,ccc_media_line_script,0,0,00:00:00,0,00:00:00,0,0
2017-11-15-ccc_priority_script,2017/11/15,ccc_priority_script,24,24,00:00:07,7,00:00:14,0,168
2017-11-15-ccc_tax_script,2017/11/15,ccc_tax_script,26,26,00:00:11,11,00:01:15,0,286
2017-11-15-ccc_waste_recycling_script,2017/11/15,ccc_waste_recycling_script,0,0,00:00:00,0,00:00:00,0,0
2017-11-16-ccc_311_calgary_script,2017/11/16,ccc_311_calgary_script,2458,2403,00:00:13,13,00:04:31,55,31239
2017-11-16-ccc_311_lobby_ph_script,2017/11/16,ccc_311_lobby_ph_script,2,2,00:00:07,7,00:00:07,0,14
2017-11-16-ccc_aserv_info_script,2017/11/16,ccc_aserv_info_script,0,0,00:00:00,0,00:00:00,0,0
2017-11-16-ccc_bylaw_script,2017/11/16,ccc_bylaw_script,0,0,00:00:00,0,00:00:00,0,0
2017-11-16-ccc_city_script,2017/11/16,ccc_city_script,13,12,00:00:09,9,00:00:16,1,108
2017-11-16-ccc_cty_online_script,2017/11/16,ccc_cty_online_script,0,0,00:00:00,0,00:00:00,0,0
2017-11-16-ccc_feedback_script,2017/11/16,ccc_feedback_script,0,0,00:00:00,0,00:00:00,0,0
2017-11-16-ccc_fpb_script,2017/11/16,ccc_fpb_script,4,4,00:00:06,6,00:00:09,0,24
2017-11-16-ccc_help_script,2017/11/16,ccc_help_script,10,10,00:00:07,7,00:00:17,0,70
2017-11-16-ccc_link_script,2017/11/16,ccc_link_script,0,0,00:00:00,0,00:00:00,0,0
2017-11-16-ccc_media_line_script,2017/11/16,ccc_media_line_script,2,1,00:00:13,13,00:00:13,1,13
2017-11-16-ccc_priority_script,2017/11/16,ccc_priority_script,29,29,00:00:05,5,00:00:14,0,145
2017-11-16-ccc_tax_script,2017/11/16,ccc_tax_script,18,18,00:00:08,8,00:00:39,0,144
2017-11-16-ccc_waste_recycling_script,2017/11/16,ccc_waste_recycling_script,0,0,00:00:00,0,00:00:00,0,0
2017-11-17-ccc_311_calgary_script,2017/11/17,ccc_311_calgary_script,2407,2363,00:00:15,15,00:04:17,44,35445
2017-11-17-ccc_311_lobby_ph_script,2017/11/17,ccc_311_lobby_ph_script,3,2,00:00:06,6,00:00:09,1,12
2017-11-17-ccc_aserv_info_script,2017/11/17,ccc_aserv_info_script,0,0,00:00:00,0,00:00:00,0,0
2017-11-17-ccc_bylaw_script,2017/11/17,ccc_bylaw_script,0,0,00:00:00,0,00:00:00,0,0
2017-11-17-ccc_city_script,2017/11/17,ccc_city_script,14,13,00:00:10,10,00:00:22,1,130
2017-11-17-ccc_cty_online_script,2017/11/17,ccc_cty_online_script,0,0,00:00:00,0,00:00:00,0,0
2017-11-17-ccc_feedback_script,2017/11/17,ccc_feedback_script,0,0,00:00:00,0,00:00:00,0,0
2017-11-17-ccc_fpb_script,2017/11/17,ccc_fpb_script,3,3,00:00:06,6,00:00:15,0,18
2017-11-17-ccc_help_script,2017/11/17,ccc_help_script,11,11,00:00:08,8,00:00:17,0,88
2017-11-17-ccc_link_script,2017/11/17,ccc_link_script,0,0,00:00:00,0,00:00:00,0,0
2017-11-17-ccc_media_line_script,2017/11/17,ccc_media_line_script,0,0,00:00:00,0,00:00:00,0,0
2017-11-17-ccc_priority_script,2017/11/17,ccc_priority_script,21,21,00:00:06,6,00:00:19,0,126
2017-11-17-ccc_tax_script,2017/11/17,ccc_tax_script,22,22,00:00:06,6,00:00:42,0,132
2017-11-17-ccc_waste_recycling_script,2017/11/17,ccc_waste_recycling_script,0,0,00:00:00,0,00:00:00,0,0
2017-11-18-ccc_311_calgary_script,2017/11/18,ccc_311_calgary_script,947,924,00:00:16,16,00:05:17,23,14784
2017-11-18-ccc_311_lobby_ph_script,2017/11/18,ccc_311_lobby_ph_script,0,0,00:00:00,0,00:00:00,0,0
2017-11-18-ccc_aserv_info_script,2017/11/18,ccc_aserv_info_script,0,0,00:00:00,0,00:00:00,0,0
2017-11-18-ccc_bylaw_script,2017/11/18,ccc_bylaw_script,0,0,00:00:00,0,00:00:00,0,0
2017-11-18-ccc_city_script,2017/11/18,ccc_city_script,0,0,00:00:00,0,00:00:00,0,0
2017-11-18-ccc_cty_online_script,2017/11/18,ccc_cty_online_script,0,0,00:00:00,0,00:00:00,0,0
2017-11-18-ccc_feedback_script,2017/11/18,ccc_feedback_script,0,0,00:00:00,0,00:00:00,0,0
2017-11-18-ccc_fpb_script,2017/11/18,ccc_fpb_script,1,1,00:00:05,5,00:00:05,0,5
2017-11-18-ccc_help_script,2017/11/18,ccc_help_script,3,3,00:00:08,8,00:00:17,0,24
2017-11-18-ccc_link_script,2017/11/18,ccc_link_script,0,0,00:00:00,0,00:00:00,0,0
2017-11-18-ccc_media_line_script,2017/11/18,ccc_media_line_script,0,0,00:00:00,0,00:00:00,0,0
2017-11-18-ccc_priority_script,2017/11/18,ccc_priority_script,21,20,00:00:08,8,00:00:24,1,160
2017-11-18-ccc_tax_script,2017/11/18,ccc_tax_script,0,0,00:00:00,0,00:00:00,0,0
2017-11-18-ccc_waste_recycling_script,2017/11/18,ccc_waste_recycling_script,0,0,00:00:00,0,00:00:00,0,0
2017-11-19-ccc_help_script,2017/11/19,ccc_help_script,8,8,00:00:12,12,00:00:54,0,96
2017-11-19-ccc_link_script,2017/11/19,ccc_link_script,0,0,00:00:00,0,00:00:00,0,0
2017-11-19-ccc_media_line_script,2017/11/19,ccc_media_line_script,1,1,00:00:05,5,00:00:05,0,5
2017-11-19-ccc_priority_script,2017/11/19,ccc_priority_script,6,6,00:00:13,13,00:00:43,0,78
2017-11-19-ccc_tax_script,2017/11/19,ccc_tax_script,0,0,00:00:00,0,00:00:00,0,0
2017-11-19-ccc_waste_recycling_script,2017/11/19,ccc_waste_recycling_script,0,0,00:00:00,0,00:00:00,0,0
2017-11-19-ccc_311_calgary_script,2017/11/19,ccc_311_calgary_script,789,759,00:00:19,19,00:05:45,30,14421
2017-11-19-ccc_311_lobby_ph_script,2017/11/19,ccc_311_lobby_ph_script,0,0,00:00:00,0,00:00:00,0,0
2017-11-19-ccc_aserv_info_script,2017/11/19,ccc_aserv_info_script,0,0,00:00:00,0,00:00:00,0,0
2017-11-19-ccc_bylaw_script,2017/11/19,ccc_bylaw_script,0,0,00:00:00,0,00:00:00,0,0
2017-11-19-ccc_city_script,2017/11/19,ccc_city_script,0,0,00:00:00,0,00:00:00,0,0
2017-11-19-ccc_cty_online_script,2017/11/19,ccc_cty_online_script,0,0,00:00:00,0,00:00:00,0,0
2017-11-19-ccc_feedback_script,2017/11/19,ccc_feedback_script,0,0,00:00:00,0,00:00:00,0,0
2017-11-19-ccc_fpb_script,2017/11/19,ccc_fpb_script,2,1,00:00:03,3,00:00:03,1,3
2017-11-20-ccc_311_calgary_script,2017/11/20,ccc_311_calgary_script,2659,2628,00:00:12,12,00:04:40,31,31536
2017-11-20-ccc_311_lobby_ph_script,2017/11/20,ccc_311_lobby_ph_script,1,1,00:00:09,9,00:00:09,0,9
2017-11-20-ccc_aserv_info_script,2017/11/20,ccc_aserv_info_script,0,0,00:00:00,0,00:00:00,0,0
2017-11-20-ccc_bylaw_script,2017/11/20,ccc_bylaw_script,0,0,00:00:00,0,00:00:00,0,0
2017-11-20-ccc_city_script,2017/11/20,ccc_city_script,24,24,00:00:09,9,00:00:13,0,216
2017-11-20-ccc_cty_online_script,2017/11/20,ccc_cty_online_script,0,0,00:00:00,0,00:00:00,0,0
2017-11-20-ccc_feedback_script,2017/11/20,ccc_feedback_script,0,0,00:00:00,0,00:00:00,0,0
2017-11-20-ccc_fpb_script,2017/11/20,ccc_fpb_script,2,2,00:00:05,5,00:00:07,0,10
2017-11-20-ccc_help_script,2017/11/20,ccc_help_script,7,7,00:00:07,7,00:00:12,0,49
2017-11-20-ccc_link_script,2017/11/20,ccc_link_script,0,0,00:00:00,0,00:00:00,0,0
2017-11-20-ccc_media_line_script,2017/11/20,ccc_media_line_script,1,1,00:00:02,2,00:00:02,0,2
2017-11-20-ccc_priority_script,2017/11/20,ccc_priority_script,20,20,00:00:06,6,00:00:16,0,120
2017-11-20-ccc_tax_script,2017/11/20,ccc_tax_script,24,23,00:00:14,14,00:01:13,1,322
2017-11-20-ccc_waste_recycling_script,2017/11/20,ccc_waste_recycling_script,0,0,00:00:00,0,00:00:00,0,0
2017-11-21-ccc_311_calgary_script,2017/11/21,ccc_311_calgary_script,2440,2394,00:00:17,17,00:04:04,46,40698
2017-11-21-ccc_311_lobby_ph_script,2017/11/21,ccc_311_lobby_ph_script,3,3,00:00:04,4,00:00:05,0,12
2017-11-21-ccc_aserv_info_script,2017/11/21,ccc_aserv_info_script,0,0,00:00:00,0,00:00:00,0,0
2017-11-21-ccc_bylaw_script,2017/11/21,ccc_bylaw_script,0,0,00:00:00,0,00:00:00,0,0
2017-11-21-ccc_city_script,2017/11/21,ccc_city_script,18,17,00:00:14,14,00:00:43,1,238
2017-11-21-ccc_cty_online_script,2017/11/21,ccc_cty_online_script,0,0,00:00:00,0,00:00:00,0,0
2017-11-21-ccc_feedback_script,2017/11/21,ccc_feedback_script,0,0,00:00:00,0,00:00:00,0,0
2017-11-21-ccc_fpb_script,2017/11/21,ccc_fpb_script,1,1,00:00:35,35,00:00:35,0,35
2017-11-21-ccc_help_script,2017/11/21,ccc_help_script,8,8,00:00:06,6,00:00:11,0,48
2017-11-21-ccc_link_script,2017/11/21,ccc_link_script,0,0,00:00:00,0,00:00:00,0,0
2017-11-21-ccc_media_line_script,2017/11/21,ccc_media_line_script,0,0,00:00:00,0,00:00:00,0,0
2017-11-21-ccc_priority_script,2017/11/21,ccc_priority_script,26,25,00:00:06,6,00:00:13,1,150
2017-11-21-ccc_tax_script,2017/11/21,ccc_tax_script,15,15,00:00:11,11,00:01:02,0,165
2017-11-21-ccc_waste_recycling_script,2017/11/21,ccc_waste_recycling_script,0,0,00:00:00,0,00:00:00,0,0
20160812-ccc_fpb_script,2016/08/12,ccc_fpb_script,4,2,0:02:39,159,0:03:45,2,318
20160812-ccc_help_script,2016/08/12,ccc_help_script,16,15,0:00:19,19,0:03:00,1,285
20160812-ccc_link_script,2016/08/12,ccc_link_script,0,0,0:00:00,0,0:00:00,0,0
20160812-ccc_media_line_script,2016/08/12,ccc_media_line_script,1,1,0:00:02,2,0:00:02,0,2
20160812-ccc_priority_script,2016/08/12,ccc_priority_script,35,32,0:00:19,19,0:01:07,3,608
20160812-ccc_tax_script,2016/08/12,ccc_tax_script,14,12,0:03:56,236,0:07:30,2,2832
20160812-ccc_waste_recycling_script,2016/08/12,ccc_waste_recycling_script,0,0,0:00:00,0,0:00:00,0,0
20160813-ccc_311_calgary_script,2016/08/13,ccc_311_calgary_script,1360,1170,0:01:50,110,0:10:22,190,128700
20160813-ccc_311_lobby_ph_script,2016/08/13,ccc_311_lobby_ph_script,0,0,0:00:00,0,0:00:00,0,0
20160813-ccc_aserv_info_script,2016/08/13,ccc_aserv_info_script,0,0,0:00:00,0,0:00:00,0,0
20160813-ccc_bylaw_script,2016/08/13,ccc_bylaw_script,0,0,0:00:00,0,0:00:00,0,0
20160813-ccc_city_script,2016/08/13,ccc_city_script,0,0,0:00:00,0,0:00:00,0,0
20160813-ccc_cty_online_script,2016/08/13,ccc_cty_online_script,0,0,0:00:00,0,0:00:00,0,0
20160813-ccc_feedback_script,2016/08/13,ccc_feedback_script,0,0,0:00:00,0,0:00:00,0,0
20160813-ccc_fpb_script,2016/08/13,ccc_fpb_script,0,0,0:00:00,0,0:00:00,0,0
2017-11-22-ccc_311_calgary_script,2017/11/22,ccc_311_calgary_script,2776,2580,00:00:57,57,00:08:17,196,147060
2017-11-22-ccc_311_lobby_ph_script,2017/11/22,ccc_311_lobby_ph_script,1,1,00:00:14,14,00:00:14,0,14
2017-11-22-ccc_aserv_info_script,2017/11/22,ccc_aserv_info_script,0,0,00:00:00,0,00:00:00,0,0
2017-11-22-ccc_bylaw_script,2017/11/22,ccc_bylaw_script,0,0,00:00:00,0,00:00:00,0,0
2017-11-22-ccc_city_script,2017/11/22,ccc_city_script,11,11,00:00:13,13,00:00:24,0,143
2017-11-22-ccc_cty_online_script,2017/11/22,ccc_cty_online_script,0,0,00:00:00,0,00:00:00,0,0
2017-11-22-ccc_feedback_script,2017/11/22,ccc_feedback_script,0,0,00:00:00,0,00:00:00,0,0
2017-11-22-ccc_fpb_script,2017/11/22,ccc_fpb_script,7,5,00:00:13,13,00:00:48,2,65
2017-11-22-ccc_help_script,2017/11/22,ccc_help_script,19,17,00:00:09,9,00:00:18,2,153
2017-11-22-ccc_link_script,2017/11/22,ccc_link_script,0,0,00:00:00,0,00:00:00,0,0
2017-11-22-ccc_media_line_script,2017/11/22,ccc_media_line_script,0,0,00:00:00,0,00:00:00,0,0
2017-11-22-ccc_priority_script,2017/11/22,ccc_priority_script,28,28,00:00:07,7,00:00:30,0,196
2017-11-22-ccc_tax_script,2017/11/22,ccc_tax_script,17,14,00:00:10,10,00:00:22,3,140
2017-11-22-ccc_waste_recycling_script,2017/11/22,ccc_waste_recycling_script,0,0,00:00:00,0,00:00:00,0,0
2017-11-23-ccc_311_calgary_script,2017/11/23,ccc_311_calgary_script,2574,2502,00:00:25,25,00:03:58,72,62550
2017-11-23-ccc_311_lobby_ph_script,2017/11/23,ccc_311_lobby_ph_script,2,2,00:00:05,5,00:00:06,0,10
2017-11-23-ccc_aserv_info_script,2017/11/23,ccc_aserv_info_script,0,0,00:00:00,0,00:00:00,0,0
2017-11-23-ccc_bylaw_script,2017/11/23,ccc_bylaw_script,0,0,00:00:00,0,00:00:00,0,0
2017-11-23-ccc_city_script,2017/11/23,ccc_city_script,11,11,00:00:11,11,00:00:24,0,121
2017-11-23-ccc_cty_online_script,2017/11/23,ccc_cty_online_script,0,0,00:00:00,0,00:00:00,0,0
2017-11-23-ccc_feedback_script,2017/11/23,ccc_feedback_script,0,0,00:00:00,0,00:00:00,0,0
2017-11-23-ccc_fpb_script,2017/11/23,ccc_fpb_script,1,1,00:00:05,5,00:00:05,0,5
2017-11-23-ccc_help_script,2017/11/23,ccc_help_script,10,10,00:00:04,4,00:00:05,0,40
2017-11-23-ccc_link_script,2017/11/23,ccc_link_script,0,0,00:00:00,0,00:00:00,0,0
2017-11-23-ccc_media_line_script,2017/11/23,ccc_media_line_script,8,8,00:00:09,9,00:00:33,0,72
2017-11-23-ccc_priority_script,2017/11/23,ccc_priority_script,17,17,00:00:08,8,00:00:32,0,136
2017-11-23-ccc_tax_script,2017/11/23,ccc_tax_script,25,24,00:00:20,20,00:02:37,1,480
2017-11-23-ccc_waste_recycling_script,2017/11/23,ccc_waste_recycling_script,0,0,00:00:00,0,00:00:00,0,0
20160814-ccc_311_calgary_script,2016/08/14,ccc_311_calgary_script,1085,1016,0:00:54,54,0:11:37,69,54864
20160814-ccc_311_lobby_ph_script,2016/08/14,ccc_311_lobby_ph_script,0,0,0:00:00,0,0:00:00,0,0
20160814-ccc_aserv_info_script,2016/08/14,ccc_aserv_info_script,0,0,0:00:00,0,0:00:00,0,0
20160814-ccc_bylaw_script,2016/08/14,ccc_bylaw_script,0,0,0:00:00,0,0:00:00,0,0
20160814-ccc_city_script,2016/08/14,ccc_city_script,0,0,0:00:00,0,0:00:00,0,0
2017-11-24-ccc_311_calgary_script,2017/11/24,ccc_311_calgary_script,2438,2358,00:00:27,27,00:06:29,80,63666
2017-11-24-ccc_311_lobby_ph_script,2017/11/24,ccc_311_lobby_ph_script,2,2,00:00:05,5,00:00:08,0,10
2017-11-24-ccc_aserv_info_script,2017/11/24,ccc_aserv_info_script,0,0,00:00:00,0,00:00:00,0,0
2017-11-24-ccc_bylaw_script,2017/11/24,ccc_bylaw_script,0,0,00:00:00,0,00:00:00,0,0
2017-11-24-ccc_city_script,2017/11/24,ccc_city_script,15,13,00:00:13,13,00:00:32,2,169
2017-11-24-ccc_cty_online_script,2017/11/24,ccc_cty_online_script,0,0,00:00:00,0,00:00:00,0,0
2017-11-24-ccc_feedback_script,2017/11/24,ccc_feedback_script,0,0,00:00:00,0,00:00:00,0,0
2017-11-24-ccc_fpb_script,2017/11/24,ccc_fpb_script,2,2,00:00:23,23,00:00:41,0,46
2017-11-24-ccc_help_script,2017/11/24,ccc_help_script,17,17,00:00:09,9,00:00:25,0,153
2017-11-24-ccc_link_script,2017/11/24,ccc_link_script,0,0,00:00:00,0,00:00:00,0,0
2017-11-24-ccc_media_line_script,2017/11/24,ccc_media_line_script,1,1,00:00:11,11,00:00:11,0,11
2017-11-24-ccc_priority_script,2017/11/24,ccc_priority_script,14,14,00:00:05,5,00:00:11,0,70
2017-11-24-ccc_tax_script,2017/11/24,ccc_tax_script,16,16,00:00:21,21,00:01:50,0,336
2017-11-24-ccc_waste_recycling_script,2017/11/24,ccc_waste_recycling_script,0,0,00:00:00,0,00:00:00,0,0
2017-11-26-ccc_311_calgary_script,2017/11/26,ccc_311_calgary_script,777,766,00:00:12,12,00:02:48,11,9192
2017-11-26-ccc_311_lobby_ph_script,2017/11/26,ccc_311_lobby_ph_script,0,0,00:00:00,0,00:00:00,0,0
2017-11-26-ccc_aserv_info_script,2017/11/26,ccc_aserv_info_script,0,0,00:00:00,0,00:00:00,0,0
2017-11-26-ccc_bylaw_script,2017/11/26,ccc_bylaw_script,0,0,00:00:00,0,00:00:00,0,0
2017-11-26-ccc_city_script,2017/11/26,ccc_city_script,0,0,00:00:00,0,00:00:00,0,0
2017-11-26-ccc_cty_online_script,2017/11/26,ccc_cty_online_script,0,0,00:00:00,0,00:00:00,0,0
2017-11-26-ccc_feedback_script,2017/11/26,ccc_feedback_script,0,0,00:00:00,0,00:00:00,0,0
2017-11-26-ccc_fpb_script,2017/11/26,ccc_fpb_script,1,1,00:00:05,5,00:00:05,0,5
2017-11-26-ccc_help_script,2017/11/26,ccc_help_script,3,2,00:00:09,9,00:00:09,1,18
2017-11-26-ccc_link_script,2017/11/26,ccc_link_script,0,0,00:00:00,0,00:00:00,0,0
2017-11-26-ccc_media_line_script,2017/11/26,ccc_media_line_script,0,0,00:00:00,0,00:00:00,0,0
2017-11-26-ccc_priority_script,2017/11/26,ccc_priority_script,9,9,00:00:04,4,00:00:08,0,36
2017-11-26-ccc_tax_script,2017/11/26,ccc_tax_script,0,0,00:00:00,0,00:00:00,0,0
2017-11-26-ccc_waste_recycling_script,2017/11/26,ccc_waste_recycling_script,0,0,00:00:00,0,00:00:00,0,0
2017-11-27-ccc_311_calgary_script,2017/11/27,ccc_311_calgary_script,2954,2725,00:01:15,75,00:06:18,229,204375
2017-11-27-ccc_311_lobby_ph_script,2017/11/27,ccc_311_lobby_ph_script,1,1,00:00:05,5,00:00:05,0,5
2017-11-27-ccc_aserv_info_script,2017/11/27,ccc_aserv_info_script,0,0,00:00:00,0,00:00:00,0,0
2017-11-27-ccc_bylaw_script,2017/11/27,ccc_bylaw_script,0,0,00:00:00,0,00:00:00,0,0
2017-11-27-ccc_city_script,2017/11/27,ccc_city_script,21,19,00:00:33,33,00:04:58,2,627
2017-11-27-ccc_cty_online_script,2017/11/27,ccc_cty_online_script,0,0,00:00:00,0,00:00:00,0,0
2017-11-27-ccc_feedback_script,2017/11/27,ccc_feedback_script,0,0,00:00:00,0,00:00:00,0,0
2017-11-27-ccc_fpb_script,2017/11/27,ccc_fpb_script,6,4,00:02:20,140,00:03:59,2,560
2017-11-27-ccc_help_script,2017/11/27,ccc_help_script,8,7,00:00:10,10,00:00:23,1,70
2017-11-27-ccc_link_script,2017/11/27,ccc_link_script,0,0,00:00:00,0,00:00:00,0,0
2017-11-27-ccc_media_line_script,2017/11/27,ccc_media_line_script,1,1,00:00:03,3,00:00:03,0,3
2017-11-27-ccc_priority_script,2017/11/27,ccc_priority_script,32,31,00:00:07,7,00:00:29,1,217
2017-11-27-ccc_tax_script,2017/11/27,ccc_tax_script,16,15,00:01:51,111,00:05:47,1,1665
2017-11-27-ccc_waste_recycling_script,2017/11/27,ccc_waste_recycling_script,0,0,00:00:00,0,00:00:00,0,0
2017-11-28-ccc_311_calgary_script,2017/11/28,ccc_311_calgary_script,2641,2565,00:00:24,24,00:03:42,76,61560
2017-11-28-ccc_311_lobby_ph_script,2017/11/28,ccc_311_lobby_ph_script,1,1,00:00:08,8,00:00:08,0,8
2017-11-28-ccc_aserv_info_script,2017/11/28,ccc_aserv_info_script,0,0,00:00:00,0,00:00:00,0,0
2017-11-28-ccc_bylaw_script,2017/11/28,ccc_bylaw_script,0,0,00:00:00,0,00:00:00,0,0
2017-11-28-ccc_city_script,2017/11/28,ccc_city_script,23,22,00:00:13,13,00:00:29,1,286
2017-11-28-ccc_cty_online_script,2017/11/28,ccc_cty_online_script,0,0,00:00:00,0,00:00:00,0,0
2017-11-28-ccc_feedback_script,2017/11/28,ccc_feedback_script,0,0,00:00:00,0,00:00:00,0,0
2017-11-28-ccc_fpb_script,2017/11/28,ccc_fpb_script,3,3,00:00:25,25,00:01:04,0,75
2017-11-28-ccc_help_script,2017/11/28,ccc_help_script,14,14,00:00:07,7,00:00:25,0,98
2017-11-28-ccc_link_script,2017/11/28,ccc_link_script,0,0,00:00:00,0,00:00:00,0,0
2017-11-28-ccc_media_line_script,2017/11/28,ccc_media_line_script,0,0,00:00:00,0,00:00:00,0,0
2017-11-28-ccc_priority_script,2017/11/28,ccc_priority_script,21,20,00:00:08,8,00:00:38,1,160
2017-11-28-ccc_tax_script,2017/11/28,ccc_tax_script,32,32,00:00:16,16,00:02:11,0,512
2017-11-28-ccc_waste_recycling_script,2017/11/28,ccc_waste_recycling_script,0,0,00:00:00,0,00:00:00,0,0
2017-11-29-ccc_311_calgary_script,2017/11/29,ccc_311_calgary_script,2721,2559,00:00:52,52,00:10:27,162,133068
2017-11-29-ccc_311_lobby_ph_script,2017/11/29,ccc_311_lobby_ph_script,0,0,00:00:00,0,00:00:00,0,0
2017-11-29-ccc_aserv_info_script,2017/11/29,ccc_aserv_info_script,0,0,00:00:00,0,00:00:00,0,0
2017-11-29-ccc_bylaw_script,2017/11/29,ccc_bylaw_script,0,0,00:00:00,0,00:00:00,0,0
2017-11-29-ccc_city_script,2017/11/29,ccc_city_script,13,13,00:00:19,19,00:02:07,0,247
2017-11-29-ccc_cty_online_script,2017/11/29,ccc_cty_online_script,0,0,00:00:00,0,00:00:00,0,0
2017-11-29-ccc_feedback_script,2017/11/29,ccc_feedback_script,0,0,00:00:00,0,00:00:00,0,0
2017-11-29-ccc_fpb_script,2017/11/29,ccc_fpb_script,1,0,00:00:00,0,00:00:00,1,0
2017-11-29-ccc_help_script,2017/11/29,ccc_help_script,18,18,00:00:17,17,00:01:17,0,306
2017-11-29-ccc_link_script,2017/11/29,ccc_link_script,0,0,00:00:00,0,00:00:00,0,0
2017-11-29-ccc_media_line_script,2017/11/29,ccc_media_line_script,0,0,00:00:00,0,00:00:00,0,0
2017-11-29-ccc_priority_script,2017/11/29,ccc_priority_script,21,21,00:00:09,9,00:00:25,0,189
2017-11-29-ccc_tax_script,2017/11/29,ccc_tax_script,22,21,00:01:13,73,00:04:33,1,1533
2017-11-29-ccc_waste_recycling_script,2017/11/29,ccc_waste_recycling_script,0,0,00:00:00,0,00:00:00,0,0
2017-11-30-ccc_311_calgary_script,2017/11/30,ccc_311_calgary_script,2802,2623,00:00:53,53,00:05:49,179,139019
2017-11-30-ccc_311_lobby_ph_script,2017/11/30,ccc_311_lobby_ph_script,0,0,00:00:00,0,00:00:00,0,0
2017-11-30-ccc_aserv_info_script,2017/11/30,ccc_aserv_info_script,0,0,00:00:00,0,00:00:00,0,0
2017-11-30-ccc_bylaw_script,2017/11/30,ccc_bylaw_script,0,0,00:00:00,0,00:00:00,0,0
2017-11-30-ccc_city_script,2017/11/30,ccc_city_script,16,16,00:00:14,14,00:00:44,0,224
2017-11-30-ccc_cty_online_script,2017/11/30,ccc_cty_online_script,0,0,00:00:00,0,00:00:00,0,0
2017-11-30-ccc_feedback_script,2017/11/30,ccc_feedback_script,0,0,00:00:00,0,00:00:00,0,0
2017-11-30-ccc_fpb_script,2017/11/30,ccc_fpb_script,5,3,00:00:10,10,00:00:17,2,30
2017-11-30-ccc_help_script,2017/11/30,ccc_help_script,16,13,00:00:16,16,00:01:14,3,208
2017-11-30-ccc_link_script,2017/11/30,ccc_link_script,0,0,00:00:00,0,00:00:00,0,0
2017-11-30-ccc_media_line_script,2017/11/30,ccc_media_line_script,2,1,00:00:06,6,00:00:06,1,6
2017-11-30-ccc_priority_script,2017/11/30,ccc_priority_script,22,22,00:00:09,9,00:00:28,0,198
2017-11-30-ccc_tax_script,2017/11/30,ccc_tax_script,24,21,00:00:29,29,00:03:20,3,609
2017-11-30-ccc_waste_recycling_script,2017/11/30,ccc_waste_recycling_script,0,0,00:00:00,0,00:00:00,0,0
2017-12-01-ccc_311_calgary_script,2017/12/01,ccc_311_calgary_script,2741,2563,00:01:00,60,00:07:15,178,153780
2017-12-01-ccc_311_lobby_ph_script,2017/12/01,ccc_311_lobby_ph_script,2,2,00:00:19,19,00:00:32,0,38
2017-12-01-ccc_aserv_info_script,2017/12/01,ccc_aserv_info_script,0,0,00:00:00,0,00:00:00,0,0
2017-12-01-ccc_bylaw_script,2017/12/01,ccc_bylaw_script,0,0,00:00:00,0,00:00:00,0,0
2017-12-01-ccc_city_script,2017/12/01,ccc_city_script,9,9,00:00:18,18,00:00:51,0,162
2017-12-01-ccc_cty_online_script,2017/12/01,ccc_cty_online_script,0,0,00:00:00,0,00:00:00,0,0
2017-12-01-ccc_feedback_script,2017/12/01,ccc_feedback_script,0,0,00:00:00,0,00:00:00,0,0
2017-12-01-ccc_fpb_script,2017/12/01,ccc_fpb_script,4,3,00:00:21,21,00:00:55,1,63
2017-12-01-ccc_help_script,2017/12/01,ccc_help_script,20,20,00:00:11,11,00:00:44,0,220
2017-12-01-ccc_link_script,2017/12/01,ccc_link_script,0,0,00:00:00,0,00:00:00,0,0
2017-12-01-ccc_media_line_script,2017/12/01,ccc_media_line_script,0,0,00:00:00,0,00:00:00,0,0
2017-12-01-ccc_priority_script,2017/12/01,ccc_priority_script,15,15,00:00:12,12,00:00:55,0,180
2017-12-01-ccc_tax_script,2017/12/01,ccc_tax_script,31,30,00:01:15,75,00:05:21,1,2250
2017-12-01-ccc_waste_recycling_script,2017/12/01,ccc_waste_recycling_script,0,0,00:00:00,0,00:00:00,0,0
2017-12-02-ccc_311_calgary_script,2017/12/02,ccc_311_calgary_script,1009,975,00:00:20,20,00:04:02,34,19500
2017-12-02-ccc_311_lobby_ph_script,2017/12/02,ccc_311_lobby_ph_script,0,0,00:00:00,0,00:00:00,0,0
2017-12-02-ccc_aserv_info_script,2017/12/02,ccc_aserv_info_script,0,0,00:00:00,0,00:00:00,0,0
2017-12-02-ccc_bylaw_script,2017/12/02,ccc_bylaw_script,0,0,00:00:00,0,00:00:00,0,0
2017-12-02-ccc_city_script,2017/12/02,ccc_city_script,0,0,00:00:00,0,00:00:00,0,0
2017-12-02-ccc_cty_online_script,2017/12/02,ccc_cty_online_script,0,0,00:00:00,0,00:00:00,0,0
2017-12-02-ccc_feedback_script,2017/12/02,ccc_feedback_script,0,0,00:00:00,0,00:00:00,0,0
2017-12-02-ccc_fpb_script,2017/12/02,ccc_fpb_script,0,0,00:00:00,0,00:00:00,0,0
2017-12-02-ccc_help_script,2017/12/02,ccc_help_script,8,8,00:00:17,17,00:01:00,0,136
2017-12-02-ccc_link_script,2017/12/02,ccc_link_script,0,0,00:00:00,0,00:00:00,0,0
2017-12-02-ccc_media_line_script,2017/12/02,ccc_media_line_script,0,0,00:00:00,0,00:00:00,0,0
2017-12-02-ccc_priority_script,2017/12/02,ccc_priority_script,21,21,00:00:05,5,00:00:32,0,105
2017-12-02-ccc_tax_script,2017/12/02,ccc_tax_script,1,1,00:01:43,103,00:01:43,0,103
2017-12-02-ccc_waste_recycling_script,2017/12/02,ccc_waste_recycling_script,0,0,00:00:00,0,00:00:00,0,0
2017-12-03-ccc_311_calgary_script,2017/12/03,ccc_311_calgary_script,701,683,00:00:13,13,00:02:25,18,8879
2017-12-03-ccc_311_lobby_ph_script,2017/12/03,ccc_311_lobby_ph_script,0,0,00:00:00,0,00:00:00,0,0
2017-12-03-ccc_aserv_info_script,2017/12/03,ccc_aserv_info_script,0,0,00:00:00,0,00:00:00,0,0
2017-12-03-ccc_bylaw_script,2017/12/03,ccc_bylaw_script,0,0,00:00:00,0,00:00:00,0,0
2017-12-03-ccc_city_script,2017/12/03,ccc_city_script,0,0,00:00:00,0,00:00:00,0,0
2017-12-03-ccc_cty_online_script,2017/12/03,ccc_cty_online_script,0,0,00:00:00,0,00:00:00,0,0
2017-12-03-ccc_feedback_script,2017/12/03,ccc_feedback_script,0,0,00:00:00,0,00:00:00,0,0
2017-12-03-ccc_fpb_script,2017/12/03,ccc_fpb_script,9,2,00:00:03,3,00:00:04,7,6
2017-12-03-ccc_help_script,2017/12/03,ccc_help_script,4,3,00:00:10,10,00:00:17,1,30
2017-12-03-ccc_link_script,2017/12/03,ccc_link_script,0,0,00:00:00,0,00:00:00,0,0
2017-12-03-ccc_media_line_script,2017/12/03,ccc_media_line_script,0,0,00:00:00,0,00:00:00,0,0
2017-12-03-ccc_priority_script,2017/12/03,ccc_priority_script,11,11,00:00:06,6,00:00:25,0,66
2017-12-03-ccc_tax_script,2017/12/03,ccc_tax_script,0,0,00:00:00,0,00:00:00,0,0
2017-12-03-ccc_waste_recycling_script,2017/12/03,ccc_waste_recycling_script,0,0,00:00:00,0,00:00:00,0,0
20161024-ccc_311_lobby_ph_script,2016/10/24,ccc_311_lobby_ph_script,2,2,0:00:23,23,0:00:23,0,46
20161024-ccc_aserv_info_script,2016/10/24,ccc_aserv_info_script,0,0,0:00:00,0,0:00:00,0,0
20161024-ccc_bylaw_script,2016/10/24,ccc_bylaw_script,0,0,0:00:00,0,0:00:00,0,0
20161024-ccc_city_script,2016/10/24,ccc_city_script,30,30,0:00:43,43,0:06:07,0,1290
20161024-ccc_cty_online_script,2016/10/24,ccc_cty_online_script,0,0,0:00:00,0,0:00:00,0,0
20161024-ccc_feedback_script,2016/10/24,ccc_feedback_script,0,0,0:00:00,0,0:00:00,0,0
20161024-ccc_fpb_script,2016/10/24,ccc_fpb_script,0,0,0:00:00,0,0:00:00,0,0
20161024-ccc_help_script,2016/10/24,ccc_help_script,11,11,0:00:09,9,0:00:54,0,99
20161024-ccc_link_script,2016/10/24,ccc_link_script,0,0,0:00:00,0,0:00:00,0,0
20161026-ccc_311_calgary_script,2016/10/26,ccc_311_calgary_script,2685,2548,0:00:43,43,0:08:13,137,109564
20161026-ccc_311_lobby_ph_script,2016/10/26,ccc_311_lobby_ph_script,5,3,0:00:08,8,0:00:16,2,24
20161026-ccc_aserv_info_script,2016/10/26,ccc_aserv_info_script,0,0,0:00:00,0,0:00:00,0,0
20161026-ccc_bylaw_script,2016/10/26,ccc_bylaw_script,0,0,0:00:00,0,0:00:00,0,0
20161026-ccc_city_script,2016/10/26,ccc_city_script,19,18,0:00:10,10,0:00:26,1,180
20161026-ccc_cty_online_script,2016/10/26,ccc_cty_online_script,0,0,0:00:00,0,0:00:00,0,0
20161026-ccc_feedback_script,2016/10/26,ccc_feedback_script,0,0,0:00:00,0,0:00:00,0,0
20161026-ccc_fpb_script,2016/10/26,ccc_fpb_script,1,1,0:00:02,2,0:00:02,0,2
20161026-ccc_help_script,2016/10/26,ccc_help_script,8,7,0:00:15,15,0:00:46,1,105
20161026-ccc_link_script,2016/10/26,ccc_link_script,0,0,0:00:00,0,0:00:00,0,0
20161118-ccc_tax_script,2016/11/18,ccc_tax_script,20,19,0:00:14,14,0:01:13,1,266
20161118-ccc_waste_recycling_script,2016/11/18,ccc_waste_recycling_script,0,0,0:00:00,0,0:00:00,0,0
20161119-ccc_311_calgary_script,2016/11/19,ccc_311_calgary_script,944,930,0:00:10,10,0:03:34,14,9300
20161119-ccc_311_lobby_ph_script,2016/11/19,ccc_311_lobby_ph_script,0,0,0:00:00,0,0:00:00,0,0
20161119-ccc_aserv_info_script,2016/11/19,ccc_aserv_info_script,0,0,0:00:00,0,0:00:00,0,0
20161119-ccc_bylaw_script,2016/11/19,ccc_bylaw_script,0,0,0:00:00,0,0:00:00,0,0
20160222-ccc_311_calgary_script,2016/02/22,ccc_311_calgary_script,3020,2982,0:00:10,10,0:01:54,38,29820
20160222-ccc_311_lobby_ph_script,2016/02/22,ccc_311_lobby_ph_script,2,2,0:00:07,7,0:00:10,0,14
20160222-ccc_aserv_info_script,2016/02/22,ccc_aserv_info_script,0,0,0:00:00,0,0:00:00,0,0
20160222-ccc_bylaw_script,2016/02/22,ccc_bylaw_script,0,0,0:00:00,0,0:00:00,0,0
20160222-ccc_city_script,2016/02/22,ccc_city_script,19,17,0:00:08,8,0:00:17,2,136
20160222-ccc_cty_online_script,2016/02/22,ccc_cty_online_script,0,0,0:00:00,0,0:00:00,0,0
20160222-ccc_feedback_script,2016/02/22,ccc_feedback_script,0,0,0:00:00,0,0:00:00,0,0
20160222-ccc_fpb_script,2016/02/22,ccc_fpb_script,1,1,0:00:02,2,0:00:02,0,2
20160222-ccc_help_script,2016/02/22,ccc_help_script,19,19,0:00:07,7,0:00:20,0,133
20160222-ccc_link_script,2016/02/22,ccc_link_script,0,0,0:00:00,0,0:00:00,0,0
20160222-ccc_media_line_script,2016/02/22,ccc_media_line_script,1,1,0:00:14,14,0:00:14,0,14
20160222-ccc_priority_script,2016/02/22,ccc_priority_script,26,26,0:00:06,6,0:00:24,0,156
20160222-ccc_tax_script,2016/02/22,ccc_tax_script,22,21,0:00:18,18,0:01:25,1,378
20160222-ccc_waste_recycling_script,2016/02/22,ccc_waste_recycling_script,0,0,0:00:00,0,0:00:00,0,0
20160223-ccc_311_calgary_script,2016/02/23,ccc_311_calgary_script,2763,2720,0:00:10,10,0:03:23,43,27200
20160223-ccc_311_lobby_ph_script,2016/02/23,ccc_311_lobby_ph_script,3,3,0:00:02,2,0:00:04,0,6
20160223-ccc_aserv_info_script,2016/02/23,ccc_aserv_info_script,0,0,0:00:00,0,0:00:00,0,0
20160223-ccc_bylaw_script,2016/02/23,ccc_bylaw_script,0,0,0:00:00,0,0:00:00,0,0
20160223-ccc_city_script,2016/02/23,ccc_city_script,28,27,0:00:07,7,0:00:38,1,189
20160223-ccc_cty_online_script,2016/02/23,ccc_cty_online_script,0,0,0:00:00,0,0:00:00,0,0
20160223-ccc_feedback_script,2016/02/23,ccc_feedback_script,2,0,0:00:00,0,0:00:00,0,0
20160223-ccc_fpb_script,2016/02/23,ccc_fpb_script,0,0,0:00:00,0,0:00:00,0,0
20160223-ccc_help_script,2016/02/23,ccc_help_script,17,17,0:00:09,9,0:01:05,0,153
20160223-ccc_link_script,2016/02/23,ccc_link_script,0,0,0:00:00,0,0:00:00,0,0
20160223-ccc_media_line_script,2016/02/23,ccc_media_line_script,1,1,0:00:01,1,0:00:01,0,1
20160223-ccc_priority_script,2016/02/23,ccc_priority_script,21,21,0:00:05,5,0:00:16,0,105
20160223-ccc_tax_script,2016/02/23,ccc_tax_script,20,20,0:00:11,11,0:01:09,0,220
20160223-ccc_waste_recycling_script,2016/02/23,ccc_waste_recycling_script,0,0,0:00:00,0,0:00:00,0,0
20160224-ccc_311_calgary_script,2016/02/24,ccc_311_calgary_script,2780,2701,0:00:19,19,0:05:47,79,51319
20160224-ccc_311_lobby_ph_script,2016/02/24,ccc_311_lobby_ph_script,7,7,0:00:06,6,0:00:10,0,42
20160224-ccc_aserv_info_script,2016/02/24,ccc_aserv_info_script,0,0,0:00:00,0,0:00:00,0,0
20160224-ccc_bylaw_script,2016/02/24,ccc_bylaw_script,0,0,0:00:00,0,0:00:00,0,0
20160224-ccc_city_script,2016/02/24,ccc_city_script,24,24,0:00:07,7,0:00:37,0,168
20160224-ccc_cty_online_script,2016/02/24,ccc_cty_online_script,0,0,0:00:00,0,0:00:00,0,0
20160224-ccc_feedback_script,2016/02/24,ccc_feedback_script,0,0,0:00:00,0,0:00:00,0,0
20160224-ccc_fpb_script,2016/02/24,ccc_fpb_script,1,1,0:00:15,15,0:00:15,0,15
20160224-ccc_help_script,2016/02/24,ccc_help_script,14,14,0:00:17,17,0:01:52,0,238
20160224-ccc_link_script,2016/02/24,ccc_link_script,0,0,0:00:00,0,0:00:00,0,0
20160224-ccc_media_line_script,2016/02/24,ccc_media_line_script,4,4,0:00:04,4,0:00:08,0,16
20160224-ccc_priority_script,2016/02/24,ccc_priority_script,29,29,0:00:07,7,0:00:18,0,203
20160224-ccc_tax_script,2016/02/24,ccc_tax_script,24,23,0:00:32,32,0:02:11,1,736
20160224-ccc_waste_recycling_script,2016/02/24,ccc_waste_recycling_script,0,0,0:00:00,0,0:00:00,0,0
20160225-ccc_311_calgary_script,2016/02/25,ccc_311_calgary_script,2992,2791,0:00:37,37,0:08:01,201,103267
20160225-ccc_311_lobby_ph_script,2016/02/25,ccc_311_lobby_ph_script,9,7,0:00:07,7,0:00:21,2,49
20160225-ccc_aserv_info_script,2016/02/25,ccc_aserv_info_script,0,0,0:00:00,0,0:00:00,0,0
20160225-ccc_bylaw_script,2016/02/25,ccc_bylaw_script,0,0,0:00:00,0,0:00:00,0,0
20160225-ccc_city_script,2016/02/25,ccc_city_script,17,17,0:00:07,7,0:00:27,0,119
20160225-ccc_cty_online_script,2016/02/25,ccc_cty_online_script,0,0,0:00:00,0,0:00:00,0,0
20160225-ccc_feedback_script,2016/02/25,ccc_feedback_script,1,0,0:00:00,0,0:00:00,0,0
20160225-ccc_fpb_script,2016/02/25,ccc_fpb_script,2,2,0:00:10,10,0:00:16,0,20
20160225-ccc_help_script,2016/02/25,ccc_help_script,21,21,0:00:05,5,0:00:13,0,105
20160225-ccc_link_script,2016/02/25,ccc_link_script,0,0,0:00:00,0,0:00:00,0,0
20160225-ccc_media_line_script,2016/02/25,ccc_media_line_script,0,0,0:00:00,0,0:00:00,0,0
20160225-ccc_priority_script,2016/02/25,ccc_priority_script,29,28,0:00:08,8,0:00:24,1,224
20160225-ccc_tax_script,2016/02/25,ccc_tax_script,18,18,0:00:59,59,0:04:00,0,1062
20160225-ccc_waste_recycling_script,2016/02/25,ccc_waste_recycling_script,0,0,0:00:00,0,0:00:00,0,0
20160226-ccc_311_calgary_script,2016/02/26,ccc_311_calgary_script,2594,2536,0:00:14,14,0:04:01,57,35504
20160226-ccc_311_lobby_ph_script,2016/02/26,ccc_311_lobby_ph_script,2,2,0:00:05,5,0:00:07,0,10
20160226-ccc_aserv_info_script,2016/02/26,ccc_aserv_info_script,0,0,0:00:00,0,0:00:00,0,0
20160226-ccc_bylaw_script,2016/02/26,ccc_bylaw_script,0,0,0:00:00,0,0:00:00,0,0
20160226-ccc_city_script,2016/02/26,ccc_city_script,14,14,0:00:07,7,0:00:16,0,98
20160226-ccc_cty_online_script,2016/02/26,ccc_cty_online_script,0,0,0:00:00,0,0:00:00,0,0
20160226-ccc_feedback_script,2016/02/26,ccc_feedback_script,0,0,0:00:00,0,0:00:00,0,0
20160226-ccc_fpb_script,2016/02/26,ccc_fpb_script,0,0,0:00:00,0,0:00:00,0,0
20160226-ccc_help_script,2016/02/26,ccc_help_script,14,14,0:00:12,12,0:01:13,0,168
20160226-ccc_link_script,2016/02/26,ccc_link_script,0,0,0:00:00,0,0:00:00,0,0
20160226-ccc_media_line_script,2016/02/26,ccc_media_line_script,0,0,0:00:00,0,0:00:00,0,0
20160226-ccc_priority_script,2016/02/26,ccc_priority_script,23,23,0:00:09,9,0:00:56,0,207
20160226-ccc_tax_script,2016/02/26,ccc_tax_script,13,13,0:00:25,25,0:01:27,0,325
20160226-ccc_waste_recycling_script,2016/02/26,ccc_waste_recycling_script,0,0,0:00:00,0,0:00:00,0,0
20160227-ccc_311_calgary_script,2016/02/27,ccc_311_calgary_script,889,879,0:00:08,8,0:02:09,11,7032
20160227-ccc_311_lobby_ph_script,2016/02/27,ccc_311_lobby_ph_script,0,0,0:00:00,0,0:00:00,0,0
20160227-ccc_aserv_info_script,2016/02/27,ccc_aserv_info_script,0,0,0:00:00,0,0:00:00,0,0
20160227-ccc_bylaw_script,2016/02/27,ccc_bylaw_script,0,0,0:00:00,0,0:00:00,0,0
20160227-ccc_city_script,2016/02/27,ccc_city_script,0,0,0:00:00,0,0:00:00,0,0
20160227-ccc_cty_online_script,2016/02/27,ccc_cty_online_script,0,0,0:00:00,0,0:00:00,0,0
20160227-ccc_feedback_script,2016/02/27,ccc_feedback_script,0,0,0:00:00,0,0:00:00,0,0
20160227-ccc_fpb_script,2016/02/27,ccc_fpb_script,0,0,0:00:00,0,0:00:00,0,0
20160227-ccc_help_script,2016/02/27,ccc_help_script,10,10,0:00:06,6,0:00:11,0,60
20160227-ccc_link_script,2016/02/27,ccc_link_script,0,0,0:00:00,0,0:00:00,0,0
20160227-ccc_media_line_script,2016/02/27,ccc_media_line_script,2,2,0:00:05,5,0:00:06,0,10
20160227-ccc_priority_script,2016/02/27,ccc_priority_script,14,14,0:00:11,11,0:01:17,0,154
20160227-ccc_tax_script,2016/02/27,ccc_tax_script,1,1,0:00:12,12,0:00:12,0,12
20160227-ccc_waste_recycling_script,2016/02/27,ccc_waste_recycling_script,0,0,0:00:00,0,0:00:00,0,0
20160228-ccc_311_calgary_script,2016/02/28,ccc_311_calgary_script,855,837,0:00:12,12,0:05:25,17,10044
20160228-ccc_311_lobby_ph_script,2016/02/28,ccc_311_lobby_ph_script,0,0,0:00:00,0,0:00:00,0,0
20160228-ccc_aserv_info_script,2016/02/28,ccc_aserv_info_script,0,0,0:00:00,0,0:00:00,0,0
20160228-ccc_bylaw_script,2016/02/28,ccc_bylaw_script,0,0,0:00:00,0,0:00:00,0,0
20160228-ccc_city_script,2016/02/28,ccc_city_script,0,0,0:00:00,0,0:00:00,0,0
20160228-ccc_cty_online_script,2016/02/28,ccc_cty_online_script,0,0,0:00:00,0,0:00:00,0,0
20160228-ccc_feedback_script,2016/02/28,ccc_feedback_script,0,0,0:00:00,0,0:00:00,0,0
20160228-ccc_fpb_script,2016/02/28,ccc_fpb_script,1,1,0:00:04,4,0:00:04,0,4
20160228-ccc_help_script,2016/02/28,ccc_help_script,8,8,0:00:07,7,0:00:14,0,56
20160228-ccc_link_script,2016/02/28,ccc_link_script,0,0,0:00:00,0,0:00:00,0,0
20160228-ccc_media_line_script,2016/02/28,ccc_media_line_script,1,1,0:00:07,7,0:00:07,0,7
20160228-ccc_priority_script,2016/02/28,ccc_priority_script,20,19,0:00:22,22,0:02:59,1,418
20160228-ccc_tax_script,2016/02/28,ccc_tax_script,0,0,0:00:00,0,0:00:00,0,0
20160228-ccc_waste_recycling_script,2016/02/28,ccc_waste_recycling_script,0,0,0:00:00,0,0:00:00,0,0
20160229-ccc_311_calgary_script,2016/02/29,ccc_311_calgary_script,3199,3099,0:00:23,23,0:18:06,100,71277
20160229-ccc_311_lobby_ph_script,2016/02/29,ccc_311_lobby_ph_script,2,2,0:00:02,2,0:00:02,0,4
20160229-ccc_aserv_info_script,2016/02/29,ccc_aserv_info_script,0,0,0:00:00,0,0:00:00,0,0
20160229-ccc_bylaw_script,2016/02/29,ccc_bylaw_script,0,0,0:00:00,0,0:00:00,0,0
20160229-ccc_city_script,2016/02/29,ccc_city_script,17,16,0:00:15,15,0:01:27,1,240
20160229-ccc_cty_online_script,2016/02/29,ccc_cty_online_script,0,0,0:00:00,0,0:00:00,0,0
20160229-ccc_feedback_script,2016/02/29,ccc_feedback_script,0,0,0:00:00,0,0:00:00,0,0
20160229-ccc_fpb_script,2016/02/29,ccc_fpb_script,0,0,0:00:00,0,0:00:00,0,0
20160229-ccc_help_script,2016/02/29,ccc_help_script,21,19,0:00:06,6,0:00:14,2,114
20160229-ccc_link_script,2016/02/29,ccc_link_script,0,0,0:00:00,0,0:00:00,0,0
20160229-ccc_media_line_script,2016/02/29,ccc_media_line_script,1,1,0:00:05,5,0:00:05,0,5
20160229-ccc_priority_script,2016/02/29,ccc_priority_script,41,39,0:00:07,7,0:00:21,2,273
20160229-ccc_tax_script,2016/02/29,ccc_tax_script,19,18,0:00:22,22,0:03:08,1,396
20160229-ccc_waste_recycling_script,2016/02/29,ccc_waste_recycling_script,0,0,0:00:00,0,0:00:00,0,0
20160301-ccc_311_calgary_script,2016/03/01,ccc_311_calgary_script,2969,2882,0:00:25,25,0:03:43,87,72050
20160301-ccc_311_lobby_ph_script,2016/03/01,ccc_311_lobby_ph_script,4,4,0:00:12,12,0:00:26,0,48
20160301-ccc_aserv_info_script,2016/03/01,ccc_aserv_info_script,0,0,0:00:00,0,0:00:00,0,0
20160301-ccc_bylaw_script,2016/03/01,ccc_bylaw_script,0,0,0:00:00,0,0:00:00,0,0
20160301-ccc_city_script,2016/03/01,ccc_city_script,26,26,0:00:09,9,0:00:49,0,234
20160301-ccc_cty_online_script,2016/03/01,ccc_cty_online_script,0,0,0:00:00,0,0:00:00,0,0
20160301-ccc_feedback_script,2016/03/01,ccc_feedback_script,0,0,0:00:00,0,0:00:00,0,0
20160301-ccc_fpb_script,2016/03/01,ccc_fpb_script,1,1,0:00:03,3,0:00:03,0,3
20160301-ccc_help_script,2016/03/01,ccc_help_script,18,18,0:00:17,17,0:00:54,0,306
20160301-ccc_link_script,2016/03/01,ccc_link_script,0,0,0:00:00,0,0:00:00,0,0
20160301-ccc_media_line_script,2016/03/01,ccc_media_line_script,3,3,0:00:10,10,0:00:16,0,30
20160301-ccc_priority_script,2016/03/01,ccc_priority_script,22,22,0:00:08,8,0:00:47,0,176
20160301-ccc_tax_script,2016/03/01,ccc_tax_script,16,16,0:00:25,25,0:01:48,0,400
20160301-ccc_waste_recycling_script,2016/03/01,ccc_waste_recycling_script,0,0,0:00:00,0,0:00:00,0,0
20160302-ccc_311_calgary_script,2016/03/02,ccc_311_calgary_script,2982,2868,0:00:26,26,0:04:13,114,74568
20160302-ccc_311_lobby_ph_script,2016/03/02,ccc_311_lobby_ph_script,3,2,0:00:23,23,0:00:37,1,46
20160302-ccc_aserv_info_script,2016/03/02,ccc_aserv_info_script,0,0,0:00:00,0,0:00:00,0,0
20160302-ccc_bylaw_script,2016/03/02,ccc_bylaw_script,0,0,0:00:00,0,0:00:00,0,0
20160302-ccc_city_script,2016/03/02,ccc_city_script,29,28,0:00:09,9,0:00:29,1,252
20160302-ccc_cty_online_script,2016/03/02,ccc_cty_online_script,0,0,0:00:00,0,0:00:00,0,0
20160302-ccc_feedback_script,2016/03/02,ccc_feedback_script,0,0,0:00:00,0,0:00:00,0,0
20160302-ccc_fpb_script,2016/03/02,ccc_fpb_script,1,1,0:00:04,4,0:00:04,0,4
20160302-ccc_help_script,2016/03/02,ccc_help_script,18,18,0:00:18,18,0:01:11,0,324
20160302-ccc_link_script,2016/03/02,ccc_link_script,0,0,0:00:00,0,0:00:00,0,0
20160302-ccc_media_line_script,2016/03/02,ccc_media_line_script,1,1,0:00:06,6,0:00:06,0,6
20160302-ccc_priority_script,2016/03/02,ccc_priority_script,14,14,0:00:07,7,0:00:19,0,98
20160302-ccc_tax_script,2016/03/02,ccc_tax_script,19,17,0:00:30,30,0:02:05,2,510
20160302-ccc_waste_recycling_script,2016/03/02,ccc_waste_recycling_script,0,0,0:00:00,0,0:00:00,0,0
20160303-ccc_311_calgary_script,2016/03/03,ccc_311_calgary_script,2920,2855,0:00:18,18,0:07:14,65,51390
20160303-ccc_311_lobby_ph_script,2016/03/03,ccc_311_lobby_ph_script,4,4,0:00:12,12,0:00:16,0,48
20160303-ccc_aserv_info_script,2016/03/03,ccc_aserv_info_script,0,0,0:00:00,0,0:00:00,0,0
20160303-ccc_bylaw_script,2016/03/03,ccc_bylaw_script,0,0,0:00:00,0,0:00:00,0,0
20160303-ccc_city_script,2016/03/03,ccc_city_script,26,25,0:00:09,9,0:00:32,1,225
20160303-ccc_cty_online_script,2016/03/03,ccc_cty_online_script,0,0,0:00:00,0,0:00:00,0,0
20160303-ccc_feedback_script,2016/03/03,ccc_feedback_script,0,0,0:00:00,0,0:00:00,0,0
20160303-ccc_fpb_script,2016/03/03,ccc_fpb_script,0,0,0:00:00,0,0:00:00,0,0
20160303-ccc_help_script,2016/03/03,ccc_help_script,20,20,0:00:07,7,0:00:23,0,140
20160303-ccc_link_script,2016/03/03,ccc_link_script,2,0,0:00:00,0,0:00:00,0,0
20160303-ccc_media_line_script,2016/03/03,ccc_media_line_script,0,0,0:00:00,0,0:00:00,0,0
20160303-ccc_priority_script,2016/03/03,ccc_priority_script,26,22,0:00:06,6,0:00:18,4,132
20160303-ccc_tax_script,2016/03/03,ccc_tax_script,18,18,0:00:27,27,0:02:49,0,486
20160303-ccc_waste_recycling_script,2016/03/03,ccc_waste_recycling_script,0,0,0:00:00,0,0:00:00,0,0
20160304-ccc_311_calgary_script,2016/03/04,ccc_311_calgary_script,2754,2680,0:00:13,13,0:04:03,74,34840
20160304-ccc_311_lobby_ph_script,2016/03/04,ccc_311_lobby_ph_script,5,4,0:00:07,7,0:00:18,1,28
20160304-ccc_aserv_info_script,2016/03/04,ccc_aserv_info_script,0,0,0:00:00,0,0:00:00,0,0
20160304-ccc_bylaw_script,2016/03/04,ccc_bylaw_script,0,0,0:00:00,0,0:00:00,0,0
20160304-ccc_city_script,2016/03/04,ccc_city_script,21,21,0:00:09,9,0:01:02,0,189
20160304-ccc_cty_online_script,2016/03/04,ccc_cty_online_script,0,0,0:00:00,0,0:00:00,0,0
20160304-ccc_feedback_script,2016/03/04,ccc_feedback_script,0,0,0:00:00,0,0:00:00,0,0
20160304-ccc_fpb_script,2016/03/04,ccc_fpb_script,1,1,0:00:01,1,0:00:01,0,1
20160304-ccc_help_script,2016/03/04,ccc_help_script,25,24,0:00:07,7,0:00:20,1,168
20160304-ccc_link_script,2016/03/04,ccc_link_script,0,0,0:00:00,0,0:00:00,0,0
20160304-ccc_media_line_script,2016/03/04,ccc_media_line_script,0,0,0:00:00,0,0:00:00,0,0
20160304-ccc_priority_script,2016/03/04,ccc_priority_script,25,22,0:00:06,6,0:00:14,3,132
20160304-ccc_tax_script,2016/03/04,ccc_tax_script,12,12,0:00:08,8,0:00:31,0,96
20160304-ccc_waste_recycling_script,2016/03/04,ccc_waste_recycling_script,0,0,0:00:00,0,0:00:00,0,0
20160305-ccc_311_calgary_script,2016/03/05,ccc_311_calgary_script,1053,1008,0:00:27,27,0:08:29,45,27216
20160305-ccc_311_lobby_ph_script,2016/03/05,ccc_311_lobby_ph_script,0,0,0:00:00,0,0:00:00,0,0
20160305-ccc_aserv_info_script,2016/03/05,ccc_aserv_info_script,0,0,0:00:00,0,0:00:00,0,0
20160305-ccc_bylaw_script,2016/03/05,ccc_bylaw_script,0,0,0:00:00,0,0:00:00,0,0
20160305-ccc_city_script,2016/03/05,ccc_city_script,0,0,0:00:00,0,0:00:00,0,0
20160305-ccc_cty_online_script,2016/03/05,ccc_cty_online_script,0,0,0:00:00,0,0:00:00,0,0
20160305-ccc_feedback_script,2016/03/05,ccc_feedback_script,0,0,0:00:00,0,0:00:00,0,0
20160305-ccc_fpb_script,2016/03/05,ccc_fpb_script,0,0,0:00:00,0,0:00:00,0,0
20160305-ccc_help_script,2016/03/05,ccc_help_script,7,6,0:00:18,18,0:00:55,1,108
20160305-ccc_link_script,2016/03/05,ccc_link_script,0,0,0:00:00,0,0:00:00,0,0
20160305-ccc_media_line_script,2016/03/05,ccc_media_line_script,0,0,0:00:00,0,0:00:00,0,0
20160305-ccc_priority_script,2016/03/05,ccc_priority_script,18,17,0:00:31,31,0:02:10,1,527
20160305-ccc_tax_script,2016/03/05,ccc_tax_script,0,0,0:00:00,0,0:00:00,0,0
20160305-ccc_waste_recycling_script,2016/03/05,ccc_waste_recycling_script,0,0,0:00:00,0,0:00:00,0,0
20160306-ccc_311_calgary_script,2016/03/06,ccc_311_calgary_script,860,848,0:00:12,12,0:02:59,12,10176
20160306-ccc_311_lobby_ph_script,2016/03/06,ccc_311_lobby_ph_script,0,0,0:00:00,0,0:00:00,0,0
20160306-ccc_aserv_info_script,2016/03/06,ccc_aserv_info_script,0,0,0:00:00,0,0:00:00,0,0
20160306-ccc_bylaw_script,2016/03/06,ccc_bylaw_script,0,0,0:00:00,0,0:00:00,0,0
20160306-ccc_city_script,2016/03/06,ccc_city_script,0,0,0:00:00,0,0:00:00,0,0
20160306-ccc_cty_online_script,2016/03/06,ccc_cty_online_script,0,0,0:00:00,0,0:00:00,0,0
20160306-ccc_feedback_script,2016/03/06,ccc_feedback_script,0,0,0:00:00,0,0:00:00,0,0
20160306-ccc_fpb_script,2016/03/06,ccc_fpb_script,0,0,0:00:00,0,0:00:00,0,0
20160306-ccc_help_script,2016/03/06,ccc_help_script,0,0,0:00:00,0,0:00:00,0,0
20160306-ccc_link_script,2016/03/06,ccc_link_script,0,0,0:00:00,0,0:00:00,0,0
20160306-ccc_media_line_script,2016/03/06,ccc_media_line_script,0,0,0:00:00,0,0:00:00,0,0
20160306-ccc_priority_script,2016/03/06,ccc_priority_script,13,13,0:00:08,8,0:00:15,0,104
20160306-ccc_tax_script,2016/03/06,ccc_tax_script,0,0,0:00:00,0,0:00:00,0,0
20160306-ccc_waste_recycling_script,2016/03/06,ccc_waste_recycling_script,0,0,0:00:00,0,0:00:00,0,0
20160307-ccc_311_calgary_script,2016/03/07,ccc_311_calgary_script,3311,3140,0:00:47,47,0:06:21,171,147580
20160307-ccc_311_lobby_ph_script,2016/03/07,ccc_311_lobby_ph_script,8,6,0:00:08,8,0:00:27,2,48
20160307-ccc_aserv_info_script,2016/03/07,ccc_aserv_info_script,0,0,0:00:00,0,0:00:00,0,0
20160307-ccc_bylaw_script,2016/03/07,ccc_bylaw_script,0,0,0:00:00,0,0:00:00,0,0
20160307-ccc_city_script,2016/03/07,ccc_city_script,19,19,0:00:16,16,0:00:47,0,304
20160307-ccc_cty_online_script,2016/03/07,ccc_cty_online_script,0,0,0:00:00,0,0:00:00,0,0
20160307-ccc_feedback_script,2016/03/07,ccc_feedback_script,0,0,0:00:00,0,0:00:00,0,0
20160307-ccc_fpb_script,2016/03/07,ccc_fpb_script,0,0,0:00:00,0,0:00:00,0,0
20160307-ccc_help_script,2016/03/07,ccc_help_script,23,21,0:00:13,13,0:00:42,2,273
20160307-ccc_link_script,2016/03/07,ccc_link_script,0,0,0:00:00,0,0:00:00,0,0
20160307-ccc_media_line_script,2016/03/07,ccc_media_line_script,3,3,0:00:04,4,0:00:08,0,12
20160307-ccc_priority_script,2016/03/07,ccc_priority_script,22,20,0:00:08,8,0:00:33,2,160
20160307-ccc_tax_script,2016/03/07,ccc_tax_script,25,22,0:01:00,60,0:03:12,3,1320
20160307-ccc_waste_recycling_script,2016/03/07,ccc_waste_recycling_script,0,0,0:00:00,0,0:00:00,0,0
20160308-ccc_311_calgary_script,2016/03/08,ccc_311_calgary_script,2900,2758,0:00:41,41,0:06:18,142,113078
20160308-ccc_311_lobby_ph_script,2016/03/08,ccc_311_lobby_ph_script,1,0,0:00:00,0,0:00:00,1,0
20160308-ccc_aserv_info_script,2016/03/08,ccc_aserv_info_script,0,0,0:00:00,0,0:00:00,0,0
20160308-ccc_bylaw_script,2016/03/08,ccc_bylaw_script,0,0,0:00:00,0,0:00:00,0,0
20160308-ccc_city_script,2016/03/08,ccc_city_script,15,15,0:00:07,7,0:00:16,0,105
20160308-ccc_cty_online_script,2016/03/08,ccc_cty_online_script,0,0,0:00:00,0,0:00:00,0,0
20160308-ccc_feedback_script,2016/03/08,ccc_feedback_script,0,0,0:00:00,0,0:00:00,0,0
20160308-ccc_fpb_script,2016/03/08,ccc_fpb_script,2,1,0:00:02,2,0:00:02,1,2
20160308-ccc_help_script,2016/03/08,ccc_help_script,16,14,0:00:11,11,0:00:43,2,154
20160308-ccc_link_script,2016/03/08,ccc_link_script,0,0,0:00:00,0,0:00:00,0,0
20160308-ccc_media_line_script,2016/03/08,ccc_media_line_script,0,0,0:00:00,0,0:00:00,0,0
20160308-ccc_priority_script,2016/03/08,ccc_priority_script,21,21,0:00:09,9,0:00:31,0,189
20160308-ccc_tax_script,2016/03/08,ccc_tax_script,20,20,0:00:56,56,0:03:10,0,1120
20160308-ccc_waste_recycling_script,2016/03/08,ccc_waste_recycling_script,0,0,0:00:00,0,0:00:00,0,0
20160309-ccc_311_calgary_script,2016/03/09,ccc_311_calgary_script,3026,2889,0:00:34,34,0:07:55,137,98226
20160309-ccc_311_lobby_ph_script,2016/03/09,ccc_311_lobby_ph_script,8,8,0:00:11,11,0:00:31,0,88
20160309-ccc_aserv_info_script,2016/03/09,ccc_aserv_info_script,0,0,0:00:00,0,0:00:00,0,0
20160309-ccc_bylaw_script,2016/03/09,ccc_bylaw_script,0,0,0:00:00,0,0:00:00,0,0
20160309-ccc_city_script,2016/03/09,ccc_city_script,15,14,0:00:11,11,0:00:27,1,154
20160309-ccc_cty_online_script,2016/03/09,ccc_cty_online_script,0,0,0:00:00,0,0:00:00,0,0
20160309-ccc_feedback_script,2016/03/09,ccc_feedback_script,3,0,0:00:00,0,0:00:00,0,0
20160309-ccc_fpb_script,2016/03/09,ccc_fpb_script,5,4,0:00:06,6,0:00:13,1,24
20160309-ccc_help_script,2016/03/09,ccc_help_script,16,13,0:00:07,7,0:00:27,3,91
20160309-ccc_link_script,2016/03/09,ccc_link_script,0,0,0:00:00,0,0:00:00,0,0
20160309-ccc_media_line_script,2016/03/09,ccc_media_line_script,2,2,0:00:05,5,0:00:05,0,10
20160309-ccc_priority_script,2016/03/09,ccc_priority_script,33,31,0:00:10,10,0:00:45,2,310
20160309-ccc_tax_script,2016/03/09,ccc_tax_script,20,19,0:00:38,38,0:03:06,1,722
20160309-ccc_waste_recycling_script,2016/03/09,ccc_waste_recycling_script,0,0,0:00:00,0,0:00:00,0,0
20160310-ccc_311_calgary_script,2016/03/10,ccc_311_calgary_script,3093,2949,0:00:36,36,0:04:44,144,106164
20160310-ccc_311_lobby_ph_script,2016/03/10,ccc_311_lobby_ph_script,9,8,0:00:06,6,0:00:11,1,48
20160310-ccc_aserv_info_script,2016/03/10,ccc_aserv_info_script,0,0,0:00:00,0,0:00:00,0,0
20160310-ccc_bylaw_script,2016/03/10,ccc_bylaw_script,0,0,0:00:00,0,0:00:00,0,0
20160310-ccc_city_script,2016/03/10,ccc_city_script,24,24,0:00:15,15,0:02:05,0,360
20160310-ccc_cty_online_script,2016/03/10,ccc_cty_online_script,0,0,0:00:00,0,0:00:00,0,0
20160310-ccc_feedback_script,2016/03/10,ccc_feedback_script,0,0,0:00:00,0,0:00:00,0,0
20160310-ccc_fpb_script,2016/03/10,ccc_fpb_script,1,1,0:04:27,267,0:04:27,0,267
20160310-ccc_help_script,2016/03/10,ccc_help_script,25,23,0:00:10,10,0:00:23,2,230
20160310-ccc_link_script,2016/03/10,ccc_link_script,0,0,0:00:00,0,0:00:00,0,0
20160310-ccc_media_line_script,2016/03/10,ccc_media_line_script,0,0,0:00:00,0,0:00:00,0,0
20160310-ccc_priority_script,2016/03/10,ccc_priority_script,30,30,0:00:09,9,0:00:35,0,270
20160310-ccc_tax_script,2016/03/10,ccc_tax_script,12,12,0:00:39,39,0:01:52,0,468
20160310-ccc_waste_recycling_script,2016/03/10,ccc_waste_recycling_script,0,0,0:00:00,0,0:00:00,0,0
20160311-ccc_311_calgary_script,2016/03/11,ccc_311_calgary_script,2710,2631,0:00:23,23,0:05:19,79,60513
20160311-ccc_311_lobby_ph_script,2016/03/11,ccc_311_lobby_ph_script,4,4,0:00:07,7,0:00:09,0,28
20160311-ccc_aserv_info_script,2016/03/11,ccc_aserv_info_script,0,0,0:00:00,0,0:00:00,0,0
20160311-ccc_bylaw_script,2016/03/11,ccc_bylaw_script,0,0,0:00:00,0,0:00:00,0,0
20160311-ccc_city_script,2016/03/11,ccc_city_script,14,14,0:00:11,11,0:00:48,0,154
20160311-ccc_cty_online_script,2016/03/11,ccc_cty_online_script,0,0,0:00:00,0,0:00:00,0,0
20160311-ccc_feedback_script,2016/03/11,ccc_feedback_script,0,0,0:00:00,0,0:00:00,0,0
20160311-ccc_fpb_script,2016/03/11,ccc_fpb_script,0,0,0:00:00,0,0:00:00,0,0
20160311-ccc_help_script,2016/03/11,ccc_help_script,27,26,0:00:10,10,0:00:51,1,260
20160311-ccc_link_script,2016/03/11,ccc_link_script,0,0,0:00:00,0,0:00:00,0,0
20160311-ccc_media_line_script,2016/03/11,ccc_media_line_script,2,2,0:00:06,6,0:00:09,0,12
20160311-ccc_priority_script,2016/03/11,ccc_priority_script,30,29,0:00:18,18,0:02:15,1,522
20160311-ccc_tax_script,2016/03/11,ccc_tax_script,19,19,0:00:11,11,0:01:37,0,209
20160311-ccc_waste_recycling_script,2016/03/11,ccc_waste_recycling_script,0,0,0:00:00,0,0:00:00,0,0
20160312-ccc_311_calgary_script,2016/03/12,ccc_311_calgary_script,1100,1087,0:00:11,11,0:02:17,13,11957
20160312-ccc_311_lobby_ph_script,2016/03/12,ccc_311_lobby_ph_script,0,0,0:00:00,0,0:00:00,0,0
20160312-ccc_aserv_info_script,2016/03/12,ccc_aserv_info_script,0,0,0:00:00,0,0:00:00,0,0
20160312-ccc_bylaw_script,2016/03/12,ccc_bylaw_script,0,0,0:00:00,0,0:00:00,0,0
20160312-ccc_city_script,2016/03/12,ccc_city_script,0,0,0:00:00,0,0:00:00,0,0
20160312-ccc_cty_online_script,2016/03/12,ccc_cty_online_script,0,0,0:00:00,0,0:00:00,0,0
20160312-ccc_feedback_script,2016/03/12,ccc_feedback_script,0,0,0:00:00,0,0:00:00,0,0
20160312-ccc_fpb_script,2016/03/12,ccc_fpb_script,0,0,0:00:00,0,0:00:00,0,0
20160312-ccc_help_script,2016/03/12,ccc_help_script,0,0,0:00:00,0,0:00:00,0,0
20160312-ccc_link_script,2016/03/12,ccc_link_script,0,0,0:00:00,0,0:00:00,0,0
20160312-ccc_media_line_script,2016/03/12,ccc_media_line_script,0,0,0:00:00,0,0:00:00,0,0
20160312-ccc_priority_script,2016/03/12,ccc_priority_script,19,19,0:00:09,9,0:00:28,0,171
20160312-ccc_tax_script,2016/03/12,ccc_tax_script,3,3,0:00:05,5,0:00:06,0,15
20160312-ccc_waste_recycling_script,2016/03/12,ccc_waste_recycling_script,0,0,0:00:00,0,0:00:00,0,0
20160313-ccc_311_calgary_script,2016/03/13,ccc_311_calgary_script,868,835,0:00:22,22,0:07:47,33,18370
20160313-ccc_311_lobby_ph_script,2016/03/13,ccc_311_lobby_ph_script,0,0,0:00:00,0,0:00:00,0,0
20160313-ccc_aserv_info_script,2016/03/13,ccc_aserv_info_script,0,0,0:00:00,0,0:00:00,0,0
20160313-ccc_bylaw_script,2016/03/13,ccc_bylaw_script,0,0,0:00:00,0,0:00:00,0,0
20160313-ccc_city_script,2016/03/13,ccc_city_script,0,0,0:00:00,0,0:00:00,0,0
20160313-ccc_cty_online_script,2016/03/13,ccc_cty_online_script,0,0,0:00:00,0,0:00:00,0,0
20160313-ccc_feedback_script,2016/03/13,ccc_feedback_script,0,0,0:00:00,0,0:00:00,0,0
20160313-ccc_fpb_script,2016/03/13,ccc_fpb_script,0,0,0:00:00,0,0:00:00,0,0
20160313-ccc_help_script,2016/03/13,ccc_help_script,6,5,0:00:13,13,0:00:33,1,65
20160313-ccc_link_script,2016/03/13,ccc_link_script,0,0,0:00:00,0,0:00:00,0,0
20160313-ccc_media_line_script,2016/03/13,ccc_media_line_script,1,1,0:00:04,4,0:00:04,0,4
20160313-ccc_priority_script,2016/03/13,ccc_priority_script,18,16,0:00:07,7,0:00:39,2,112
20160313-ccc_tax_script,2016/03/13,ccc_tax_script,1,1,0:00:04,4,0:00:04,0,4
20160313-ccc_waste_recycling_script,2016/03/13,ccc_waste_recycling_script,0,0,0:00:00,0,0:00:00,0,0
20160314-ccc_311_calgary_script,2016/03/14,ccc_311_calgary_script,2998,2962,0:00:10,10,0:05:47,36,29620
20160314-ccc_311_lobby_ph_script,2016/03/14,ccc_311_lobby_ph_script,7,6,0:00:10,10,0:00:18,1,60
20160314-ccc_aserv_info_script,2016/03/14,ccc_aserv_info_script,0,0,0:00:00,0,0:00:00,0,0
20160314-ccc_bylaw_script,2016/03/14,ccc_bylaw_script,0,0,0:00:00,0,0:00:00,0,0
20160314-ccc_city_script,2016/03/14,ccc_city_script,27,26,0:00:08,8,0:00:19,1,208
20160314-ccc_cty_online_script,2016/03/14,ccc_cty_online_script,0,0,0:00:00,0,0:00:00,0,0
20160314-ccc_feedback_script,2016/03/14,ccc_feedback_script,0,0,0:00:00,0,0:00:00,0,0
20160314-ccc_fpb_script,2016/03/14,ccc_fpb_script,1,1,0:00:04,4,0:00:04,0,4
20160314-ccc_help_script,2016/03/14,ccc_help_script,20,20,0:00:07,7,0:00:35,0,140
20160314-ccc_link_script,2016/03/14,ccc_link_script,0,0,0:00:00,0,0:00:00,0,0
20160314-ccc_media_line_script,2016/03/14,ccc_media_line_script,1,1,0:00:09,9,0:00:09,0,9
20160314-ccc_priority_script,2016/03/14,ccc_priority_script,22,21,0:00:11,11,0:00:49,1,231
20160314-ccc_tax_script,2016/03/14,ccc_tax_script,12,12,0:00:09,9,0:00:38,0,108
20160314-ccc_waste_recycling_script,2016/03/14,ccc_waste_recycling_script,0,0,0:00:00,0,0:00:00,0,0
20160315-ccc_311_calgary_script,2016/03/15,ccc_311_calgary_script,2926,2877,0:00:16,16,0:18:15,49,46032
20160315-ccc_311_lobby_ph_script,2016/03/15,ccc_311_lobby_ph_script,5,4,0:00:09,9,0:00:19,1,36
20160315-ccc_aserv_info_script,2016/03/15,ccc_aserv_info_script,0,0,0:00:00,0,0:00:00,0,0
20160315-ccc_bylaw_script,2016/03/15,ccc_bylaw_script,0,0,0:00:00,0,0:00:00,0,0
20160315-ccc_city_script,2016/03/15,ccc_city_script,25,25,0:00:09,9,0:00:19,0,225
20160315-ccc_cty_online_script,2016/03/15,ccc_cty_online_script,0,0,0:00:00,0,0:00:00,0,0
20160315-ccc_feedback_script,2016/03/15,ccc_feedback_script,0,0,0:00:00,0,0:00:00,0,0
20160315-ccc_fpb_script,2016/03/15,ccc_fpb_script,1,1,0:00:05,5,0:00:05,0,5
20160315-ccc_help_script,2016/03/15,ccc_help_script,21,19,0:00:11,11,0:00:42,2,209
20160315-ccc_link_script,2016/03/15,ccc_link_script,0,0,0:00:00,0,0:00:00,0,0
20160315-ccc_media_line_script,2016/03/15,ccc_media_line_script,2,2,0:00:06,6,0:00:07,0,12
20160315-ccc_priority_script,2016/03/15,ccc_priority_script,23,22,0:00:08,8,0:00:20,1,176
20160315-ccc_tax_script,2016/03/15,ccc_tax_script,14,13,0:00:05,5,0:00:09,1,65
20160315-ccc_waste_recycling_script,2016/03/15,ccc_waste_recycling_script,0,0,0:00:00,0,0:00:00,0,0
20160316-ccc_311_calgary_script,2016/03/16,ccc_311_calgary_script,2694,2652,0:00:11,11,0:04:30,42,29172
20160316-ccc_311_lobby_ph_script,2016/03/16,ccc_311_lobby_ph_script,6,6,0:00:07,7,0:00:18,0,42
20160316-ccc_aserv_info_script,2016/03/16,ccc_aserv_info_script,0,0,0:00:00,0,0:00:00,0,0
20160316-ccc_bylaw_script,2016/03/16,ccc_bylaw_script,0,0,0:00:00,0,0:00:00,0,0
20160316-ccc_city_script,2016/03/16,ccc_city_script,18,18,0:00:10,10,0:00:37,0,180
20160316-ccc_cty_online_script,2016/03/16,ccc_cty_online_script,0,0,0:00:00,0,0:00:00,0,0
20160316-ccc_feedback_script,2016/03/16,ccc_feedback_script,0,0,0:00:00,0,0:00:00,0,0
20160316-ccc_fpb_script,2016/03/16,ccc_fpb_script,0,0,0:00:00,0,0:00:00,0,0
20160316-ccc_help_script,2016/03/16,ccc_help_script,14,13,0:00:11,11,0:00:39,1,143
20160316-ccc_link_script,2016/03/16,ccc_link_script,0,0,0:00:00,0,0:00:00,0,0
20160316-ccc_media_line_script,2016/03/16,ccc_media_line_script,0,0,0:00:00,0,0:00:00,0,0
20160316-ccc_priority_script,2016/03/16,ccc_priority_script,22,22,0:00:07,7,0:00:25,0,154
20160316-ccc_tax_script,2016/03/16,ccc_tax_script,15,15,0:00:09,9,0:00:47,0,135
20160316-ccc_waste_recycling_script,2016/03/16,ccc_waste_recycling_script,0,0,0:00:00,0,0:00:00,0,0
20160317-ccc_311_calgary_script,2016/03/17,ccc_311_calgary_script,2472,2448,0:00:08,8,0:03:43,24,19584
20160317-ccc_311_lobby_ph_script,2016/03/17,ccc_311_lobby_ph_script,1,1,0:00:03,3,0:00:03,0,3
20160317-ccc_aserv_info_script,2016/03/17,ccc_aserv_info_script,0,0,0:00:00,0,0:00:00,0,0
20160317-ccc_bylaw_script,2016/03/17,ccc_bylaw_script,0,0,0:00:00,0,0:00:00,0,0
20160317-ccc_city_script,2016/03/17,ccc_city_script,20,20,0:00:06,6,0:00:14,0,120
20160317-ccc_cty_online_script,2016/03/17,ccc_cty_online_script,0,0,0:00:00,0,0:00:00,0,0
20160317-ccc_feedback_script,2016/03/17,ccc_feedback_script,0,0,0:00:00,0,0:00:00,0,0
20160317-ccc_fpb_script,2016/03/17,ccc_fpb_script,1,1,0:00:05,5,0:00:05,0,5
20160317-ccc_help_script,2016/03/17,ccc_help_script,12,12,0:00:10,10,0:00:45,0,120
20160317-ccc_link_script,2016/03/17,ccc_link_script,0,0,0:00:00,0,0:00:00,0,0
20160317-ccc_media_line_script,2016/03/17,ccc_media_line_script,2,2,0:00:04,4,0:00:05,0,8
20160317-ccc_priority_script,2016/03/17,ccc_priority_script,44,44,0:00:11,11,0:01:36,0,484
20160317-ccc_tax_script,2016/03/17,ccc_tax_script,4,4,0:00:05,5,0:00:07,0,20
20160317-ccc_waste_recycling_script,2016/03/17,ccc_waste_recycling_script,0,0,0:00:00,0,0:00:00,0,0
20160318-ccc_311_calgary_script,2016/03/18,ccc_311_calgary_script,2429,2394,0:00:09,9,0:05:53,35,21546
20160318-ccc_311_lobby_ph_script,2016/03/18,ccc_311_lobby_ph_script,3,3,0:00:16,16,0:00:36,0,48
20160318-ccc_aserv_info_script,2016/03/18,ccc_aserv_info_script,0,0,0:00:00,0,0:00:00,0,0
20160318-ccc_bylaw_script,2016/03/18,ccc_bylaw_script,0,0,0:00:00,0,0:00:00,0,0
20160318-ccc_city_script,2016/03/18,ccc_city_script,18,18,0:00:07,7,0:00:15,0,126
20160318-ccc_cty_online_script,2016/03/18,ccc_cty_online_script,0,0,0:00:00,0,0:00:00,0,0
20160318-ccc_feedback_script,2016/03/18,ccc_feedback_script,0,0,0:00:00,0,0:00:00,0,0
20160318-ccc_fpb_script,2016/03/18,ccc_fpb_script,0,0,0:00:00,0,0:00:00,0,0
20160318-ccc_help_script,2016/03/18,ccc_help_script,10,10,0:00:13,13,0:00:33,0,130
20160318-ccc_link_script,2016/03/18,ccc_link_script,0,0,0:00:00,0,0:00:00,0,0
20160318-ccc_media_line_script,2016/03/18,ccc_media_line_script,0,0,0:00:00,0,0:00:00,0,0
20160318-ccc_priority_script,2016/03/18,ccc_priority_script,26,25,0:00:08,8,0:00:26,1,200
20160318-ccc_tax_script,2016/03/18,ccc_tax_script,14,14,0:00:09,9,0:00:34,0,126
20160318-ccc_waste_recycling_script,2016/03/18,ccc_waste_recycling_script,0,0,0:00:00,0,0:00:00,0,0
20160319-ccc_311_calgary_script,2016/03/19,ccc_311_calgary_script,1044,1017,0:00:14,14,0:09:33,27,14238
20160319-ccc_311_lobby_ph_script,2016/03/19,ccc_311_lobby_ph_script,0,0,0:00:00,0,0:00:00,0,0
20160319-ccc_aserv_info_script,2016/03/19,ccc_aserv_info_script,0,0,0:00:00,0,0:00:00,0,0
20160319-ccc_bylaw_script,2016/03/19,ccc_bylaw_script,0,0,0:00:00,0,0:00:00,0,0
20160319-ccc_city_script,2016/03/19,ccc_city_script,0,0,0:00:00,0,0:00:00,0,0
20160319-ccc_cty_online_script,2016/03/19,ccc_cty_online_script,0,0,0:00:00,0,0:00:00,0,0
20160319-ccc_feedback_script,2016/03/19,ccc_feedback_script,0,0,0:00:00,0,0:00:00,0,0
20160319-ccc_fpb_script,2016/03/19,ccc_fpb_script,0,0,0:00:00,0,0:00:00,0,0
20160319-ccc_help_script,2016/03/19,ccc_help_script,4,4,0:00:07,7,0:00:15,0,28
20160319-ccc_link_script,2016/03/19,ccc_link_script,0,0,0:00:00,0,0:00:00,0,0
20160319-ccc_media_line_script,2016/03/19,ccc_media_line_script,2,2,0:00:05,5,0:00:06,0,10
20160319-ccc_priority_script,2016/03/19,ccc_priority_script,25,24,0:00:13,13,0:00:53,1,312
20160319-ccc_tax_script,2016/03/19,ccc_tax_script,0,0,0:00:00,0,0:00:00,0,0
20160319-ccc_waste_recycling_script,2016/03/19,ccc_waste_recycling_script,0,0,0:00:00,0,0:00:00,0,0
20160320-ccc_311_calgary_script,2016/03/20,ccc_311_calgary_script,894,882,0:00:12,12,0:02:53,12,10584
20160320-ccc_311_lobby_ph_script,2016/03/20,ccc_311_lobby_ph_script,0,0,0:00:00,0,0:00:00,0,0
20160320-ccc_aserv_info_script,2016/03/20,ccc_aserv_info_script,0,0,0:00:00,0,0:00:00,0,0
20160320-ccc_bylaw_script,2016/03/20,ccc_bylaw_script,0,0,0:00:00,0,0:00:00,0,0
20160320-ccc_city_script,2016/03/20,ccc_city_script,0,0,0:00:00,0,0:00:00,0,0
20160320-ccc_cty_online_script,2016/03/20,ccc_cty_online_script,0,0,0:00:00,0,0:00:00,0,0
20160320-ccc_feedback_script,2016/03/20,ccc_feedback_script,0,0,0:00:00,0,0:00:00,0,0
20160320-ccc_fpb_script,2016/03/20,ccc_fpb_script,0,0,0:00:00,0,0:00:00,0,0
20160320-ccc_help_script,2016/03/20,ccc_help_script,1,1,0:00:07,7,0:00:07,0,7
20160320-ccc_link_script,2016/03/20,ccc_link_script,0,0,0:00:00,0,0:00:00,0,0
20160320-ccc_media_line_script,2016/03/20,ccc_media_line_script,1,1,0:00:10,10,0:00:10,0,10
20160320-ccc_priority_script,2016/03/20,ccc_priority_script,13,12,0:00:10,10,0:00:49,1,120
20160320-ccc_tax_script,2016/03/20,ccc_tax_script,1,1,0:00:38,38,0:00:38,0,38
20160320-ccc_waste_recycling_script,2016/03/20,ccc_waste_recycling_script,0,0,0:00:00,0,0:00:00,0,0
20160321-ccc_311_calgary_script,2016/03/21,ccc_311_calgary_script,3127,3060,0:00:15,15,0:02:54,67,45900
20160321-ccc_311_lobby_ph_script,2016/03/21,ccc_311_lobby_ph_script,7,7,0:00:13,13,0:00:46,0,91
20160321-ccc_aserv_info_script,2016/03/21,ccc_aserv_info_script,0,0,0:00:00,0,0:00:00,0,0
20160321-ccc_bylaw_script,2016/03/21,ccc_bylaw_script,0,0,0:00:00,0,0:00:00,0,0
20160321-ccc_city_script,2016/03/21,ccc_city_script,29,29,0:00:10,10,0:00:38,0,290
20160321-ccc_cty_online_script,2016/03/21,ccc_cty_online_script,0,0,0:00:00,0,0:00:00,0,0
20160321-ccc_feedback_script,2016/03/21,ccc_feedback_script,0,0,0:00:00,0,0:00:00,0,0
20160321-ccc_fpb_script,2016/03/21,ccc_fpb_script,0,0,0:00:00,0,0:00:00,0,0
20160321-ccc_help_script,2016/03/21,ccc_help_script,11,11,0:00:08,8,0:00:16,0,88
20160321-ccc_link_script,2016/03/21,ccc_link_script,0,0,0:00:00,0,0:00:00,0,0
20160321-ccc_media_line_script,2016/03/21,ccc_media_line_script,2,2,0:00:06,6,0:00:08,0,12
20160321-ccc_priority_script,2016/03/21,ccc_priority_script,22,21,0:00:10,10,0:00:28,1,210
20160321-ccc_tax_script,2016/03/21,ccc_tax_script,9,9,0:00:28,28,0:01:26,0,252
20160321-ccc_waste_recycling_script,2016/03/21,ccc_waste_recycling_script,0,0,0:00:00,0,0:00:00,0,0
20160322-ccc_311_calgary_script,2016/03/22,ccc_311_calgary_script,2938,2747,0:00:51,51,0:07:12,191,140097
20160322-ccc_311_lobby_ph_script,2016/03/22,ccc_311_lobby_ph_script,1,0,0:00:00,0,0:00:00,1,0
20160322-ccc_aserv_info_script,2016/03/22,ccc_aserv_info_script,0,0,0:00:00,0,0:00:00,0,0
20160322-ccc_bylaw_script,2016/03/22,ccc_bylaw_script,0,0,0:00:00,0,0:00:00,0,0
20160322-ccc_city_script,2016/03/22,ccc_city_script,13,12,0:00:18,18,0:00:55,1,216
20160322-ccc_cty_online_script,2016/03/22,ccc_cty_online_script,0,0,0:00:00,0,0:00:00,0,0
20160322-ccc_feedback_script,2016/03/22,ccc_feedback_script,0,0,0:00:00,0,0:00:00,0,0
20160322-ccc_fpb_script,2016/03/22,ccc_fpb_script,0,0,0:00:00,0,0:00:00,0,0
20160322-ccc_help_script,2016/03/22,ccc_help_script,12,11,0:00:11,11,0:00:32,1,121
20160322-ccc_link_script,2016/03/22,ccc_link_script,0,0,0:00:00,0,0:00:00,0,0
20160322-ccc_media_line_script,2016/03/22,ccc_media_line_script,1,1,0:00:06,6,0:00:06,0,6
20160322-ccc_priority_script,2016/03/22,ccc_priority_script,33,33,0:00:15,15,0:01:15,0,495
20160322-ccc_tax_script,2016/03/22,ccc_tax_script,15,13,0:00:37,37,0:02:51,2,481
20160322-ccc_waste_recycling_script,2016/03/22,ccc_waste_recycling_script,0,0,0:00:00,0,0:00:00,0,0
20160323-ccc_311_calgary_script,2016/03/23,ccc_311_calgary_script,3038,2804,0:00:57,57,0:12:05,234,159828
20160323-ccc_311_lobby_ph_script,2016/03/23,ccc_311_lobby_ph_script,5,4,0:00:06,6,0:00:13,1,24
20160323-ccc_aserv_info_script,2016/03/23,ccc_aserv_info_script,0,0,0:00:00,0,0:00:00,0,0
20160323-ccc_bylaw_script,2016/03/23,ccc_bylaw_script,0,0,0:00:00,0,0:00:00,0,0
20160323-ccc_city_script,2016/03/23,ccc_city_script,13,13,0:00:10,10,0:00:21,0,130
20160323-ccc_cty_online_script,2016/03/23,ccc_cty_online_script,0,0,0:00:00,0,0:00:00,0,0
20160323-ccc_feedback_script,2016/03/23,ccc_feedback_script,0,0,0:00:00,0,0:00:00,0,0
20160323-ccc_fpb_script,2016/03/23,ccc_fpb_script,1,0,0:00:00,0,0:00:00,1,0
20160323-ccc_help_script,2016/03/23,ccc_help_script,11,8,0:00:21,21,0:01:42,3,168
20160323-ccc_link_script,2016/03/23,ccc_link_script,0,0,0:00:00,0,0:00:00,0,0
20160323-ccc_media_line_script,2016/03/23,ccc_media_line_script,2,1,0:00:50,50,0:00:50,1,50
20160323-ccc_priority_script,2016/03/23,ccc_priority_script,30,28,0:00:12,12,0:01:51,2,336
20160323-ccc_tax_script,2016/03/23,ccc_tax_script,12,12,0:00:47,47,0:02:33,0,564
20160323-ccc_waste_recycling_script,2016/03/23,ccc_waste_recycling_script,0,0,0:00:00,0,0:00:00,0,0
20160324-ccc_311_calgary_script,2016/03/24,ccc_311_calgary_script,2949,2842,0:00:27,27,0:04:49,107,76734
20160324-ccc_311_lobby_ph_script,2016/03/24,ccc_311_lobby_ph_script,1,1,0:00:02,2,0:00:02,0,2
20160324-ccc_aserv_info_script,2016/03/24,ccc_aserv_info_script,0,0,0:00:00,0,0:00:00,0,0
20160324-ccc_bylaw_script,2016/03/24,ccc_bylaw_script,0,0,0:00:00,0,0:00:00,0,0
20160324-ccc_city_script,2016/03/24,ccc_city_script,13,13,0:00:17,17,0:00:44,0,221
20160324-ccc_cty_online_script,2016/03/24,ccc_cty_online_script,0,0,0:00:00,0,0:00:00,0,0
20160324-ccc_feedback_script,2016/03/24,ccc_feedback_script,0,0,0:00:00,0,0:00:00,0,0
20160324-ccc_fpb_script,2016/03/24,ccc_fpb_script,0,0,0:00:00,0,0:00:00,0,0
20160324-ccc_help_script,2016/03/24,ccc_help_script,19,17,0:00:17,17,0:00:57,2,289
20160324-ccc_link_script,2016/03/24,ccc_link_script,0,0,0:00:00,0,0:00:00,0,0
20160324-ccc_media_line_script,2016/03/24,ccc_media_line_script,1,1,0:00:02,2,0:00:02,0,2
20160324-ccc_priority_script,2016/03/24,ccc_priority_script,24,24,0:00:10,10,0:00:28,0,240
20160324-ccc_tax_script,2016/03/24,ccc_tax_script,17,15,0:00:40,40,0:03:08,2,600
20160324-ccc_waste_recycling_script,2016/03/24,ccc_waste_recycling_script,0,0,0:00:00,0,0:00:00,0,0
20160325-ccc_311_calgary_script,2016/03/25,ccc_311_calgary_script,1124,1108,0:00:07,7,0:05:05,16,7756
20160325-ccc_311_lobby_ph_script,2016/03/25,ccc_311_lobby_ph_script,0,0,0:00:00,0,0:00:00,0,0
20160325-ccc_aserv_info_script,2016/03/25,ccc_aserv_info_script,0,0,0:00:00,0,0:00:00,0,0
20160325-ccc_bylaw_script,2016/03/25,ccc_bylaw_script,0,0,0:00:00,0,0:00:00,0,0
20160325-ccc_city_script,2016/03/25,ccc_city_script,0,0,0:00:00,0,0:00:00,0,0
20160325-ccc_cty_online_script,2016/03/25,ccc_cty_online_script,0,0,0:00:00,0,0:00:00,0,0
20160325-ccc_feedback_script,2016/03/25,ccc_feedback_script,0,0,0:00:00,0,0:00:00,0,0
20160325-ccc_fpb_script,2016/03/25,ccc_fpb_script,0,0,0:00:00,0,0:00:00,0,0
20160325-ccc_help_script,2016/03/25,ccc_help_script,3,3,0:00:05,5,0:00:10,0,15
20160325-ccc_link_script,2016/03/25,ccc_link_script,0,0,0:00:00,0,0:00:00,0,0
20160325-ccc_media_line_script,2016/03/25,ccc_media_line_script,2,2,0:00:05,5,0:00:06,0,10
20160325-ccc_priority_script,2016/03/25,ccc_priority_script,19,19,0:00:05,5,0:00:13,0,95
20160325-ccc_tax_script,2016/03/25,ccc_tax_script,0,0,0:00:00,0,0:00:00,0,0
20160325-ccc_waste_recycling_script,2016/03/25,ccc_waste_recycling_script,0,0,0:00:00,0,0:00:00,0,0
20160326-ccc_311_calgary_script,2016/03/26,ccc_311_calgary_script,985,959,0:00:10,10,0:04:05,26,9590
20160326-ccc_311_lobby_ph_script,2016/03/26,ccc_311_lobby_ph_script,0,0,0:00:00,0,0:00:00,0,0
20160326-ccc_aserv_info_script,2016/03/26,ccc_aserv_info_script,0,0,0:00:00,0,0:00:00,0,0
20160326-ccc_bylaw_script,2016/03/26,ccc_bylaw_script,0,0,0:00:00,0,0:00:00,0,0
20160326-ccc_city_script,2016/03/26,ccc_city_script,0,0,0:00:00,0,0:00:00,0,0
20160326-ccc_cty_online_script,2016/03/26,ccc_cty_online_script,0,0,0:00:00,0,0:00:00,0,0
20160326-ccc_feedback_script,2016/03/26,ccc_feedback_script,0,0,0:00:00,0,0:00:00,0,0
20160326-ccc_fpb_script,2016/03/26,ccc_fpb_script,0,0,0:00:00,0,0:00:00,0,0
20160326-ccc_help_script,2016/03/26,ccc_help_script,0,0,0:00:00,0,0:00:00,0,0
20160326-ccc_link_script,2016/03/26,ccc_link_script,0,0,0:00:00,0,0:00:00,0,0
20160326-ccc_media_line_script,2016/03/26,ccc_media_line_script,0,0,0:00:00,0,0:00:00,0,0
20160326-ccc_priority_script,2016/03/26,ccc_priority_script,15,15,0:00:07,7,0:00:11,0,105
20160326-ccc_tax_script,2016/03/26,ccc_tax_script,2,2,0:00:05,5,0:00:06,0,10
20160326-ccc_waste_recycling_script,2016/03/26,ccc_waste_recycling_script,0,0,0:00:00,0,0:00:00,0,0
20160327-ccc_311_calgary_script,2016/03/27,ccc_311_calgary_script,702,691,0:00:08,8,0:03:39,11,5528
20160327-ccc_311_lobby_ph_script,2016/03/27,ccc_311_lobby_ph_script,0,0,0:00:00,0,0:00:00,0,0
20160327-ccc_aserv_info_script,2016/03/27,ccc_aserv_info_script,0,0,0:00:00,0,0:00:00,0,0
20160327-ccc_bylaw_script,2016/03/27,ccc_bylaw_script,0,0,0:00:00,0,0:00:00,0,0
20160327-ccc_city_script,2016/03/27,ccc_city_script,0,0,0:00:00,0,0:00:00,0,0
20160327-ccc_cty_online_script,2016/03/27,ccc_cty_online_script,0,0,0:00:00,0,0:00:00,0,0
20160327-ccc_feedback_script,2016/03/27,ccc_feedback_script,0,0,0:00:00,0,0:00:00,0,0
20160327-ccc_fpb_script,2016/03/27,ccc_fpb_script,0,0,0:00:00,0,0:00:00,0,0
20160327-ccc_help_script,2016/03/27,ccc_help_script,2,2,0:00:08,8,0:00:13,0,16
20160327-ccc_link_script,2016/03/27,ccc_link_script,0,0,0:00:00,0,0:00:00,0,0
20160327-ccc_media_line_script,2016/03/27,ccc_media_line_script,1,1,0:00:13,13,0:00:13,0,13
20160327-ccc_priority_script,2016/03/27,ccc_priority_script,18,18,0:00:13,13,0:01:07,0,234
20160327-ccc_tax_script,2016/03/27,ccc_tax_script,0,0,0:00:00,0,0:00:00,0,0
20160327-ccc_waste_recycling_script,2016/03/27,ccc_waste_recycling_script,0,0,0:00:00,0,0:00:00,0,0
20160328-ccc_311_calgary_script,2016/03/28,ccc_311_calgary_script,3090,3045,0:00:11,11,0:03:30,45,33495
20160328-ccc_311_lobby_ph_script,2016/03/28,ccc_311_lobby_ph_script,1,1,0:00:04,4,0:00:04,0,4
20160328-ccc_aserv_info_script,2016/03/28,ccc_aserv_info_script,0,0,0:00:00,0,0:00:00,0,0
20160328-ccc_bylaw_script,2016/03/28,ccc_bylaw_script,2,2,0:00:08,8,0:00:12,0,16
20160328-ccc_city_script,2016/03/28,ccc_city_script,30,30,0:00:11,11,0:02:14,0,330
20160328-ccc_cty_online_script,2016/03/28,ccc_cty_online_script,0,0,0:00:00,0,0:00:00,0,0
20160328-ccc_feedback_script,2016/03/28,ccc_feedback_script,2,0,0:00:00,0,0:00:00,0,0
20160328-ccc_fpb_script,2016/03/28,ccc_fpb_script,0,0,0:00:00,0,0:00:00,0,0
20160328-ccc_help_script,2016/03/28,ccc_help_script,4,4,0:00:13,13,0:00:31,0,52
20160328-ccc_link_script,2016/03/28,ccc_link_script,0,0,0:00:00,0,0:00:00,0,0
20160328-ccc_media_line_script,2016/03/28,ccc_media_line_script,0,0,0:00:00,0,0:00:00,0,0
20160328-ccc_priority_script,2016/03/28,ccc_priority_script,20,19,0:00:06,6,0:00:13,1,114
20160328-ccc_tax_script,2016/03/28,ccc_tax_script,2,2,0:00:09,9,0:00:10,0,18
20160328-ccc_waste_recycling_script,2016/03/28,ccc_waste_recycling_script,0,0,0:00:00,0,0:00:00,0,0
20160329-ccc_311_calgary_script,2016/03/29,ccc_311_calgary_script,3414,2958,0:01:45,105,0:08:24,456,310590
20160329-ccc_311_lobby_ph_script,2016/03/29,ccc_311_lobby_ph_script,3,1,0:00:10,10,0:00:10,2,10
20160329-ccc_aserv_info_script,2016/03/29,ccc_aserv_info_script,0,0,0:00:00,0,0:00:00,0,0
20160329-ccc_bylaw_script,2016/03/29,ccc_bylaw_script,0,0,0:00:00,0,0:00:00,0,0
20160329-ccc_city_script,2016/03/29,ccc_city_script,18,18,0:00:30,30,0:01:58,0,540
20160329-ccc_cty_online_script,2016/03/29,ccc_cty_online_script,0,0,0:00:00,0,0:00:00,0,0
20160329-ccc_feedback_script,2016/03/29,ccc_feedback_script,0,0,0:00:00,0,0:00:00,0,0
20160329-ccc_fpb_script,2016/03/29,ccc_fpb_script,0,0,0:00:00,0,0:00:00,0,0
20160329-ccc_help_script,2016/03/29,ccc_help_script,7,7,0:00:12,12,0:00:20,0,84
20160329-ccc_link_script,2016/03/29,ccc_link_script,1,0,0:00:00,0,0:00:00,1,0
20160329-ccc_media_line_script,2016/03/29,ccc_media_line_script,0,0,0:00:00,0,0:00:00,0,0
20160329-ccc_priority_script,2016/03/29,ccc_priority_script,28,27,0:00:15,15,0:01:57,1,405
20160329-ccc_tax_script,2016/03/29,ccc_tax_script,21,18,0:02:20,140,0:06:20,3,2520
20160329-ccc_waste_recycling_script,2016/03/29,ccc_waste_recycling_script,0,0,0:00:00,0,0:00:00,0,0
20160330-ccc_311_calgary_script,2016/03/30,ccc_311_calgary_script,3086,2867,0:00:44,44,0:04:58,219,126148
20160330-ccc_311_lobby_ph_script,2016/03/30,ccc_311_lobby_ph_script,3,3,0:00:06,6,0:00:08,0,18
20160330-ccc_aserv_info_script,2016/03/30,ccc_aserv_info_script,0,0,0:00:00,0,0:00:00,0,0
20160330-ccc_bylaw_script,2016/03/30,ccc_bylaw_script,0,0,0:00:00,0,0:00:00,0,0
20160330-ccc_city_script,2016/03/30,ccc_city_script,23,23,0:00:20,20,0:01:10,0,460
20160330-ccc_cty_online_script,2016/03/30,ccc_cty_online_script,0,0,0:00:00,0,0:00:00,0,0
20160330-ccc_feedback_script,2016/03/30,ccc_feedback_script,1,0,0:00:00,0,0:00:00,0,0
20160330-ccc_fpb_script,2016/03/30,ccc_fpb_script,0,0,0:00:00,0,0:00:00,0,0
20160330-ccc_help_script,2016/03/30,ccc_help_script,6,6,0:00:25,25,0:01:40,0,150
20160330-ccc_link_script,2016/03/30,ccc_link_script,0,0,0:00:00,0,0:00:00,0,0
20160330-ccc_media_line_script,2016/03/30,ccc_media_line_script,0,0,0:00:00,0,0:00:00,0,0
20160330-ccc_priority_script,2016/03/30,ccc_priority_script,28,27,0:00:09,9,0:00:30,1,243
20160330-ccc_tax_script,2016/03/30,ccc_tax_script,22,22,0:00:41,41,0:02:14,0,902
20160330-ccc_waste_recycling_script,2016/03/30,ccc_waste_recycling_script,0,0,0:00:00,0,0:00:00,0,0
20160331-ccc_311_calgary_script,2016/03/31,ccc_311_calgary_script,3199,2944,0:01:01,61,0:05:13,255,179584
20160331-ccc_311_lobby_ph_script,2016/03/31,ccc_311_lobby_ph_script,6,4,0:00:07,7,0:00:13,2,28
20160331-ccc_aserv_info_script,2016/03/31,ccc_aserv_info_script,0,0,0:00:00,0,0:00:00,0,0
20160331-ccc_bylaw_script,2016/03/31,ccc_bylaw_script,0,0,0:00:00,0,0:00:00,0,0
20160331-ccc_city_script,2016/03/31,ccc_city_script,14,13,0:00:14,14,0:00:55,1,182
20160331-ccc_cty_online_script,2016/03/31,ccc_cty_online_script,0,0,0:00:00,0,0:00:00,0,0
20160331-ccc_feedback_script,2016/03/31,ccc_feedback_script,1,0,0:00:00,0,0:00:00,0,0
20160331-ccc_fpb_script,2016/03/31,ccc_fpb_script,1,0,0:00:00,0,0:00:00,1,0
20160331-ccc_help_script,2016/03/31,ccc_help_script,20,16,0:00:05,5,0:00:15,4,80
20160331-ccc_link_script,2016/03/31,ccc_link_script,0,0,0:00:00,0,0:00:00,0,0
20160331-ccc_media_line_script,2016/03/31,ccc_media_line_script,0,0,0:00:00,0,0:00:00,0,0
20160331-ccc_priority_script,2016/03/31,ccc_priority_script,33,33,0:00:13,13,0:01:11,0,429
20160331-ccc_tax_script,2016/03/31,ccc_tax_script,24,20,0:00:57,57,0:02:49,4,1140
20160331-ccc_waste_recycling_script,2016/03/31,ccc_waste_recycling_script,0,0,0:00:00,0,0:00:00,0,0
20160401-ccc_311_calgary_script,2016/04/01,ccc_311_calgary_script,3162,2927,0:00:58,58,0:11:38,235,169766
20160401-ccc_311_lobby_ph_script,2016/04/01,ccc_311_lobby_ph_script,4,4,0:00:11,11,0:00:13,0,44
20160401-ccc_aserv_info_script,2016/04/01,ccc_aserv_info_script,0,0,0:00:00,0,0:00:00,0,0
20160401-ccc_bylaw_script,2016/04/01,ccc_bylaw_script,0,0,0:00:00,0,0:00:00,0,0
20160401-ccc_city_script,2016/04/01,ccc_city_script,24,21,0:00:15,15,0:01:30,3,315
20160401-ccc_cty_online_script,2016/04/01,ccc_cty_online_script,0,0,0:00:00,0,0:00:00,0,0
20160401-ccc_feedback_script,2016/04/01,ccc_feedback_script,0,0,0:00:00,0,0:00:00,0,0
20160401-ccc_fpb_script,2016/04/01,ccc_fpb_script,0,0,0:00:00,0,0:00:00,0,0
20160401-ccc_help_script,2016/04/01,ccc_help_script,15,14,0:00:14,14,0:00:51,1,196
20160401-ccc_link_script,2016/04/01,ccc_link_script,0,0,0:00:00,0,0:00:00,0,0
20160401-ccc_media_line_script,2016/04/01,ccc_media_line_script,3,3,0:00:06,6,0:00:10,0,18
20160401-ccc_priority_script,2016/04/01,ccc_priority_script,25,24,0:00:17,17,0:01:17,1,408
20160401-ccc_tax_script,2016/04/01,ccc_tax_script,15,14,0:01:35,95,0:06:19,1,1330
20160401-ccc_waste_recycling_script,2016/04/01,ccc_waste_recycling_script,0,0,0:00:00,0,0:00:00,0,0
20160402-ccc_311_calgary_script,2016/04/02,ccc_311_calgary_script,1460,1335,0:00:55,55,0:14:04,125,73425
20160402-ccc_311_lobby_ph_script,2016/04/02,ccc_311_lobby_ph_script,0,0,0:00:00,0,0:00:00,0,0
20160402-ccc_aserv_info_script,2016/04/02,ccc_aserv_info_script,0,0,0:00:00,0,0:00:00,0,0
20160402-ccc_bylaw_script,2016/04/02,ccc_bylaw_script,0,0,0:00:00,0,0:00:00,0,0
20160402-ccc_city_script,2016/04/02,ccc_city_script,0,0,0:00:00,0,0:00:00,0,0
20160402-ccc_cty_online_script,2016/04/02,ccc_cty_online_script,0,0,0:00:00,0,0:00:00,0,0
20160402-ccc_feedback_script,2016/04/02,ccc_feedback_script,0,0,0:00:00,0,0:00:00,0,0
20160402-ccc_fpb_script,2016/04/02,ccc_fpb_script,0,0,0:00:00,0,0:00:00,0,0
20160402-ccc_help_script,2016/04/02,ccc_help_script,10,10,0:00:44,44,0:03:36,0,440
20160402-ccc_link_script,2016/04/02,ccc_link_script,0,0,0:00:00,0,0:00:00,0,0
20160402-ccc_media_line_script,2016/04/02,ccc_media_line_script,0,0,0:00:00,0,0:00:00,0,0
20160402-ccc_priority_script,2016/04/02,ccc_priority_script,21,20,0:00:09,9,0:00:32,1,180
20160402-ccc_tax_script,2016/04/02,ccc_tax_script,7,7,0:01:41,101,0:05:21,0,707
20160402-ccc_waste_recycling_script,2016/04/02,ccc_waste_recycling_script,0,0,0:00:00,0,0:00:00,0,0
20160403-ccc_311_calgary_script,2016/04/03,ccc_311_calgary_script,1325,1220,0:00:47,47,0:10:33,105,57340
20160403-ccc_311_lobby_ph_script,2016/04/03,ccc_311_lobby_ph_script,0,0,0:00:00,0,0:00:00,0,0
20160403-ccc_aserv_info_script,2016/04/03,ccc_aserv_info_script,0,0,0:00:00,0,0:00:00,0,0
20160403-ccc_bylaw_script,2016/04/03,ccc_bylaw_script,0,0,0:00:00,0,0:00:00,0,0
20160403-ccc_city_script,2016/04/03,ccc_city_script,0,0,0:00:00,0,0:00:00,0,0
20160403-ccc_cty_online_script,2016/04/03,ccc_cty_online_script,0,0,0:00:00,0,0:00:00,0,0
20160403-ccc_feedback_script,2016/04/03,ccc_feedback_script,0,0,0:00:00,0,0:00:00,0,0
20160403-ccc_fpb_script,2016/04/03,ccc_fpb_script,0,0,0:00:00,0,0:00:00,0,0
20160403-ccc_help_script,2016/04/03,ccc_help_script,0,0,0:00:00,0,0:00:00,0,0
20160403-ccc_link_script,2016/04/03,ccc_link_script,0,0,0:00:00,0,0:00:00,0,0
20160403-ccc_media_line_script,2016/04/03,ccc_media_line_script,2,2,0:00:22,22,0:00:41,0,44
20160403-ccc_priority_script,2016/04/03,ccc_priority_script,20,16,0:00:14,14,0:01:44,4,224
20160403-ccc_tax_script,2016/04/03,ccc_tax_script,2,2,0:00:37,37,0:01:12,0,74
20160403-ccc_waste_recycling_script,2016/04/03,ccc_waste_recycling_script,0,0,0:00:00,0,0:00:00,0,0
20160404-ccc_311_calgary_script,2016/04/04,ccc_311_calgary_script,3577,3338,0:00:57,57,0:10:29,239,190266
20160404-ccc_311_lobby_ph_script,2016/04/04,ccc_311_lobby_ph_script,4,4,0:00:12,12,0:00:32,0,48
20160404-ccc_aserv_info_script,2016/04/04,ccc_aserv_info_script,0,0,0:00:00,0,0:00:00,0,0
20160404-ccc_bylaw_script,2016/04/04,ccc_bylaw_script,0,0,0:00:00,0,0:00:00,0,0
20160404-ccc_city_script,2016/04/04,ccc_city_script,15,15,0:00:05,5,0:00:14,0,75
20160404-ccc_cty_online_script,2016/04/04,ccc_cty_online_script,0,0,0:00:00,0,0:00:00,0,0
20160404-ccc_feedback_script,2016/04/04,ccc_feedback_script,0,0,0:00:00,0,0:00:00,0,0
20160404-ccc_fpb_script,2016/04/04,ccc_fpb_script,0,0,0:00:00,0,0:00:00,0,0
20160404-ccc_help_script,2016/04/04,ccc_help_script,9,8,0:00:12,12,0:00:45,1,96
20160404-ccc_link_script,2016/04/04,ccc_link_script,0,0,0:00:00,0,0:00:00,0,0
20160404-ccc_media_line_script,2016/04/04,ccc_media_line_script,1,1,0:00:11,11,0:00:11,0,11
20160404-ccc_priority_script,2016/04/04,ccc_priority_script,28,26,0:00:14,14,0:01:48,2,364
20160404-ccc_tax_script,2016/04/04,ccc_tax_script,25,24,0:00:21,21,0:01:24,1,504
20160404-ccc_waste_recycling_script,2016/04/04,ccc_waste_recycling_script,0,0,0:00:00,0,0:00:00,0,0
20160405-ccc_311_calgary_script,2016/04/05,ccc_311_calgary_script,3402,2976,0:01:44,104,0:10:31,426,309504
20160405-ccc_311_lobby_ph_script,2016/04/05,ccc_311_lobby_ph_script,4,4,0:00:14,14,0:00:36,0,56
20160405-ccc_aserv_info_script,2016/04/05,ccc_aserv_info_script,0,0,0:00:00,0,0:00:00,0,0
20160405-ccc_bylaw_script,2016/04/05,ccc_bylaw_script,0,0,0:00:00,0,0:00:00,0,0
20160405-ccc_city_script,2016/04/05,ccc_city_script,17,17,0:00:42,42,0:03:35,0,714
20160405-ccc_cty_online_script,2016/04/05,ccc_cty_online_script,0,0,0:00:00,0,0:00:00,0,0
20160405-ccc_feedback_script,2016/04/05,ccc_feedback_script,0,0,0:00:00,0,0:00:00,0,0
20160405-ccc_fpb_script,2016/04/05,ccc_fpb_script,1,0,0:00:00,0,0:00:00,1,0
20160405-ccc_help_script,2016/04/05,ccc_help_script,15,14,0:00:15,15,0:00:56,1,210
20160405-ccc_link_script,2016/04/05,ccc_link_script,0,0,0:00:00,0,0:00:00,0,0
20160405-ccc_media_line_script,2016/04/05,ccc_media_line_script,3,3,0:00:10,10,0:00:22,0,30
20160405-ccc_priority_script,2016/04/05,ccc_priority_script,46,44,0:00:15,15,0:01:23,2,660
20160405-ccc_tax_script,2016/04/05,ccc_tax_script,26,22,0:01:58,118,0:06:42,4,2596
20160405-ccc_waste_recycling_script,2016/04/05,ccc_waste_recycling_script,0,0,0:00:00,0,0:00:00,0,0
20160406-ccc_311_calgary_script,2016/04/06,ccc_311_calgary_script,3280,2941,0:01:13,73,0:10:39,339,214693
20160406-ccc_311_lobby_ph_script,2016/04/06,ccc_311_lobby_ph_script,5,3,0:00:08,8,0:00:14,2,24
20160406-ccc_aserv_info_script,2016/04/06,ccc_aserv_info_script,0,0,0:00:00,0,0:00:00,0,0
20160406-ccc_bylaw_script,2016/04/06,ccc_bylaw_script,0,0,0:00:00,0,0:00:00,0,0
20160406-ccc_city_script,2016/04/06,ccc_city_script,12,12,0:00:26,26,0:02:46,0,312
20160406-ccc_cty_online_script,2016/04/06,ccc_cty_online_script,0,0,0:00:00,0,0:00:00,0,0
20160406-ccc_feedback_script,2016/04/06,ccc_feedback_script,0,0,0:00:00,0,0:00:00,0,0
20160406-ccc_fpb_script,2016/04/06,ccc_fpb_script,0,0,0:00:00,0,0:00:00,0,0
20160406-ccc_help_script,2016/04/06,ccc_help_script,20,17,0:00:15,15,0:00:34,3,255
20160406-ccc_link_script,2016/04/06,ccc_link_script,0,0,0:00:00,0,0:00:00,0,0
20160406-ccc_media_line_script,2016/04/06,ccc_media_line_script,3,3,0:00:07,7,0:00:08,0,21
20160406-ccc_priority_script,2016/04/06,ccc_priority_script,27,25,0:00:24,24,0:03:44,2,600
20160406-ccc_tax_script,2016/04/06,ccc_tax_script,21,20,0:01:13,73,0:03:55,1,1460
20160406-ccc_waste_recycling_script,2016/04/06,ccc_waste_recycling_script,0,0,0:00:00,0,0:00:00,0,0
20160407-ccc_311_calgary_script,2016/04/07,ccc_311_calgary_script,3427,3155,0:00:59,59,0:21:07,272,186145
20160407-ccc_311_lobby_ph_script,2016/04/07,ccc_311_lobby_ph_script,6,6,0:00:10,10,0:00:31,0,60
20160407-ccc_aserv_info_script,2016/04/07,ccc_aserv_info_script,0,0,0:00:00,0,0:00:00,0,0
20160407-ccc_bylaw_script,2016/04/07,ccc_bylaw_script,0,0,0:00:00,0,0:00:00,0,0
20160407-ccc_city_script,2016/04/07,ccc_city_script,14,14,0:00:07,7,0:00:21,0,98
20160407-ccc_cty_online_script,2016/04/07,ccc_cty_online_script,0,0,0:00:00,0,0:00:00,0,0
20160407-ccc_feedback_script,2016/04/07,ccc_feedback_script,0,0,0:00:00,0,0:00:00,0,0
20160407-ccc_fpb_script,2016/04/07,ccc_fpb_script,1,1,0:00:02,2,0:00:02,0,2
20160407-ccc_help_script,2016/04/07,ccc_help_script,19,18,0:00:15,15,0:00:46,1,270
20160407-ccc_link_script,2016/04/07,ccc_link_script,0,0,0:00:00,0,0:00:00,0,0
20160407-ccc_media_line_script,2016/04/07,ccc_media_line_script,0,0,0:00:00,0,0:00:00,0,0
20160407-ccc_priority_script,2016/04/07,ccc_priority_script,40,39,0:00:19,19,0:03:17,1,741
20160407-ccc_tax_script,2016/04/07,ccc_tax_script,21,20,0:00:51,51,0:03:30,1,1020
20160407-ccc_waste_recycling_script,2016/04/07,ccc_waste_recycling_script,0,0,0:00:00,0,0:00:00,0,0
20160408-ccc_311_calgary_script,2016/04/08,ccc_311_calgary_script,3154,2976,0:00:33,33,0:08:51,178,98208
20160408-ccc_311_lobby_ph_script,2016/04/08,ccc_311_lobby_ph_script,3,3,0:00:05,5,0:00:06,0,15
20160408-ccc_aserv_info_script,2016/04/08,ccc_aserv_info_script,0,0,0:00:00,0,0:00:00,0,0
20160408-ccc_bylaw_script,2016/04/08,ccc_bylaw_script,0,0,0:00:00,0,0:00:00,0,0
20160408-ccc_city_script,2016/04/08,ccc_city_script,23,23,0:00:07,7,0:00:22,0,161
20160408-ccc_cty_online_script,2016/04/08,ccc_cty_online_script,0,0,0:00:00,0,0:00:00,0,0
20160408-ccc_feedback_script,2016/04/08,ccc_feedback_script,1,0,0:00:00,0,0:00:00,0,0
20160408-ccc_fpb_script,2016/04/08,ccc_fpb_script,0,0,0:00:00,0,0:00:00,0,0
20160408-ccc_help_script,2016/04/08,ccc_help_script,18,15,0:00:11,11,0:00:42,3,165
20160408-ccc_link_script,2016/04/08,ccc_link_script,0,0,0:00:00,0,0:00:00,0,0
20160408-ccc_media_line_script,2016/04/08,ccc_media_line_script,1,1,0:00:11,11,0:00:11,0,11
20160408-ccc_priority_script,2016/04/08,ccc_priority_script,33,31,0:00:12,12,0:01:03,2,372
20160408-ccc_tax_script,2016/04/08,ccc_tax_script,13,13,0:00:19,19,0:02:20,0,247
20160408-ccc_waste_recycling_script,2016/04/08,ccc_waste_recycling_script,0,0,0:00:00,0,0:00:00,0,0
20160409-ccc_311_calgary_script,2016/04/09,ccc_311_calgary_script,1413,1222,0:01:40,100,0:11:50,191,122200
20160409-ccc_311_lobby_ph_script,2016/04/09,ccc_311_lobby_ph_script,0,0,0:00:00,0,0:00:00,0,0
20160409-ccc_aserv_info_script,2016/04/09,ccc_aserv_info_script,0,0,0:00:00,0,0:00:00,0,0
20160409-ccc_bylaw_script,2016/04/09,ccc_bylaw_script,0,0,0:00:00,0,0:00:00,0,0
20160409-ccc_city_script,2016/04/09,ccc_city_script,0,0,0:00:00,0,0:00:00,0,0
20160409-ccc_cty_online_script,2016/04/09,ccc_cty_online_script,0,0,0:00:00,0,0:00:00,0,0
20160409-ccc_feedback_script,2016/04/09,ccc_feedback_script,0,0,0:00:00,0,0:00:00,0,0
20160409-ccc_fpb_script,2016/04/09,ccc_fpb_script,0,0,0:00:00,0,0:00:00,0,0
20160409-ccc_help_script,2016/04/09,ccc_help_script,1,1,0:01:24,84,0:01:24,0,84
20160409-ccc_link_script,2016/04/09,ccc_link_script,0,0,0:00:00,0,0:00:00,0,0
20160409-ccc_media_line_script,2016/04/09,ccc_media_line_script,0,0,0:00:00,0,0:00:00,0,0
20160409-ccc_priority_script,2016/04/09,ccc_priority_script,24,21,0:00:10,10,0:01:04,3,210
20160409-ccc_tax_script,2016/04/09,ccc_tax_script,2,2,0:05:19,319,0:10:36,0,638
20160409-ccc_waste_recycling_script,2016/04/09,ccc_waste_recycling_script,0,0,0:00:00,0,0:00:00,0,0
20160410-ccc_311_calgary_script,2016/04/10,ccc_311_calgary_script,1099,1034,0:00:33,33,0:06:27,65,34122
20160410-ccc_311_lobby_ph_script,2016/04/10,ccc_311_lobby_ph_script,0,0,0:00:00,0,0:00:00,0,0
20160410-ccc_aserv_info_script,2016/04/10,ccc_aserv_info_script,0,0,0:00:00,0,0:00:00,0,0
20160410-ccc_bylaw_script,2016/04/10,ccc_bylaw_script,0,0,0:00:00,0,0:00:00,0,0
20160410-ccc_city_script,2016/04/10,ccc_city_script,0,0,0:00:00,0,0:00:00,0,0
20160410-ccc_cty_online_script,2016/04/10,ccc_cty_online_script,0,0,0:00:00,0,0:00:00,0,0
20160410-ccc_feedback_script,2016/04/10,ccc_feedback_script,0,0,0:00:00,0,0:00:00,0,0
20160410-ccc_fpb_script,2016/04/10,ccc_fpb_script,0,0,0:00:00,0,0:00:00,0,0
20160410-ccc_help_script,2016/04/10,ccc_help_script,2,2,0:01:35,95,0:03:05,0,190
20160410-ccc_link_script,2016/04/10,ccc_link_script,0,0,0:00:00,0,0:00:00,0,0
20160410-ccc_media_line_script,2016/04/10,ccc_media_line_script,3,3,0:00:04,4,0:00:05,0,12
20160410-ccc_priority_script,2016/04/10,ccc_priority_script,11,11,0:00:08,8,0:00:22,0,88
20160410-ccc_tax_script,2016/04/10,ccc_tax_script,0,0,0:00:00,0,0:00:00,0,0
20160410-ccc_waste_recycling_script,2016/04/10,ccc_waste_recycling_script,0,0,0:00:00,0,0:00:00,0,0
20160411-ccc_311_calgary_script,2016/04/11,ccc_311_calgary_script,3570,3465,0:00:26,26,0:07:37,105,90090
20160411-ccc_311_lobby_ph_script,2016/04/11,ccc_311_lobby_ph_script,4,4,0:00:04,4,0:00:06,0,16
20160411-ccc_aserv_info_script,2016/04/11,ccc_aserv_info_script,0,0,0:00:00,0,0:00:00,0,0
20160411-ccc_bylaw_script,2016/04/11,ccc_bylaw_script,0,0,0:00:00,0,0:00:00,0,0
20160411-ccc_city_script,2016/04/11,ccc_city_script,30,30,0:00:13,13,0:01:51,0,390
20160411-ccc_cty_online_script,2016/04/11,ccc_cty_online_script,0,0,0:00:00,0,0:00:00,0,0
20160411-ccc_feedback_script,2016/04/11,ccc_feedback_script,0,0,0:00:00,0,0:00:00,0,0
20160411-ccc_fpb_script,2016/04/11,ccc_fpb_script,0,0,0:00:00,0,0:00:00,0,0
20160411-ccc_help_script,2016/04/11,ccc_help_script,16,15,0:00:10,10,0:00:33,1,150
20160411-ccc_link_script,2016/04/11,ccc_link_script,0,0,0:00:00,0,0:00:00,0,0
20160411-ccc_media_line_script,2016/04/11,ccc_media_line_script,1,1,0:00:02,2,0:00:02,0,2
20160411-ccc_priority_script,2016/04/11,ccc_priority_script,28,24,0:00:07,7,0:00:45,4,168
20160411-ccc_tax_script,2016/04/11,ccc_tax_script,25,24,0:00:28,28,0:02:13,1,672
20160411-ccc_waste_recycling_script,2016/04/11,ccc_waste_recycling_script,0,0,0:00:00,0,0:00:00,0,0
20160412-ccc_311_calgary_script,2016/04/12,ccc_311_calgary_script,3391,3084,0:01:22,82,0:07:08,307,252888
20160412-ccc_311_lobby_ph_script,2016/04/12,ccc_311_lobby_ph_script,0,0,0:00:00,0,0:00:00,0,0
20160412-ccc_aserv_info_script,2016/04/12,ccc_aserv_info_script,0,0,0:00:00,0,0:00:00,0,0
20160412-ccc_bylaw_script,2016/04/12,ccc_bylaw_script,0,0,0:00:00,0,0:00:00,0,0
20160412-ccc_city_script,2016/04/12,ccc_city_script,45,44,0:00:39,39,0:04:02,1,1716
20160412-ccc_cty_online_script,2016/04/12,ccc_cty_online_script,0,0,0:00:00,0,0:00:00,0,0
20160412-ccc_feedback_script,2016/04/12,ccc_feedback_script,1,0,0:00:00,0,0:00:00,0,0
20160412-ccc_fpb_script,2016/04/12,ccc_fpb_script,1,1,0:05:26,326,0:05:26,0,326
20160412-ccc_help_script,2016/04/12,ccc_help_script,11,10,0:00:17,17,0:00:51,1,170
20160412-ccc_link_script,2016/04/12,ccc_link_script,0,0,0:00:00,0,0:00:00,0,0
20160412-ccc_media_line_script,2016/04/12,ccc_media_line_script,0,0,0:00:00,0,0:00:00,0,0
20160412-ccc_priority_script,2016/04/12,ccc_priority_script,35,34,0:00:12,12,0:00:58,1,408
20160412-ccc_tax_script,2016/04/12,ccc_tax_script,22,20,0:02:08,128,0:06:16,2,2560
20160412-ccc_waste_recycling_script,2016/04/12,ccc_waste_recycling_script,0,0,0:00:00,0,0:00:00,0,0
20160413-ccc_311_calgary_script,2016/04/13,ccc_311_calgary_script,3635,3073,0:02:24,144,0:11:00,562,442512
20160413-ccc_311_lobby_ph_script,2016/04/13,ccc_311_lobby_ph_script,1,1,0:00:11,11,0:00:11,0,11
20160413-ccc_aserv_info_script,2016/04/13,ccc_aserv_info_script,0,0,0:00:00,0,0:00:00,0,0
20160413-ccc_bylaw_script,2016/04/13,ccc_bylaw_script,0,0,0:00:00,0,0:00:00,0,0
20160413-ccc_city_script,2016/04/13,ccc_city_script,25,23,0:00:49,49,0:03:49,2,1127
20160413-ccc_cty_online_script,2016/04/13,ccc_cty_online_script,0,0,0:00:00,0,0:00:00,0,0
20160413-ccc_feedback_script,2016/04/13,ccc_feedback_script,0,0,0:00:00,0,0:00:00,0,0
20160413-ccc_fpb_script,2016/04/13,ccc_fpb_script,1,0,0:00:00,0,0:00:00,1,0
20160413-ccc_help_script,2016/04/13,ccc_help_script,33,26,0:00:15,15,0:00:59,7,390
20160413-ccc_link_script,2016/04/13,ccc_link_script,0,0,0:00:00,0,0:00:00,0,0
20160413-ccc_media_line_script,2016/04/13,ccc_media_line_script,0,0,0:00:00,0,0:00:00,0,0
20160413-ccc_priority_script,2016/04/13,ccc_priority_script,24,23,0:00:17,17,0:01:15,1,391
20160413-ccc_tax_script,2016/04/13,ccc_tax_script,17,13,0:02:56,176,0:08:28,4,2288
20160413-ccc_waste_recycling_script,2016/04/13,ccc_waste_recycling_script,0,0,0:00:00,0,0:00:00,0,0
20160414-ccc_311_calgary_script,2016/04/14,ccc_311_calgary_script,3143,3038,0:00:24,24,0:08:30,105,72912
20160414-ccc_311_lobby_ph_script,2016/04/14,ccc_311_lobby_ph_script,8,7,0:00:10,10,0:00:18,1,70
20160414-ccc_aserv_info_script,2016/04/14,ccc_aserv_info_script,0,0,0:00:00,0,0:00:00,0,0
20160414-ccc_bylaw_script,2016/04/14,ccc_bylaw_script,0,0,0:00:00,0,0:00:00,0,0
20160414-ccc_city_script,2016/04/14,ccc_city_script,28,27,0:00:13,13,0:01:01,1,351
20160414-ccc_cty_online_script,2016/04/14,ccc_cty_online_script,0,0,0:00:00,0,0:00:00,0,0
20160414-ccc_feedback_script,2016/04/14,ccc_feedback_script,0,0,0:00:00,0,0:00:00,0,0
20160414-ccc_fpb_script,2016/04/14,ccc_fpb_script,1,1,0:00:08,8,0:00:08,0,8
20160414-ccc_help_script,2016/04/14,ccc_help_script,16,16,0:00:12,12,0:00:40,0,192
20160414-ccc_link_script,2016/04/14,ccc_link_script,0,0,0:00:00,0,0:00:00,0,0
20160414-ccc_media_line_script,2016/04/14,ccc_media_line_script,0,0,0:00:00,0,0:00:00,0,0
20160414-ccc_priority_script,2016/04/14,ccc_priority_script,22,21,0:00:08,8,0:00:35,1,168
20160414-ccc_tax_script,2016/04/14,ccc_tax_script,21,20,0:00:29,29,0:01:46,1,580
20160414-ccc_waste_recycling_script,2016/04/14,ccc_waste_recycling_script,0,0,0:00:00,0,0:00:00,0,0
20160415-ccc_311_calgary_script,2016/04/15,ccc_311_calgary_script,3159,2758,0:01:49,109,0:10:06,401,300622
20160415-ccc_311_lobby_ph_script,2016/04/15,ccc_311_lobby_ph_script,4,3,0:00:20,20,0:00:34,1,60
20160415-ccc_aserv_info_script,2016/04/15,ccc_aserv_info_script,0,0,0:00:00,0,0:00:00,0,0
20160415-ccc_bylaw_script,2016/04/15,ccc_bylaw_script,0,0,0:00:00,0,0:00:00,0,0
20160415-ccc_city_script,2016/04/15,ccc_city_script,16,16,0:00:39,39,0:05:43,0,624
20160415-ccc_cty_online_script,2016/04/15,ccc_cty_online_script,0,0,0:00:00,0,0:00:00,0,0
20160415-ccc_feedback_script,2016/04/15,ccc_feedback_script,0,0,0:00:00,0,0:00:00,0,0
20160415-ccc_fpb_script,2016/04/15,ccc_fpb_script,1,0,0:00:00,0,0:00:00,1,0
20160415-ccc_help_script,2016/04/15,ccc_help_script,10,9,0:00:17,17,0:00:52,1,153
20160415-ccc_link_script,2016/04/15,ccc_link_script,1,0,0:00:00,0,0:00:00,0,0
20160415-ccc_media_line_script,2016/04/15,ccc_media_line_script,2,2,0:00:10,10,0:00:13,0,20
20160415-ccc_priority_script,2016/04/15,ccc_priority_script,28,27,0:00:11,11,0:01:08,1,297
20160415-ccc_tax_script,2016/04/15,ccc_tax_script,26,25,0:01:47,107,0:08:38,1,2675
20160415-ccc_waste_recycling_script,2016/04/15,ccc_waste_recycling_script,0,0,0:00:00,0,0:00:00,0,0
20160416-ccc_311_calgary_script,2016/04/16,ccc_311_calgary_script,1353,1284,0:00:37,37,0:08:47,69,47508
20160416-ccc_311_lobby_ph_script,2016/04/16,ccc_311_lobby_ph_script,0,0,0:00:00,0,0:00:00,0,0
20160416-ccc_aserv_info_script,2016/04/16,ccc_aserv_info_script,0,0,0:00:00,0,0:00:00,0,0
20160416-ccc_bylaw_script,2016/04/16,ccc_bylaw_script,0,0,0:00:00,0,0:00:00,0,0
20160416-ccc_city_script,2016/04/16,ccc_city_script,0,0,0:00:00,0,0:00:00,0,0
20160416-ccc_cty_online_script,2016/04/16,ccc_cty_online_script,0,0,0:00:00,0,0:00:00,0,0
20160416-ccc_feedback_script,2016/04/16,ccc_feedback_script,0,0,0:00:00,0,0:00:00,0,0
20160416-ccc_fpb_script,2016/04/16,ccc_fpb_script,0,0,0:00:00,0,0:00:00,0,0
20160416-ccc_help_script,2016/04/16,ccc_help_script,2,1,0:00:08,8,0:00:08,1,8
20160416-ccc_link_script,2016/04/16,ccc_link_script,0,0,0:00:00,0,0:00:00,0,0
20160416-ccc_media_line_script,2016/04/16,ccc_media_line_script,0,0,0:00:00,0,0:00:00,0,0
20160416-ccc_priority_script,2016/04/16,ccc_priority_script,19,18,0:00:19,19,0:02:09,1,342
20160416-ccc_tax_script,2016/04/16,ccc_tax_script,3,3,0:01:10,70,0:03:24,0,210
20160416-ccc_waste_recycling_script,2016/04/16,ccc_waste_recycling_script,0,0,0:00:00,0,0:00:00,0,0
20160417-ccc_311_calgary_script,2016/04/17,ccc_311_calgary_script,1251,1165,0:00:45,45,0:08:13,86,52425
20160417-ccc_311_lobby_ph_script,2016/04/17,ccc_311_lobby_ph_script,0,0,0:00:00,0,0:00:00,0,0
20160417-ccc_aserv_info_script,2016/04/17,ccc_aserv_info_script,0,0,0:00:00,0,0:00:00,0,0
20160417-ccc_bylaw_script,2016/04/17,ccc_bylaw_script,0,0,0:00:00,0,0:00:00,0,0
20160417-ccc_city_script,2016/04/17,ccc_city_script,0,0,0:00:00,0,0:00:00,0,0
20160417-ccc_cty_online_script,2016/04/17,ccc_cty_online_script,0,0,0:00:00,0,0:00:00,0,0
20160417-ccc_feedback_script,2016/04/17,ccc_feedback_script,0,0,0:00:00,0,0:00:00,0,0
20160417-ccc_fpb_script,2016/04/17,ccc_fpb_script,0,0,0:00:00,0,0:00:00,0,0
20160417-ccc_help_script,2016/04/17,ccc_help_script,3,2,0:00:08,8,0:00:10,1,16
20160417-ccc_link_script,2016/04/17,ccc_link_script,0,0,0:00:00,0,0:00:00,0,0
20160417-ccc_media_line_script,2016/04/17,ccc_media_line_script,2,2,0:00:05,5,0:00:08,0,10
20160417-ccc_priority_script,2016/04/17,ccc_priority_script,25,24,0:00:18,18,0:01:24,1,432
20160417-ccc_tax_script,2016/04/17,ccc_tax_script,3,3,0:00:17,17,0:00:45,0,51
20160417-ccc_waste_recycling_script,2016/04/17,ccc_waste_recycling_script,0,0,0:00:00,0,0:00:00,0,0
20160418-ccc_311_calgary_script,2016/04/18,ccc_311_calgary_script,3964,3603,0:01:19,79,0:06:49,361,284637
20160418-ccc_311_lobby_ph_script,2016/04/18,ccc_311_lobby_ph_script,3,3,0:00:15,15,0:00:18,0,45
20160418-ccc_aserv_info_script,2016/04/18,ccc_aserv_info_script,0,0,0:00:00,0,0:00:00,0,0
20160418-ccc_bylaw_script,2016/04/18,ccc_bylaw_script,0,0,0:00:00,0,0:00:00,0,0
20160418-ccc_city_script,2016/04/18,ccc_city_script,13,13,0:00:39,39,0:03:48,0,507
20160418-ccc_cty_online_script,2016/04/18,ccc_cty_online_script,0,0,0:00:00,0,0:00:00,0,0
20160418-ccc_feedback_script,2016/04/18,ccc_feedback_script,0,0,0:00:00,0,0:00:00,0,0
20160418-ccc_fpb_script,2016/04/18,ccc_fpb_script,2,1,0:00:02,2,0:00:02,1,2
20160418-ccc_help_script,2016/04/18,ccc_help_script,32,26,0:00:12,12,0:00:36,6,312
20160418-ccc_link_script,2016/04/18,ccc_link_script,0,0,0:00:00,0,0:00:00,0,0
20160418-ccc_media_line_script,2016/04/18,ccc_media_line_script,1,1,0:00:07,7,0:00:07,0,7
20160418-ccc_priority_script,2016/04/18,ccc_priority_script,27,26,0:00:12,12,0:01:05,1,312
20160418-ccc_tax_script,2016/04/18,ccc_tax_script,20,19,0:01:29,89,0:05:22,1,1691
20160418-ccc_waste_recycling_script,2016/04/18,ccc_waste_recycling_script,0,0,0:00:00,0,0:00:00,0,0
20160419-ccc_311_calgary_script,2016/04/19,ccc_311_calgary_script,3889,3498,0:01:23,83,0:11:44,391,290334
20160419-ccc_311_lobby_ph_script,2016/04/19,ccc_311_lobby_ph_script,5,5,0:00:08,8,0:00:29,0,40
20160419-ccc_aserv_info_script,2016/04/19,ccc_aserv_info_script,0,0,0:00:00,0,0:00:00,0,0
20160419-ccc_bylaw_script,2016/04/19,ccc_bylaw_script,0,0,0:00:00,0,0:00:00,0,0
20160419-ccc_city_script,2016/04/19,ccc_city_script,11,11,0:00:16,16,0:00:39,0,176
20160419-ccc_cty_online_script,2016/04/19,ccc_cty_online_script,0,0,0:00:00,0,0:00:00,0,0
20160419-ccc_feedback_script,2016/04/19,ccc_feedback_script,0,0,0:00:00,0,0:00:00,0,0
20160419-ccc_fpb_script,2016/04/19,ccc_fpb_script,1,1,0:01:48,108,0:01:48,0,108
20160419-ccc_help_script,2016/04/19,ccc_help_script,20,18,0:00:18,18,0:00:55,2,324
20160419-ccc_link_script,2016/04/19,ccc_link_script,0,0,0:00:00,0,0:00:00,0,0
20160419-ccc_media_line_script,2016/04/19,ccc_media_line_script,0,0,0:00:00,0,0:00:00,0,0
20160419-ccc_priority_script,2016/04/19,ccc_priority_script,27,27,0:00:12,12,0:00:52,0,324
20160419-ccc_tax_script,2016/04/19,ccc_tax_script,19,17,0:01:34,94,0:04:29,2,1598
20160419-ccc_waste_recycling_script,2016/04/19,ccc_waste_recycling_script,0,0,0:00:00,0,0:00:00,0,0
20160420-ccc_311_calgary_script,2016/04/20,ccc_311_calgary_script,3647,3371,0:01:11,71,0:09:44,276,239341
20160420-ccc_311_lobby_ph_script,2016/04/20,ccc_311_lobby_ph_script,4,4,0:00:05,5,0:00:08,0,20
20160420-ccc_aserv_info_script,2016/04/20,ccc_aserv_info_script,0,0,0:00:00,0,0:00:00,0,0
20160420-ccc_bylaw_script,2016/04/20,ccc_bylaw_script,0,0,0:00:00,0,0:00:00,0,0
20160420-ccc_city_script,2016/04/20,ccc_city_script,18,18,0:00:10,10,0:00:31,0,180
20160420-ccc_cty_online_script,2016/04/20,ccc_cty_online_script,0,0,0:00:00,0,0:00:00,0,0
20160420-ccc_feedback_script,2016/04/20,ccc_feedback_script,0,0,0:00:00,0,0:00:00,0,0
20160420-ccc_fpb_script,2016/04/20,ccc_fpb_script,0,0,0:00:00,0,0:00:00,0,0
20160420-ccc_help_script,2016/04/20,ccc_help_script,22,21,0:00:14,14,0:01:12,1,294
20160420-ccc_link_script,2016/04/20,ccc_link_script,0,0,0:00:00,0,0:00:00,0,0
20160420-ccc_media_line_script,2016/04/20,ccc_media_line_script,1,1,0:00:30,30,0:00:30,0,30
20160420-ccc_priority_script,2016/04/20,ccc_priority_script,37,36,0:00:12,12,0:00:45,1,432
20160420-ccc_tax_script,2016/04/20,ccc_tax_script,18,17,0:00:49,49,0:02:20,1,833
20160420-ccc_waste_recycling_script,2016/04/20,ccc_waste_recycling_script,0,0,0:00:00,0,0:00:00,0,0
20160421-ccc_311_calgary_script,2016/04/21,ccc_311_calgary_script,3442,3193,0:00:55,55,0:13:03,249,175615
20160421-ccc_311_lobby_ph_script,2016/04/21,ccc_311_lobby_ph_script,0,0,0:00:00,0,0:00:00,0,0
20160421-ccc_aserv_info_script,2016/04/21,ccc_aserv_info_script,0,0,0:00:00,0,0:00:00,0,0
20160421-ccc_bylaw_script,2016/04/21,ccc_bylaw_script,0,0,0:00:00,0,0:00:00,0,0
20160421-ccc_city_script,2016/04/21,ccc_city_script,19,17,0:00:13,13,0:00:38,2,221
20160421-ccc_cty_online_script,2016/04/21,ccc_cty_online_script,0,0,0:00:00,0,0:00:00,0,0
20160421-ccc_feedback_script,2016/04/21,ccc_feedback_script,0,0,0:00:00,0,0:00:00,0,0
20160421-ccc_fpb_script,2016/04/21,ccc_fpb_script,1,1,0:00:04,4,0:00:04,0,4
20160421-ccc_help_script,2016/04/21,ccc_help_script,51,49,0:00:21,21,0:01:09,2,1029
20160421-ccc_link_script,2016/04/21,ccc_link_script,0,0,0:00:00,0,0:00:00,0,0
20160421-ccc_media_line_script,2016/04/21,ccc_media_line_script,0,0,0:00:00,0,0:00:00,0,0
20160421-ccc_priority_script,2016/04/21,ccc_priority_script,25,23,0:00:14,14,0:00:59,2,322
20160421-ccc_tax_script,2016/04/21,ccc_tax_script,15,12,0:01:07,67,0:03:03,3,804
20160421-ccc_waste_recycling_script,2016/04/21,ccc_waste_recycling_script,0,0,0:00:00,0,0:00:00,0,0
20160422-ccc_311_calgary_script,2016/04/22,ccc_311_calgary_script,3111,2819,0:01:29,89,0:10:51,292,250891
20160422-ccc_311_lobby_ph_script,2016/04/22,ccc_311_lobby_ph_script,2,1,0:00:45,45,0:00:45,1,45
20160422-ccc_aserv_info_script,2016/04/22,ccc_aserv_info_script,0,0,0:00:00,0,0:00:00,0,0
20160422-ccc_bylaw_script,2016/04/22,ccc_bylaw_script,0,0,0:00:00,0,0:00:00,0,0
20160422-ccc_city_script,2016/04/22,ccc_city_script,13,13,0:00:37,37,0:04:39,0,481
20160422-ccc_cty_online_script,2016/04/22,ccc_cty_online_script,0,0,0:00:00,0,0:00:00,0,0
20160422-ccc_feedback_script,2016/04/22,ccc_feedback_script,0,0,0:00:00,0,0:00:00,0,0
20160422-ccc_fpb_script,2016/04/22,ccc_fpb_script,1,0,0:00:00,0,0:00:00,1,0
20160422-ccc_help_script,2016/04/22,ccc_help_script,38,35,0:00:19,19,0:02:23,3,665
20160422-ccc_link_script,2016/04/22,ccc_link_script,0,0,0:00:00,0,0:00:00,0,0
20160422-ccc_media_line_script,2016/04/22,ccc_media_line_script,4,3,0:00:11,11,0:00:13,1,33
20160422-ccc_priority_script,2016/04/22,ccc_priority_script,22,20,0:00:10,10,0:00:25,2,200
20160422-ccc_tax_script,2016/04/22,ccc_tax_script,21,15,0:02:32,152,0:10:19,6,2280
20160422-ccc_waste_recycling_script,2016/04/22,ccc_waste_recycling_script,0,0,0:00:00,0,0:00:00,0,0
20160423-ccc_311_calgary_script,2016/04/23,ccc_311_calgary_script,1201,1110,0:00:53,53,0:11:18,91,58830
20160423-ccc_311_lobby_ph_script,2016/04/23,ccc_311_lobby_ph_script,0,0,0:00:00,0,0:00:00,0,0
20160423-ccc_aserv_info_script,2016/04/23,ccc_aserv_info_script,0,0,0:00:00,0,0:00:00,0,0
20160423-ccc_bylaw_script,2016/04/23,ccc_bylaw_script,0,0,0:00:00,0,0:00:00,0,0
20160423-ccc_city_script,2016/04/23,ccc_city_script,0,0,0:00:00,0,0:00:00,0,0
20160423-ccc_cty_online_script,2016/04/23,ccc_cty_online_script,0,0,0:00:00,0,0:00:00,0,0
20160423-ccc_feedback_script,2016/04/23,ccc_feedback_script,0,0,0:00:00,0,0:00:00,0,0
20160423-ccc_fpb_script,2016/04/23,ccc_fpb_script,0,0,0:00:00,0,0:00:00,0,0
20160423-ccc_help_script,2016/04/23,ccc_help_script,0,0,0:00:00,0,0:00:00,0,0
20160423-ccc_link_script,2016/04/23,ccc_link_script,0,0,0:00:00,0,0:00:00,0,0
20160423-ccc_media_line_script,2016/04/23,ccc_media_line_script,0,0,0:00:00,0,0:00:00,0,0
20160423-ccc_priority_script,2016/04/23,ccc_priority_script,25,21,0:00:14,14,0:01:24,4,294
20160423-ccc_tax_script,2016/04/23,ccc_tax_script,3,3,0:00:06,6,0:00:06,0,18
20160423-ccc_waste_recycling_script,2016/04/23,ccc_waste_recycling_script,0,0,0:00:00,0,0:00:00,0,0
20160424-ccc_311_calgary_script,2016/04/24,ccc_311_calgary_script,943,925,0:00:13,13,0:04:46,18,12025
20160424-ccc_311_lobby_ph_script,2016/04/24,ccc_311_lobby_ph_script,0,0,0:00:00,0,0:00:00,0,0
20160424-ccc_aserv_info_script,2016/04/24,ccc_aserv_info_script,0,0,0:00:00,0,0:00:00,0,0
20160424-ccc_bylaw_script,2016/04/24,ccc_bylaw_script,0,0,0:00:00,0,0:00:00,0,0
20160424-ccc_city_script,2016/04/24,ccc_city_script,0,0,0:00:00,0,0:00:00,0,0
20160424-ccc_cty_online_script,2016/04/24,ccc_cty_online_script,0,0,0:00:00,0,0:00:00,0,0
20160424-ccc_feedback_script,2016/04/24,ccc_feedback_script,1,0,0:00:00,0,0:00:00,0,0
20160424-ccc_fpb_script,2016/04/24,ccc_fpb_script,0,0,0:00:00,0,0:00:00,0,0
20160424-ccc_help_script,2016/04/24,ccc_help_script,4,4,0:00:16,16,0:00:43,0,64
20160424-ccc_link_script,2016/04/24,ccc_link_script,0,0,0:00:00,0,0:00:00,0,0
20160424-ccc_media_line_script,2016/04/24,ccc_media_line_script,1,1,0:00:06,6,0:00:06,0,6
20160424-ccc_priority_script,2016/04/24,ccc_priority_script,16,14,0:00:14,14,0:01:46,2,196
20160424-ccc_tax_script,2016/04/24,ccc_tax_script,2,2,0:00:02,2,0:00:02,0,4
20160424-ccc_waste_recycling_script,2016/04/24,ccc_waste_recycling_script,0,0,0:00:00,0,0:00:00,0,0
20160425-ccc_311_calgary_script,2016/04/25,ccc_311_calgary_script,3328,3265,0:00:18,18,0:05:19,63,58770
20160425-ccc_311_lobby_ph_script,2016/04/25,ccc_311_lobby_ph_script,3,3,0:00:05,5,0:00:06,0,15
20160425-ccc_aserv_info_script,2016/04/25,ccc_aserv_info_script,0,0,0:00:00,0,0:00:00,0,0
20160425-ccc_bylaw_script,2016/04/25,ccc_bylaw_script,0,0,0:00:00,0,0:00:00,0,0
20160425-ccc_city_script,2016/04/25,ccc_city_script,29,29,0:00:06,6,0:00:24,0,174
20160425-ccc_cty_online_script,2016/04/25,ccc_cty_online_script,0,0,0:00:00,0,0:00:00,0,0
20160425-ccc_feedback_script,2016/04/25,ccc_feedback_script,0,0,0:00:00,0,0:00:00,0,0
20160425-ccc_fpb_script,2016/04/25,ccc_fpb_script,2,2,0:00:04,4,0:00:05,0,8
20160425-ccc_help_script,2016/04/25,ccc_help_script,68,67,0:00:08,8,0:00:45,1,536
20160425-ccc_link_script,2016/04/25,ccc_link_script,0,0,0:00:00,0,0:00:00,0,0
20160425-ccc_media_line_script,2016/04/25,ccc_media_line_script,2,2,0:00:07,7,0:00:07,0,14
20160425-ccc_priority_script,2016/04/25,ccc_priority_script,27,25,0:00:08,8,0:00:52,2,200
20160425-ccc_tax_script,2016/04/25,ccc_tax_script,14,14,0:00:25,25,0:01:44,0,350
20160425-ccc_waste_recycling_script,2016/04/25,ccc_waste_recycling_script,0,0,0:00:00,0,0:00:00,0,0
20160426-ccc_311_calgary_script,2016/04/26,ccc_311_calgary_script,3316,3121,0:00:50,50,0:06:05,195,156050
20160426-ccc_311_lobby_ph_script,2016/04/26,ccc_311_lobby_ph_script,3,2,0:00:04,4,0:00:04,1,8
20160426-ccc_aserv_info_script,2016/04/26,ccc_aserv_info_script,0,0,0:00:00,0,0:00:00,0,0
20160426-ccc_bylaw_script,2016/04/26,ccc_bylaw_script,0,0,0:00:00,0,0:00:00,0,0
20160426-ccc_city_script,2016/04/26,ccc_city_script,19,19,0:00:18,18,0:02:55,0,342
20160426-ccc_cty_online_script,2016/04/26,ccc_cty_online_script,0,0,0:00:00,0,0:00:00,0,0
20160426-ccc_feedback_script,2016/04/26,ccc_feedback_script,0,0,0:00:00,0,0:00:00,0,0
20160426-ccc_fpb_script,2016/04/26,ccc_fpb_script,1,1,0:00:10,10,0:00:10,0,10
20160426-ccc_help_script,2016/04/26,ccc_help_script,23,21,0:00:22,22,0:01:10,2,462
20160426-ccc_link_script,2016/04/26,ccc_link_script,0,0,0:00:00,0,0:00:00,0,0
20160426-ccc_media_line_script,2016/04/26,ccc_media_line_script,1,1,0:00:17,17,0:00:17,0,17
20160426-ccc_priority_script,2016/04/26,ccc_priority_script,23,22,0:00:15,15,0:01:23,1,330
20160426-ccc_tax_script,2016/04/26,ccc_tax_script,11,10,0:00:41,41,0:01:52,1,410
20160426-ccc_waste_recycling_script,2016/04/26,ccc_waste_recycling_script,0,0,0:00:00,0,0:00:00,0,0
20160427-ccc_311_calgary_script,2016/04/27,ccc_311_calgary_script,3393,3015,0:01:37,97,0:07:59,378,292455
20160427-ccc_311_lobby_ph_script,2016/04/27,ccc_311_lobby_ph_script,4,3,0:00:10,10,0:00:15,1,30
20160427-ccc_aserv_info_script,2016/04/27,ccc_aserv_info_script,0,0,0:00:00,0,0:00:00,0,0
20160427-ccc_bylaw_script,2016/04/27,ccc_bylaw_script,0,0,0:00:00,0,0:00:00,0,0
20160427-ccc_city_script,2016/04/27,ccc_city_script,22,21,0:00:24,24,0:01:24,1,504
20160427-ccc_cty_online_script,2016/04/27,ccc_cty_online_script,0,0,0:00:00,0,0:00:00,0,0
20160427-ccc_feedback_script,2016/04/27,ccc_feedback_script,0,0,0:00:00,0,0:00:00,0,0
20160427-ccc_fpb_script,2016/04/27,ccc_fpb_script,0,0,0:00:00,0,0:00:00,0,0
20160427-ccc_help_script,2016/04/27,ccc_help_script,63,58,0:00:16,16,0:00:53,5,928
20160427-ccc_link_script,2016/04/27,ccc_link_script,0,0,0:00:00,0,0:00:00,0,0
20160427-ccc_media_line_script,2016/04/27,ccc_media_line_script,5,3,0:00:21,21,0:00:26,2,63
20160427-ccc_priority_script,2016/04/27,ccc_priority_script,30,29,0:00:15,15,0:01:24,1,435
20160427-ccc_tax_script,2016/04/27,ccc_tax_script,25,22,0:01:30,90,0:07:49,3,1980
20160427-ccc_waste_recycling_script,2016/04/27,ccc_waste_recycling_script,0,0,0:00:00,0,0:00:00,0,0
20160428-ccc_311_calgary_script,2016/04/28,ccc_311_calgary_script,3226,3011,0:00:48,48,0:10:42,215,144528
20160428-ccc_311_lobby_ph_script,2016/04/28,ccc_311_lobby_ph_script,4,4,0:00:05,5,0:00:09,0,20
20160428-ccc_aserv_info_script,2016/04/28,ccc_aserv_info_script,0,0,0:00:00,0,0:00:00,0,0
20160428-ccc_bylaw_script,2016/04/28,ccc_bylaw_script,0,0,0:00:00,0,0:00:00,0,0
20160428-ccc_city_script,2016/04/28,ccc_city_script,15,15,0:00:12,12,0:00:38,0,180
20160428-ccc_cty_online_script,2016/04/28,ccc_cty_online_script,0,0,0:00:00,0,0:00:00,0,0
20160428-ccc_feedback_script,2016/04/28,ccc_feedback_script,1,0,0:00:00,0,0:00:00,0,0
20160428-ccc_fpb_script,2016/04/28,ccc_fpb_script,1,1,0:03:14,194,0:03:14,0,194
20160428-ccc_help_script,2016/04/28,ccc_help_script,16,15,0:00:12,12,0:01:05,1,180
20160428-ccc_link_script,2016/04/28,ccc_link_script,0,0,0:00:00,0,0:00:00,0,0
20160428-ccc_media_line_script,2016/04/28,ccc_media_line_script,0,0,0:00:00,0,0:00:00,0,0
20160428-ccc_priority_script,2016/04/28,ccc_priority_script,29,29,0:00:10,10,0:00:35,0,290
20160428-ccc_tax_script,2016/04/28,ccc_tax_script,15,14,0:01:00,60,0:03:37,1,840
20160428-ccc_waste_recycling_script,2016/04/28,ccc_waste_recycling_script,0,0,0:00:00,0,0:00:00,0,0
20160429-ccc_311_calgary_script,2016/04/29,ccc_311_calgary_script,3201,2718,0:02:23,143,0:10:16,483,388674
20160429-ccc_311_lobby_ph_script,2016/04/29,ccc_311_lobby_ph_script,0,0,0:00:00,0,0:00:00,0,0
20160429-ccc_aserv_info_script,2016/04/29,ccc_aserv_info_script,0,0,0:00:00,0,0:00:00,0,0
20160429-ccc_bylaw_script,2016/04/29,ccc_bylaw_script,0,0,0:00:00,0,0:00:00,0,0
20160429-ccc_city_script,2016/04/29,ccc_city_script,23,22,0:01:00,60,0:05:33,1,1320
20160429-ccc_cty_online_script,2016/04/29,ccc_cty_online_script,0,0,0:00:00,0,0:00:00,0,0
20160429-ccc_feedback_script,2016/04/29,ccc_feedback_script,1,0,0:00:00,0,0:00:00,0,0
20160429-ccc_fpb_script,2016/04/29,ccc_fpb_script,0,0,0:00:00,0,0:00:00,0,0
20160429-ccc_help_script,2016/04/29,ccc_help_script,29,25,0:00:17,17,0:01:48,3,425
20160429-ccc_link_script,2016/04/29,ccc_link_script,0,0,0:00:00,0,0:00:00,0,0
20160429-ccc_media_line_script,2016/04/29,ccc_media_line_script,1,1,0:00:08,8,0:00:08,0,8
20160429-ccc_priority_script,2016/04/29,ccc_priority_script,22,19,0:00:17,17,0:00:51,3,323
20160429-ccc_tax_script,2016/04/29,ccc_tax_script,18,16,0:03:53,233,0:07:35,2,3728
20160429-ccc_waste_recycling_script,2016/04/29,ccc_waste_recycling_script,0,0,0:00:00,0,0:00:00,0,0
20160430-ccc_311_calgary_script,2016/04/30,ccc_311_calgary_script,1380,1274,0:00:47,47,0:11:51,106,59878
20160430-ccc_311_lobby_ph_script,2016/04/30,ccc_311_lobby_ph_script,0,0,0:00:00,0,0:00:00,0,0
20160430-ccc_aserv_info_script,2016/04/30,ccc_aserv_info_script,0,0,0:00:00,0,0:00:00,0,0
20160430-ccc_bylaw_script,2016/04/30,ccc_bylaw_script,0,0,0:00:00,0,0:00:00,0,0
20160430-ccc_city_script,2016/04/30,ccc_city_script,0,0,0:00:00,0,0:00:00,0,0
20160430-ccc_cty_online_script,2016/04/30,ccc_cty_online_script,0,0,0:00:00,0,0:00:00,0,0
20160430-ccc_feedback_script,2016/04/30,ccc_feedback_script,0,0,0:00:00,0,0:00:00,0,0
20160430-ccc_fpb_script,2016/04/30,ccc_fpb_script,0,0,0:00:00,0,0:00:00,0,0
20160430-ccc_help_script,2016/04/30,ccc_help_script,9,10,0:00:39,39,0:02:42,0,390
20160430-ccc_link_script,2016/04/30,ccc_link_script,0,0,0:00:00,0,0:00:00,0,0
20160430-ccc_media_line_script,2016/04/30,ccc_media_line_script,0,0,0:00:00,0,0:00:00,0,0
20160430-ccc_priority_script,2016/04/30,ccc_priority_script,33,33,0:00:22,22,0:03:36,0,726
20160430-ccc_tax_script,2016/04/30,ccc_tax_script,2,2,0:02:18,138,0:02:18,0,276
20160430-ccc_waste_recycling_script,2016/04/30,ccc_waste_recycling_script,0,0,0:00:00,0,0:00:00,0,0
20160501-ccc_311_calgary_script,2016/05/01,ccc_311_calgary_script,1381,1207,0:01:22,82,0:13:52,174,98974
20160501-ccc_311_lobby_ph_script,2016/05/01,ccc_311_lobby_ph_script,0,0,0:00:00,0,0:00:00,0,0
20160501-ccc_aserv_info_script,2016/05/01,ccc_aserv_info_script,0,0,0:00:00,0,0:00:00,0,0
20160501-ccc_bylaw_script,2016/05/01,ccc_bylaw_script,0,0,0:00:00,0,0:00:00,0,0
20160501-ccc_city_script,2016/05/01,ccc_city_script,0,0,0:00:00,0,0:00:00,0,0
20160501-ccc_cty_online_script,2016/05/01,ccc_cty_online_script,0,0,0:00:00,0,0:00:00,0,0
20160501-ccc_feedback_script,2016/05/01,ccc_feedback_script,0,0,0:00:00,0,0:00:00,0,0
20160501-ccc_fpb_script,2016/05/01,ccc_fpb_script,0,0,0:00:00,0,0:00:00,0,0
20160501-ccc_help_script,2016/05/01,ccc_help_script,6,6,0:00:13,13,0:00:25,0,78
20160501-ccc_link_script,2016/05/01,ccc_link_script,0,0,0:00:00,0,0:00:00,0,0
20160501-ccc_media_line_script,2016/05/01,ccc_media_line_script,2,2,0:00:04,4,0:00:05,0,8
20160501-ccc_priority_script,2016/05/01,ccc_priority_script,12,12,0:00:29,29,0:02:45,0,348
20160501-ccc_tax_script,2016/05/01,ccc_tax_script,0,0,0:00:00,0,0:00:00,0,0
20160501-ccc_waste_recycling_script,2016/05/01,ccc_waste_recycling_script,0,0,0:00:00,0,0:00:00,0,0
20160502-ccc_311_calgary_script,2016/05/02,ccc_311_calgary_script,4152,3595,0:02:05,125,0:19:19,557,449375
20160502-ccc_311_lobby_ph_script,2016/05/02,ccc_311_lobby_ph_script,4,4,0:00:14,14,0:00:25,0,56
20160502-ccc_aserv_info_script,2016/05/02,ccc_aserv_info_script,0,0,0:00:00,0,0:00:00,0,0
20160502-ccc_bylaw_script,2016/05/02,ccc_bylaw_script,0,0,0:00:00,0,0:00:00,0,0
20160502-ccc_city_script,2016/05/02,ccc_city_script,17,16,0:00:30,30,0:02:35,1,480
20160502-ccc_cty_online_script,2016/05/02,ccc_cty_online_script,0,0,0:00:00,0,0:00:00,0,0
20160502-ccc_feedback_script,2016/05/02,ccc_feedback_script,0,0,0:00:00,0,0:00:00,0,0
20160502-ccc_fpb_script,2016/05/02,ccc_fpb_script,0,0,0:00:00,0,0:00:00,0,0
20160502-ccc_help_script,2016/05/02,ccc_help_script,30,30,0:00:19,19,0:01:01,0,570
20160502-ccc_link_script,2016/05/02,ccc_link_script,0,0,0:00:00,0,0:00:00,0,0
20160502-ccc_media_line_script,2016/05/02,ccc_media_line_script,2,2,0:00:03,3,0:00:04,0,6
20160502-ccc_priority_script,2016/05/02,ccc_priority_script,33,31,0:00:20,20,0:02:00,2,620
20160502-ccc_tax_script,2016/05/02,ccc_tax_script,21,19,0:01:39,99,0:04:21,2,1881
20160502-ccc_waste_recycling_script,2016/05/02,ccc_waste_recycling_script,0,0,0:00:00,0,0:00:00,0,0
20160503-ccc_311_calgary_script,2016/05/03,ccc_311_calgary_script,3734,3463,0:01:02,62,0:07:37,271,214706
20160503-ccc_311_lobby_ph_script,2016/05/03,ccc_311_lobby_ph_script,3,3,0:00:08,8,0:00:18,0,24
20160503-ccc_aserv_info_script,2016/05/03,ccc_aserv_info_script,0,0,0:00:00,0,0:00:00,0,0
20160503-ccc_bylaw_script,2016/05/03,ccc_bylaw_script,0,0,0:00:00,0,0:00:00,0,0
20160503-ccc_city_script,2016/05/03,ccc_city_script,9,9,0:00:25,25,0:02:39,0,225
20160503-ccc_cty_online_script,2016/05/03,ccc_cty_online_script,0,0,0:00:00,0,0:00:00,0,0
20160503-ccc_feedback_script,2016/05/03,ccc_feedback_script,0,0,0:00:00,0,0:00:00,0,0
20160503-ccc_fpb_script,2016/05/03,ccc_fpb_script,2,1,0:00:02,2,0:00:02,1,2
20160503-ccc_help_script,2016/05/03,ccc_help_script,15,14,0:00:18,18,0:01:03,1,252
20160503-ccc_link_script,2016/05/03,ccc_link_script,1,0,0:00:00,0,0:00:00,1,0
20160503-ccc_media_line_script,2016/05/03,ccc_media_line_script,9,8,0:00:19,19,0:01:50,1,152
20160503-ccc_priority_script,2016/05/03,ccc_priority_script,35,35,0:00:10,10,0:00:38,0,350
20160503-ccc_tax_script,2016/05/03,ccc_tax_script,18,16,0:01:11,71,0:06:51,2,1136
20160503-ccc_waste_recycling_script,2016/05/03,ccc_waste_recycling_script,0,0,0:00:00,0,0:00:00,0,0
20160504-ccc_311_calgary_script,2016/05/04,ccc_311_calgary_script,3822,3355,0:01:34,94,0:18:31,467,315370
20160504-ccc_311_lobby_ph_script,2016/05/04,ccc_311_lobby_ph_script,1,1,0:00:12,12,0:00:12,0,12
20160504-ccc_aserv_info_script,2016/05/04,ccc_aserv_info_script,0,0,0:00:00,0,0:00:00,0,0
20160504-ccc_bylaw_script,2016/05/04,ccc_bylaw_script,0,0,0:00:00,0,0:00:00,0,0
20160504-ccc_city_script,2016/05/04,ccc_city_script,9,8,0:01:09,69,0:03:42,1,552
20160504-ccc_cty_online_script,2016/05/04,ccc_cty_online_script,0,0,0:00:00,0,0:00:00,0,0
20160504-ccc_feedback_script,2016/05/04,ccc_feedback_script,1,0,0:00:00,0,0:00:00,0,0
20160504-ccc_fpb_script,2016/05/04,ccc_fpb_script,0,0,0:00:00,0,0:00:00,0,0
20160504-ccc_help_script,2016/05/04,ccc_help_script,28,27,0:00:18,18,0:01:06,1,486
20160504-ccc_link_script,2016/05/04,ccc_link_script,0,0,0:00:00,0,0:00:00,0,0
20160504-ccc_media_line_script,2016/05/04,ccc_media_line_script,2,2,0:00:04,4,0:00:05,0,8
20160504-ccc_priority_script,2016/05/04,ccc_priority_script,32,31,0:00:14,14,0:00:57,1,434
20160504-ccc_tax_script,2016/05/04,ccc_tax_script,30,27,0:01:31,91,0:05:35,3,2457
20160504-ccc_waste_recycling_script,2016/05/04,ccc_waste_recycling_script,0,0,0:00:00,0,0:00:00,0,0
20160505-ccc_311_calgary_script,2016/05/05,ccc_311_calgary_script,3396,3053,0:01:28,88,0:15:25,343,268664
20160505-ccc_311_lobby_ph_script,2016/05/05,ccc_311_lobby_ph_script,6,5,0:00:07,7,0:00:14,1,35
20160505-ccc_aserv_info_script,2016/05/05,ccc_aserv_info_script,0,0,0:00:00,0,0:00:00,0,0
20160505-ccc_bylaw_script,2016/05/05,ccc_bylaw_script,0,0,0:00:00,0,0:00:00,0,0
20160505-ccc_city_script,2016/05/05,ccc_city_script,26,24,0:00:37,37,0:03:54,2,888
20160505-ccc_cty_online_script,2016/05/05,ccc_cty_online_script,0,0,0:00:00,0,0:00:00,0,0
20160505-ccc_feedback_script,2016/05/05,ccc_feedback_script,0,0,0:00:00,0,0:00:00,0,0
20160505-ccc_fpb_script,2016/05/05,ccc_fpb_script,1,1,0:02:41,161,0:02:41,0,161
20160505-ccc_help_script,2016/05/05,ccc_help_script,17,16,0:00:10,10,0:00:39,1,160
20160505-ccc_link_script,2016/05/05,ccc_link_script,0,0,0:00:00,0,0:00:00,0,0
20160505-ccc_media_line_script,2016/05/05,ccc_media_line_script,3,3,0:00:25,25,0:01:05,0,75
20160505-ccc_priority_script,2016/05/05,ccc_priority_script,25,25,0:00:28,28,0:03:39,0,700
20160505-ccc_tax_script,2016/05/05,ccc_tax_script,13,11,0:03:03,183,0:12:50,2,2013
20160505-ccc_waste_recycling_script,2016/05/05,ccc_waste_recycling_script,0,0,0:00:00,0,0:00:00,0,0
20160506-ccc_311_calgary_script,2016/05/06,ccc_311_calgary_script,4040,3265,0:02:55,175,0:09:21,775,571375
20160506-ccc_311_lobby_ph_script,2016/05/06,ccc_311_lobby_ph_script,4,4,0:00:09,9,0:00:15,0,36
20160506-ccc_aserv_info_script,2016/05/06,ccc_aserv_info_script,0,0,0:00:00,0,0:00:00,0,0
20160506-ccc_bylaw_script,2016/05/06,ccc_bylaw_script,0,0,0:00:00,0,0:00:00,0,0
20160506-ccc_city_script,2016/05/06,ccc_city_script,11,8,0:01:22,82,0:05:20,3,656
20160506-ccc_cty_online_script,2016/05/06,ccc_cty_online_script,0,0,0:00:00,0,0:00:00,0,0
20160506-ccc_feedback_script,2016/05/06,ccc_feedback_script,0,0,0:00:00,0,0:00:00,0,0
20160506-ccc_fpb_script,2016/05/06,ccc_fpb_script,1,0,0:00:00,0,0:00:00,1,0
20160506-ccc_help_script,2016/05/06,ccc_help_script,31,29,0:00:19,19,0:01:24,2,551
20160506-ccc_link_script,2016/05/06,ccc_link_script,0,0,0:00:00,0,0:00:00,0,0
20160506-ccc_media_line_script,2016/05/06,ccc_media_line_script,6,5,0:00:28,28,0:01:35,1,140
20160506-ccc_priority_script,2016/05/06,ccc_priority_script,35,33,0:00:19,19,0:01:20,2,627
20160506-ccc_tax_script,2016/05/06,ccc_tax_script,11,10,0:02:44,164,0:06:18,1,1640
20160506-ccc_waste_recycling_script,2016/05/06,ccc_waste_recycling_script,0,0,0:00:00,0,0:00:00,0,0
20160507-ccc_311_calgary_script,2016/05/07,ccc_311_calgary_script,2052,1803,0:01:16,76,0:11:26,249,137028
20160507-ccc_311_lobby_ph_script,2016/05/07,ccc_311_lobby_ph_script,0,0,0:00:00,0,0:00:00,0,0
20160507-ccc_aserv_info_script,2016/05/07,ccc_aserv_info_script,0,0,0:00:00,0,0:00:00,0,0
20160507-ccc_bylaw_script,2016/05/07,ccc_bylaw_script,1,1,0:00:03,3,0:00:03,0,3
20160507-ccc_city_script,2016/05/07,ccc_city_script,0,0,0:00:00,0,0:00:00,0,0
20160507-ccc_cty_online_script,2016/05/07,ccc_cty_online_script,0,0,0:00:00,0,0:00:00,0,0
20160507-ccc_feedback_script,2016/05/07,ccc_feedback_script,0,0,0:00:00,0,0:00:00,0,0
20160507-ccc_fpb_script,2016/05/07,ccc_fpb_script,0,0,0:00:00,0,0:00:00,0,0
20160507-ccc_help_script,2016/05/07,ccc_help_script,10,10,0:00:26,26,0:03:02,0,260
20160507-ccc_link_script,2016/05/07,ccc_link_script,0,0,0:00:00,0,0:00:00,0,0
20160507-ccc_media_line_script,2016/05/07,ccc_media_line_script,14,10,0:00:11,11,0:00:27,4,110
20160507-ccc_priority_script,2016/05/07,ccc_priority_script,17,16,0:00:21,21,0:00:59,1,336
20160507-ccc_tax_script,2016/05/07,ccc_tax_script,0,0,0:00:00,0,0:00:00,0,0
20160507-ccc_waste_recycling_script,2016/05/07,ccc_waste_recycling_script,0,0,0:00:00,0,0:00:00,0,0
20160508-ccc_311_calgary_script,2016/05/08,ccc_311_calgary_script,1064,1048,0:00:13,13,0:06:16,16,13624
20160508-ccc_311_lobby_ph_script,2016/05/08,ccc_311_lobby_ph_script,0,0,0:00:00,0,0:00:00,0,0
20160508-ccc_aserv_info_script,2016/05/08,ccc_aserv_info_script,0,0,0:00:00,0,0:00:00,0,0
20160508-ccc_bylaw_script,2016/05/08,ccc_bylaw_script,0,0,0:00:00,0,0:00:00,0,0
20160508-ccc_city_script,2016/05/08,ccc_city_script,0,0,0:00:00,0,0:00:00,0,0
20160508-ccc_cty_online_script,2016/05/08,ccc_cty_online_script,0,0,0:00:00,0,0:00:00,0,0
20160508-ccc_feedback_script,2016/05/08,ccc_feedback_script,0,0,0:00:00,0,0:00:00,0,0
20160508-ccc_fpb_script,2016/05/08,ccc_fpb_script,0,0,0:00:00,0,0:00:00,0,0
20160508-ccc_help_script,2016/05/08,ccc_help_script,4,4,0:00:04,4,0:00:05,0,16
20160508-ccc_link_script,2016/05/08,ccc_link_script,0,0,0:00:00,0,0:00:00,0,0
20160508-ccc_media_line_script,2016/05/08,ccc_media_line_script,9,9,0:00:09,9,0:00:39,0,81
20160508-ccc_priority_script,2016/05/08,ccc_priority_script,18,17,0:00:05,5,0:00:12,1,85
20160508-ccc_tax_script,2016/05/08,ccc_tax_script,1,1,0:00:03,3,0:00:03,0,3
20160508-ccc_waste_recycling_script,2016/05/08,ccc_waste_recycling_script,0,0,0:00:00,0,0:00:00,0,0
20160509-ccc_311_calgary_script,2016/05/09,ccc_311_calgary_script,3672,3517,0:00:35,35,0:05:47,155,123095
20160509-ccc_311_lobby_ph_script,2016/05/09,ccc_311_lobby_ph_script,4,4,0:00:10,10,0:00:21,0,40
20160509-ccc_aserv_info_script,2016/05/09,ccc_aserv_info_script,0,0,0:00:00,0,0:00:00,0,0
20160509-ccc_bylaw_script,2016/05/09,ccc_bylaw_script,0,0,0:00:00,0,0:00:00,0,0
20160509-ccc_city_script,2016/05/09,ccc_city_script,35,35,0:00:14,14,0:02:38,0,490
20160509-ccc_cty_online_script,2016/05/09,ccc_cty_online_script,0,0,0:00:00,0,0:00:00,0,0
20160509-ccc_feedback_script,2016/05/09,ccc_feedback_script,0,0,0:00:00,0,0:00:00,0,0
20160509-ccc_fpb_script,2016/05/09,ccc_fpb_script,0,0,0:00:00,0,0:00:00,0,0
20160509-ccc_help_script,2016/05/09,ccc_help_script,29,28,0:00:17,17,0:01:20,1,476
20160509-ccc_link_script,2016/05/09,ccc_link_script,0,0,0:00:00,0,0:00:00,0,0
20160509-ccc_media_line_script,2016/05/09,ccc_media_line_script,0,0,0:00:00,0,0:00:00,0,0
20160509-ccc_priority_script,2016/05/09,ccc_priority_script,37,37,0:00:11,11,0:00:53,0,407
20160509-ccc_tax_script,2016/05/09,ccc_tax_script,20,19,0:00:28,28,0:02:05,1,532
20160509-ccc_waste_recycling_script,2016/05/09,ccc_waste_recycling_script,0,0,0:00:00,0,0:00:00,0,0
20160510-ccc_311_calgary_script,2016/05/10,ccc_311_calgary_script,3578,3341,0:00:44,44,0:05:32,237,147004
20160510-ccc_311_lobby_ph_script,2016/05/10,ccc_311_lobby_ph_script,3,3,0:00:05,5,0:00:06,0,15
20160510-ccc_aserv_info_script,2016/05/10,ccc_aserv_info_script,0,0,0:00:00,0,0:00:00,0,0
20160510-ccc_bylaw_script,2016/05/10,ccc_bylaw_script,0,0,0:00:00,0,0:00:00,0,0
20160510-ccc_city_script,2016/05/10,ccc_city_script,24,24,0:00:34,34,0:03:17,0,816
20160510-ccc_cty_online_script,2016/05/10,ccc_cty_online_script,0,0,0:00:00,0,0:00:00,0,0
20160510-ccc_feedback_script,2016/05/10,ccc_feedback_script,0,0,0:00:00,0,0:00:00,0,0
20160510-ccc_fpb_script,2016/05/10,ccc_fpb_script,0,0,0:00:00,0,0:00:00,0,0
20160510-ccc_help_script,2016/05/10,ccc_help_script,16,16,0:00:39,39,0:02:43,0,624
20160510-ccc_link_script,2016/05/10,ccc_link_script,0,0,0:00:00,0,0:00:00,0,0
20160510-ccc_media_line_script,2016/05/10,ccc_media_line_script,0,0,0:00:00,0,0:00:00,0,0
20160510-ccc_priority_script,2016/05/10,ccc_priority_script,25,24,0:00:11,11,0:01:04,1,264
20160510-ccc_tax_script,2016/05/10,ccc_tax_script,16,15,0:00:55,55,0:02:39,1,825
20160510-ccc_waste_recycling_script,2016/05/10,ccc_waste_recycling_script,0,0,0:00:00,0,0:00:00,0,0
20160511-ccc_311_calgary_script,2016/05/11,ccc_311_calgary_script,3204,3096,0:00:29,29,0:09:29,108,89784
20160511-ccc_311_lobby_ph_script,2016/05/11,ccc_311_lobby_ph_script,1,1,0:00:13,13,0:00:13,0,13
20160511-ccc_aserv_info_script,2016/05/11,ccc_aserv_info_script,0,0,0:00:00,0,0:00:00,0,0
20160511-ccc_bylaw_script,2016/05/11,ccc_bylaw_script,0,0,0:00:00,0,0:00:00,0,0
20160511-ccc_city_script,2016/05/11,ccc_city_script,27,27,0:00:30,30,0:04:57,0,810
20160511-ccc_cty_online_script,2016/05/11,ccc_cty_online_script,0,0,0:00:00,0,0:00:00,0,0
20160511-ccc_feedback_script,2016/05/11,ccc_feedback_script,0,0,0:00:00,0,0:00:00,0,0
20160511-ccc_fpb_script,2016/05/11,ccc_fpb_script,0,0,0:00:00,0,0:00:00,0,0
20160511-ccc_help_script,2016/05/11,ccc_help_script,13,13,0:00:17,17,0:02:05,0,221
20160511-ccc_link_script,2016/05/11,ccc_link_script,0,0,0:00:00,0,0:00:00,0,0
20160511-ccc_media_line_script,2016/05/11,ccc_media_line_script,5,5,0:00:10,10,0:00:29,0,50
20160511-ccc_priority_script,2016/05/11,ccc_priority_script,33,33,0:00:12,12,0:01:45,0,396
20160511-ccc_tax_script,2016/05/11,ccc_tax_script,16,16,0:00:12,12,0:00:50,0,192
20160511-ccc_waste_recycling_script,2016/05/11,ccc_waste_recycling_script,0,0,0:00:00,0,0:00:00,0,0
20160512-ccc_311_calgary_script,2016/05/12,ccc_311_calgary_script,3030,2927,0:00:26,26,0:07:18,103,76102
20160512-ccc_311_lobby_ph_script,2016/05/12,ccc_311_lobby_ph_script,3,2,0:00:07,7,0:00:10,1,14
20160512-ccc_aserv_info_script,2016/05/12,ccc_aserv_info_script,0,0,0:00:00,0,0:00:00,0,0
20160512-ccc_bylaw_script,2016/05/12,ccc_bylaw_script,0,0,0:00:00,0,0:00:00,0,0
20160512-ccc_city_script,2016/05/12,ccc_city_script,25,24,0:00:07,7,0:00:15,1,168
20160512-ccc_cty_online_script,2016/05/12,ccc_cty_online_script,0,0,0:00:00,0,0:00:00,0,0
20160512-ccc_feedback_script,2016/05/12,ccc_feedback_script,0,0,0:00:00,0,0:00:00,0,0
20160512-ccc_fpb_script,2016/05/12,ccc_fpb_script,0,0,0:00:00,0,0:00:00,0,0
20160512-ccc_help_script,2016/05/12,ccc_help_script,34,31,0:00:08,8,0:00:50,3,248
20160512-ccc_link_script,2016/05/12,ccc_link_script,0,0,0:00:00,0,0:00:00,0,0
20160512-ccc_media_line_script,2016/05/12,ccc_media_line_script,1,1,0:00:03,3,0:00:03,0,3
20160512-ccc_priority_script,2016/05/12,ccc_priority_script,27,25,0:00:16,16,0:01:52,2,400
20160512-ccc_tax_script,2016/05/12,ccc_tax_script,10,10,0:00:23,23,0:01:51,0,230
20160512-ccc_waste_recycling_script,2016/05/12,ccc_waste_recycling_script,0,0,0:00:00,0,0:00:00,0,0
20160513-ccc_311_calgary_script,2016/05/13,ccc_311_calgary_script,3148,3017,0:00:37,37,0:06:51,131,111629
20160513-ccc_311_lobby_ph_script,2016/05/13,ccc_311_lobby_ph_script,5,5,0:00:09,9,0:00:17,0,45
20160513-ccc_aserv_info_script,2016/05/13,ccc_aserv_info_script,0,0,0:00:00,0,0:00:00,0,0
20160513-ccc_bylaw_script,2016/05/13,ccc_bylaw_script,0,0,0:00:00,0,0:00:00,0,0
20160513-ccc_city_script,2016/05/13,ccc_city_script,21,21,0:00:14,14,0:01:23,0,294
20160513-ccc_cty_online_script,2016/05/13,ccc_cty_online_script,0,0,0:00:00,0,0:00:00,0,0
20160513-ccc_feedback_script,2016/05/13,ccc_feedback_script,1,0,0:00:00,0,0:00:00,0,0
20160513-ccc_fpb_script,2016/05/13,ccc_fpb_script,3,2,0:00:03,3,0:00:03,1,6
20160513-ccc_help_script,2016/05/13,ccc_help_script,30,27,0:00:13,13,0:02:07,3,351
20160513-ccc_link_script,2016/05/13,ccc_link_script,0,0,0:00:00,0,0:00:00,0,0
20160513-ccc_media_line_script,2016/05/13,ccc_media_line_script,2,2,0:00:08,8,0:00:12,0,16
20160513-ccc_priority_script,2016/05/13,ccc_priority_script,23,20,0:00:10,10,0:00:56,3,200
20160513-ccc_tax_script,2016/05/13,ccc_tax_script,21,21,0:00:24,24,0:01:54,0,504
20160513-ccc_waste_recycling_script,2016/05/13,ccc_waste_recycling_script,0,0,0:00:00,0,0:00:00,0,0
20160514-ccc_311_calgary_script,2016/05/14,ccc_311_calgary_script,1425,1389,0:00:16,16,0:08:36,36,22224
20160514-ccc_311_lobby_ph_script,2016/05/14,ccc_311_lobby_ph_script,0,0,0:00:00,0,0:00:00,0,0
20160514-ccc_aserv_info_script,2016/05/14,ccc_aserv_info_script,0,0,0:00:00,0,0:00:00,0,0
20160514-ccc_bylaw_script,2016/05/14,ccc_bylaw_script,0,0,0:00:00,0,0:00:00,0,0
20160514-ccc_city_script,2016/05/14,ccc_city_script,0,0,0:00:00,0,0:00:00,0,0
20160514-ccc_cty_online_script,2016/05/14,ccc_cty_online_script,0,0,0:00:00,0,0:00:00,0,0
20160514-ccc_feedback_script,2016/05/14,ccc_feedback_script,0,0,0:00:00,0,0:00:00,0,0
20160514-ccc_fpb_script,2016/05/14,ccc_fpb_script,1,1,0:00:03,3,0:00:03,0,3
20160514-ccc_help_script,2016/05/14,ccc_help_script,7,7,0:00:18,18,0:01:26,0,126
20160514-ccc_link_script,2016/05/14,ccc_link_script,0,0,0:00:00,0,0:00:00,0,0
20160514-ccc_media_line_script,2016/05/14,ccc_media_line_script,2,2,0:00:17,17,0:00:31,0,34
20160514-ccc_priority_script,2016/05/14,ccc_priority_script,12,12,0:00:07,7,0:00:18,0,84
20160514-ccc_tax_script,2016/05/14,ccc_tax_script,1,1,0:00:05,5,0:00:05,0,5
20160514-ccc_waste_recycling_script,2016/05/14,ccc_waste_recycling_script,0,0,0:00:00,0,0:00:00,0,0
20160515-ccc_311_calgary_script,2016/05/15,ccc_311_calgary_script,1121,1090,0:00:18,18,0:11:11,31,19620
20160515-ccc_311_lobby_ph_script,2016/05/15,ccc_311_lobby_ph_script,0,0,0:00:00,0,0:00:00,0,0
20160515-ccc_aserv_info_script,2016/05/15,ccc_aserv_info_script,0,0,0:00:00,0,0:00:00,0,0
20160515-ccc_bylaw_script,2016/05/15,ccc_bylaw_script,0,0,0:00:00,0,0:00:00,0,0
20160515-ccc_city_script,2016/05/15,ccc_city_script,0,0,0:00:00,0,0:00:00,0,0
20160515-ccc_cty_online_script,2016/05/15,ccc_cty_online_script,0,0,0:00:00,0,0:00:00,0,0
20160515-ccc_feedback_script,2016/05/15,ccc_feedback_script,0,0,0:00:00,0,0:00:00,0,0
20160515-ccc_fpb_script,2016/05/15,ccc_fpb_script,0,0,0:00:00,0,0:00:00,0,0
20160515-ccc_help_script,2016/05/15,ccc_help_script,6,6,0:00:32,32,0:01:33,0,192
20160515-ccc_link_script,2016/05/15,ccc_link_script,0,0,0:00:00,0,0:00:00,0,0
20160515-ccc_media_line_script,2016/05/15,ccc_media_line_script,2,2,0:00:29,29,0:00:52,0,58
20160515-ccc_priority_script,2016/05/15,ccc_priority_script,27,27,0:00:11,11,0:01:07,0,297
20160515-ccc_tax_script,2016/05/15,ccc_tax_script,1,1,0:00:04,4,0:00:04,0,4
20160515-ccc_waste_recycling_script,2016/05/15,ccc_waste_recycling_script,0,0,0:00:00,0,0:00:00,0,0
20160516-ccc_311_calgary_script,2016/05/16,ccc_311_calgary_script,3942,3785,0:00:31,31,0:08:31,157,117335
20160516-ccc_311_lobby_ph_script,2016/05/16,ccc_311_lobby_ph_script,2,2,0:00:03,3,0:00:04,0,6
20160516-ccc_aserv_info_script,2016/05/16,ccc_aserv_info_script,0,0,0:00:00,0,0:00:00,0,0
20160516-ccc_bylaw_script,2016/05/16,ccc_bylaw_script,0,0,0:00:00,0,0:00:00,0,0
20160516-ccc_city_script,2016/05/16,ccc_city_script,14,13,0:00:11,11,0:00:46,1,143
20160516-ccc_cty_online_script,2016/05/16,ccc_cty_online_script,0,0,0:00:00,0,0:00:00,0,0
20160516-ccc_feedback_script,2016/05/16,ccc_feedback_script,0,0,0:00:00,0,0:00:00,0,0
20160516-ccc_fpb_script,2016/05/16,ccc_fpb_script,0,0,0:00:00,0,0:00:00,0,0
20160516-ccc_help_script,2016/05/16,ccc_help_script,10,10,0:00:25,25,0:02:10,0,250
20160516-ccc_link_script,2016/05/16,ccc_link_script,0,0,0:00:00,0,0:00:00,0,0
20160516-ccc_media_line_script,2016/05/16,ccc_media_line_script,2,2,0:00:07,7,0:00:09,0,14
20160516-ccc_priority_script,2016/05/16,ccc_priority_script,39,38,0:00:12,12,0:02:09,1,456
20160516-ccc_tax_script,2016/05/16,ccc_tax_script,20,13,0:00:20,20,0:01:38,7,260
20160516-ccc_waste_recycling_script,2016/05/16,ccc_waste_recycling_script,0,0,0:00:00,0,0:00:00,0,0
20160517-ccc_311_calgary_script,2016/05/17,ccc_311_calgary_script,3784,3291,0:01:48,108,0:14:56,493,355428
20160517-ccc_311_lobby_ph_script,2016/05/17,ccc_311_lobby_ph_script,2,2,0:00:03,3,0:00:03,0,6
20160517-ccc_aserv_info_script,2016/05/17,ccc_aserv_info_script,0,0,0:00:00,0,0:00:00,0,0
20160517-ccc_bylaw_script,2016/05/17,ccc_bylaw_script,0,0,0:00:00,0,0:00:00,0,0
20160517-ccc_city_script,2016/05/17,ccc_city_script,17,17,0:00:28,28,0:04:33,0,476
20160517-ccc_cty_online_script,2016/05/17,ccc_cty_online_script,0,0,0:00:00,0,0:00:00,0,0
20160517-ccc_feedback_script,2016/05/17,ccc_feedback_script,0,0,0:00:00,0,0:00:00,0,0
20160517-ccc_fpb_script,2016/05/17,ccc_fpb_script,1,1,0:02:29,149,0:02:29,0,149
20160517-ccc_help_script,2016/05/17,ccc_help_script,13,13,0:00:14,14,0:00:29,0,182
20160517-ccc_link_script,2016/05/17,ccc_link_script,0,0,0:00:00,0,0:00:00,0,0
20160517-ccc_media_line_script,2016/05/17,ccc_media_line_script,2,2,0:00:15,15,0:00:19,0,30
20160517-ccc_priority_script,2016/05/17,ccc_priority_script,26,26,0:00:16,16,0:02:00,0,416
20160517-ccc_tax_script,2016/05/17,ccc_tax_script,22,19,0:01:05,65,0:02:26,3,1235
20160517-ccc_waste_recycling_script,2016/05/17,ccc_waste_recycling_script,0,0,0:00:00,0,0:00:00,0,0
20160518-ccc_311_calgary_script,2016/05/18,ccc_311_calgary_script,3600,3226,0:01:28,88,0:10:45,374,283888
20160518-ccc_311_lobby_ph_script,2016/05/18,ccc_311_lobby_ph_script,4,4,0:00:07,7,0:00:10,0,28
20160518-ccc_aserv_info_script,2016/05/18,ccc_aserv_info_script,0,0,0:00:00,0,0:00:00,0,0
20160518-ccc_bylaw_script,2016/05/18,ccc_bylaw_script,0,0,0:00:00,0,0:00:00,0,0
20160518-ccc_city_script,2016/05/18,ccc_city_script,17,16,0:00:17,17,0:01:50,1,272
20160518-ccc_cty_online_script,2016/05/18,ccc_cty_online_script,0,0,0:00:00,0,0:00:00,0,0
20160518-ccc_feedback_script,2016/05/18,ccc_feedback_script,0,0,0:00:00,0,0:00:00,0,0
20160518-ccc_fpb_script,2016/05/18,ccc_fpb_script,1,1,0:05:55,355,0:05:55,0,355
20160518-ccc_help_script,2016/05/18,ccc_help_script,19,18,0:00:11,11,0:00:35,1,198
20160518-ccc_link_script,2016/05/18,ccc_link_script,0,0,0:00:00,0,0:00:00,0,0
20160518-ccc_media_line_script,2016/05/18,ccc_media_line_script,0,0,0:00:00,0,0:00:00,0,0
20160518-ccc_priority_script,2016/05/18,ccc_priority_script,37,36,0:00:20,20,0:01:59,1,720
20160518-ccc_tax_script,2016/05/18,ccc_tax_script,15,13,0:01:45,105,0:06:01,2,1365
20160518-ccc_waste_recycling_script,2016/05/18,ccc_waste_recycling_script,0,0,0:00:00,0,0:00:00,0,0
20160519-ccc_311_calgary_script,2016/05/19,ccc_311_calgary_script,3249,2820,0:01:58,118,0:08:10,429,332760
20160519-ccc_311_lobby_ph_script,2016/05/19,ccc_311_lobby_ph_script,7,7,0:00:08,8,0:00:25,0,56
20160519-ccc_aserv_info_script,2016/05/19,ccc_aserv_info_script,0,0,0:00:00,0,0:00:00,0,0
20160519-ccc_bylaw_script,2016/05/19,ccc_bylaw_script,0,0,0:00:00,0,0:00:00,0,0
20160519-ccc_city_script,2016/05/19,ccc_city_script,18,17,0:00:29,29,0:03:04,1,493
20160519-ccc_cty_online_script,2016/05/19,ccc_cty_online_script,0,0,0:00:00,0,0:00:00,0,0
20160519-ccc_feedback_script,2016/05/19,ccc_feedback_script,1,0,0:00:00,0,0:00:00,1,0
20160519-ccc_fpb_script,2016/05/19,ccc_fpb_script,0,0,0:00:00,0,0:00:00,0,0
20160519-ccc_help_script,2016/05/19,ccc_help_script,15,13,0:00:26,26,0:01:22,2,338
20160519-ccc_link_script,2016/05/19,ccc_link_script,0,0,0:00:00,0,0:00:00,0,0
20160519-ccc_media_line_script,2016/05/19,ccc_media_line_script,0,0,0:00:00,0,0:00:00,0,0
20160519-ccc_priority_script,2016/05/19,ccc_priority_script,26,26,0:00:23,23,0:03:54,0,598
20160519-ccc_tax_script,2016/05/19,ccc_tax_script,11,10,0:02:05,125,0:07:52,1,1250
20160519-ccc_waste_recycling_script,2016/05/19,ccc_waste_recycling_script,0,0,0:00:00,0,0:00:00,0,0
20160520-ccc_311_calgary_script,2016/05/20,ccc_311_calgary_script,2883,2635,0:01:09,69,0:07:58,242,181815
20160520-ccc_311_lobby_ph_script,2016/05/20,ccc_311_lobby_ph_script,0,0,0:00:00,0,0:00:00,0,0
20160520-ccc_aserv_info_script,2016/05/20,ccc_aserv_info_script,0,0,0:00:00,0,0:00:00,0,0
20160520-ccc_bylaw_script,2016/05/20,ccc_bylaw_script,0,0,0:00:00,0,0:00:00,0,0
20160520-ccc_city_script,2016/05/20,ccc_city_script,14,14,0:00:17,17,0:00:47,0,238
20160520-ccc_cty_online_script,2016/05/20,ccc_cty_online_script,0,0,0:00:00,0,0:00:00,0,0
20160520-ccc_feedback_script,2016/05/20,ccc_feedback_script,0,0,0:00:00,0,0:00:00,0,0
20160520-ccc_fpb_script,2016/05/20,ccc_fpb_script,1,0,0:00:00,0,0:00:00,1,0
20160520-ccc_help_script,2016/05/20,ccc_help_script,16,16,0:00:11,11,0:00:27,0,176
20160520-ccc_link_script,2016/05/20,ccc_link_script,0,0,0:00:00,0,0:00:00,0,0
20160520-ccc_media_line_script,2016/05/20,ccc_media_line_script,1,1,0:00:05,5,0:00:05,0,5
20160520-ccc_priority_script,2016/05/20,ccc_priority_script,24,17,0:00:17,17,0:00:51,0,289
20160520-ccc_tax_script,2016/05/20,ccc_tax_script,15,13,0:01:03,63,0:03:34,2,819
20160520-ccc_waste_recycling_script,2016/05/20,ccc_waste_recycling_script,0,0,0:00:00,0,0:00:00,0,0
20160521-ccc_311_calgary_script,2016/05/21,ccc_311_calgary_script,997,982,0:00:10,10,0:04:32,15,9820
20160521-ccc_311_lobby_ph_script,2016/05/21,ccc_311_lobby_ph_script,0,0,0:00:00,0,0:00:00,0,0
20160521-ccc_aserv_info_script,2016/05/21,ccc_aserv_info_script,0,0,0:00:00,0,0:00:00,0,0
20160521-ccc_bylaw_script,2016/05/21,ccc_bylaw_script,0,0,0:00:00,0,0:00:00,0,0
20160521-ccc_city_script,2016/05/21,ccc_city_script,0,0,0:00:00,0,0:00:00,0,0
20160521-ccc_cty_online_script,2016/05/21,ccc_cty_online_script,0,0,0:00:00,0,0:00:00,0,0
20160521-ccc_feedback_script,2016/05/21,ccc_feedback_script,0,0,0:00:00,0,0:00:00,0,0
20160521-ccc_fpb_script,2016/05/21,ccc_fpb_script,0,0,0:00:00,0,0:00:00,0,0
20160521-ccc_help_script,2016/05/21,ccc_help_script,0,0,0:00:00,0,0:00:00,0,0
20160521-ccc_link_script,2016/05/21,ccc_link_script,0,0,0:00:00,0,0:00:00,0,0
20160521-ccc_media_line_script,2016/05/21,ccc_media_line_script,1,1,0:00:05,5,0:00:05,0,5
20160521-ccc_priority_script,2016/05/21,ccc_priority_script,10,8,0:00:26,26,0:02:05,2,208
20160521-ccc_tax_script,2016/05/21,ccc_tax_script,0,0,0:00:00,0,0:00:00,0,0
20160521-ccc_waste_recycling_script,2016/05/21,ccc_waste_recycling_script,0,0,0:00:00,0,0:00:00,0,0
20160522-ccc_311_calgary_script,2016/05/22,ccc_311_calgary_script,759,744,0:00:13,13,0:03:04,15,9672
20160522-ccc_311_lobby_ph_script,2016/05/22,ccc_311_lobby_ph_script,0,0,0:00:00,0,0:00:00,0,0
20160522-ccc_aserv_info_script,2016/05/22,ccc_aserv_info_script,0,0,0:00:00,0,0:00:00,0,0
20160522-ccc_bylaw_script,2016/05/22,ccc_bylaw_script,0,0,0:00:00,0,0:00:00,0,0
20160522-ccc_city_script,2016/05/22,ccc_city_script,0,0,0:00:00,0,0:00:00,0,0
20160522-ccc_cty_online_script,2016/05/22,ccc_cty_online_script,0,0,0:00:00,0,0:00:00,0,0
20160522-ccc_feedback_script,2016/05/22,ccc_feedback_script,0,0,0:00:00,0,0:00:00,0,0
20160522-ccc_fpb_script,2016/05/22,ccc_fpb_script,0,0,0:00:00,0,0:00:00,0,0
20160522-ccc_help_script,2016/05/22,ccc_help_script,2,2,0:00:03,3,0:00:04,0,6
20160522-ccc_link_script,2016/05/22,ccc_link_script,0,0,0:00:00,0,0:00:00,0,0
20160522-ccc_media_line_script,2016/05/22,ccc_media_line_script,2,2,0:00:05,5,0:00:08,0,10
20160522-ccc_priority_script,2016/05/22,ccc_priority_script,12,12,0:00:13,13,0:01:18,0,156
20160522-ccc_tax_script,2016/05/22,ccc_tax_script,0,0,0:00:00,0,0:00:00,0,0
20160522-ccc_waste_recycling_script,2016/05/22,ccc_waste_recycling_script,0,0,0:00:00,0,0:00:00,0,0
20160523-ccc_311_calgary_script,2016/05/23,ccc_311_calgary_script,1035,1014,0:00:11,11,0:05:12,21,11154
20160523-ccc_311_lobby_ph_script,2016/05/23,ccc_311_lobby_ph_script,0,0,0:00:00,0,0:00:00,0,0
20160523-ccc_aserv_info_script,2016/05/23,ccc_aserv_info_script,0,0,0:00:00,0,0:00:00,0,0
20160523-ccc_bylaw_script,2016/05/23,ccc_bylaw_script,0,0,0:00:00,0,0:00:00,0,0
20160523-ccc_city_script,2016/05/23,ccc_city_script,0,0,0:00:00,0,0:00:00,0,0
20160523-ccc_cty_online_script,2016/05/23,ccc_cty_online_script,0,0,0:00:00,0,0:00:00,0,0
20160523-ccc_feedback_script,2016/05/23,ccc_feedback_script,0,0,0:00:00,0,0:00:00,0,0
20160523-ccc_fpb_script,2016/05/23,ccc_fpb_script,0,0,0:00:00,0,0:00:00,0,0
20160523-ccc_help_script,2016/05/23,ccc_help_script,2,2,0:00:04,4,0:00:07,0,8
20160523-ccc_link_script,2016/05/23,ccc_link_script,0,0,0:00:00,0,0:00:00,0,0
20160523-ccc_media_line_script,2016/05/23,ccc_media_line_script,9,9,0:00:08,8,0:00:35,0,72
20160523-ccc_priority_script,2016/05/23,ccc_priority_script,18,17,0:00:15,15,0:01:48,1,255
20160523-ccc_tax_script,2016/05/23,ccc_tax_script,0,0,0:00:00,0,0:00:00,0,0
20160523-ccc_waste_recycling_script,2016/05/23,ccc_waste_recycling_script,0,0,0:00:00,0,0:00:00,0,0
20160524-ccc_311_calgary_script,2016/05/24,ccc_311_calgary_script,3801,3578,0:00:42,42,0:28:04,223,150276
20160524-ccc_311_lobby_ph_script,2016/05/24,ccc_311_lobby_ph_script,2,1,0:00:09,9,0:00:09,1,9
20160524-ccc_aserv_info_script,2016/05/24,ccc_aserv_info_script,0,0,0:00:00,0,0:00:00,0,0
20160524-ccc_bylaw_script,2016/05/24,ccc_bylaw_script,0,0,0:00:00,0,0:00:00,0,0
20160524-ccc_city_script,2016/05/24,ccc_city_script,43,43,0:00:08,8,0:00:33,0,344
20160524-ccc_cty_online_script,2016/05/24,ccc_cty_online_script,0,0,0:00:00,0,0:00:00,0,0
20160524-ccc_feedback_script,2016/05/24,ccc_feedback_script,0,0,0:00:00,0,0:00:00,0,0
20160524-ccc_fpb_script,2016/05/24,ccc_fpb_script,0,0,0:00:00,0,0:00:00,0,0
20160524-ccc_help_script,2016/05/24,ccc_help_script,18,17,0:00:10,10,0:00:36,1,170
20160524-ccc_link_script,2016/05/24,ccc_link_script,0,0,0:00:00,0,0:00:00,0,0
20160524-ccc_media_line_script,2016/05/24,ccc_media_line_script,0,0,0:00:00,0,0:00:00,0,0
20160524-ccc_priority_script,2016/05/24,ccc_priority_script,36,33,0:00:32,32,0:07:32,3,1056
20160524-ccc_tax_script,2016/05/24,ccc_tax_script,13,12,0:00:20,20,0:01:02,1,240
20160524-ccc_waste_recycling_script,2016/05/24,ccc_waste_recycling_script,0,0,0:00:00,0,0:00:00,0,0
20160525-ccc_311_calgary_script,2016/05/25,ccc_311_calgary_script,3577,3033,0:02:21,141,0:11:30,544,427653
20160525-ccc_311_lobby_ph_script,2016/05/25,ccc_311_lobby_ph_script,6,5,0:00:12,12,0:00:24,1,60
20160525-ccc_aserv_info_script,2016/05/25,ccc_aserv_info_script,0,0,0:00:00,0,0:00:00,0,0
20160525-ccc_bylaw_script,2016/05/25,ccc_bylaw_script,0,0,0:00:00,0,0:00:00,0,0
20160525-ccc_city_script,2016/05/25,ccc_city_script,31,31,0:00:27,27,0:03:12,0,837
20160525-ccc_cty_online_script,2016/05/25,ccc_cty_online_script,0,0,0:00:00,0,0:00:00,0,0
20160525-ccc_feedback_script,2016/05/25,ccc_feedback_script,0,0,0:00:00,0,0:00:00,0,0
20160525-ccc_fpb_script,2016/05/25,ccc_fpb_script,0,0,0:00:00,0,0:00:00,0,0
20160525-ccc_help_script,2016/05/25,ccc_help_script,42,35,0:00:17,17,0:01:58,7,595
20160525-ccc_link_script,2016/05/25,ccc_link_script,0,0,0:00:00,0,0:00:00,0,0
20160525-ccc_media_line_script,2016/05/25,ccc_media_line_script,1,1,0:00:10,10,0:00:10,0,10
20160525-ccc_priority_script,2016/05/25,ccc_priority_script,36,35,0:00:13,13,0:00:49,1,455
20160525-ccc_tax_script,2016/05/25,ccc_tax_script,29,21,0:02:22,142,0:06:40,8,2982
20160525-ccc_waste_recycling_script,2016/05/25,ccc_waste_recycling_script,0,0,0:00:00,0,0:00:00,0,0
20160526-ccc_311_calgary_script,2016/05/26,ccc_311_calgary_script,3663,3121,0:02:12,132,0:17:21,542,411972
20160526-ccc_311_lobby_ph_script,2016/05/26,ccc_311_lobby_ph_script,8,7,0:00:10,10,0:00:20,1,70
20160526-ccc_aserv_info_script,2016/05/26,ccc_aserv_info_script,0,0,0:00:00,0,0:00:00,0,0
20160526-ccc_bylaw_script,2016/05/26,ccc_bylaw_script,0,0,0:00:00,0,0:00:00,0,0
20160526-ccc_city_script,2016/05/26,ccc_city_script,22,21,0:01:45,105,0:05:24,1,2205
20160526-ccc_cty_online_script,2016/05/26,ccc_cty_online_script,0,0,0:00:00,0,0:00:00,0,0
20160526-ccc_feedback_script,2016/05/26,ccc_feedback_script,0,0,0:00:00,0,0:00:00,0,0
20160526-ccc_fpb_script,2016/05/26,ccc_fpb_script,0,0,0:00:00,0,0:00:00,0,0
20160526-ccc_help_script,2016/05/26,ccc_help_script,30,23,0:00:20,20,0:00:56,5,460
20160526-ccc_link_script,2016/05/26,ccc_link_script,0,0,0:00:00,0,0:00:00,0,0
20160526-ccc_media_line_script,2016/05/26,ccc_media_line_script,0,0,0:00:00,0,0:00:00,0,0
20160526-ccc_priority_script,2016/05/26,ccc_priority_script,34,32,0:00:18,18,0:02:37,2,576
20160526-ccc_tax_script,2016/05/26,ccc_tax_script,24,22,0:02:25,145,0:06:04,2,3190
20160526-ccc_waste_recycling_script,2016/05/26,ccc_waste_recycling_script,0,0,0:00:00,0,0:00:00,0,0
20160527-ccc_311_calgary_script,2016/05/27,ccc_311_calgary_script,3422,2639,0:03:35,215,0:17:39,783,567385
20160527-ccc_311_lobby_ph_script,2016/05/27,ccc_311_lobby_ph_script,1,1,0:00:26,26,0:00:26,0,26
20160527-ccc_aserv_info_script,2016/05/27,ccc_aserv_info_script,0,0,0:00:00,0,0:00:00,0,0
20160527-ccc_bylaw_script,2016/05/27,ccc_bylaw_script,0,0,0:00:00,0,0:00:00,0,0
20160527-ccc_city_script,2016/05/27,ccc_city_script,23,23,0:00:26,26,0:03:08,0,598
20160527-ccc_cty_online_script,2016/05/27,ccc_cty_online_script,0,0,0:00:00,0,0:00:00,0,0
20160527-ccc_feedback_script,2016/05/27,ccc_feedback_script,0,0,0:00:00,0,0:00:00,0,0
20160527-ccc_fpb_script,2016/05/27,ccc_fpb_script,0,0,0:00:00,0,0:00:00,0,0
20160527-ccc_help_script,2016/05/27,ccc_help_script,14,13,0:00:18,18,0:01:12,1,234
20160527-ccc_link_script,2016/05/27,ccc_link_script,0,0,0:00:00,0,0:00:00,0,0
20160527-ccc_media_line_script,2016/05/27,ccc_media_line_script,1,1,0:00:07,7,0:00:07,0,7
20160527-ccc_priority_script,2016/05/27,ccc_priority_script,42,38,0:00:22,22,0:04:22,3,836
20160527-ccc_tax_script,2016/05/27,ccc_tax_script,22,19,0:04:23,263,0:09:05,3,4997
20160527-ccc_waste_recycling_script,2016/05/27,ccc_waste_recycling_script,0,0,0:00:00,0,0:00:00,0,0
20160528-ccc_311_calgary_script,2016/05/28,ccc_311_calgary_script,1448,1296,0:01:19,79,0:09:46,152,102384
20160528-ccc_311_lobby_ph_script,2016/05/28,ccc_311_lobby_ph_script,0,0,0:00:00,0,0:00:00,0,0
20160528-ccc_aserv_info_script,2016/05/28,ccc_aserv_info_script,0,0,0:00:00,0,0:00:00,0,0
20160528-ccc_bylaw_script,2016/05/28,ccc_bylaw_script,0,0,0:00:00,0,0:00:00,0,0
20160528-ccc_city_script,2016/05/28,ccc_city_script,0,0,0:00:00,0,0:00:00,0,0
20160528-ccc_cty_online_script,2016/05/28,ccc_cty_online_script,0,0,0:00:00,0,0:00:00,0,0
20160528-ccc_feedback_script,2016/05/28,ccc_feedback_script,1,0,0:00:00,0,0:00:00,0,0
20160528-ccc_fpb_script,2016/05/28,ccc_fpb_script,0,0,0:00:00,0,0:00:00,0,0
20160528-ccc_help_script,2016/05/28,ccc_help_script,9,8,0:01:13,73,0:04:21,1,584
20160528-ccc_link_script,2016/05/28,ccc_link_script,0,0,0:00:00,0,0:00:00,0,0
20160528-ccc_media_line_script,2016/05/28,ccc_media_line_script,0,0,0:00:00,0,0:00:00,0,0
20160528-ccc_priority_script,2016/05/28,ccc_priority_script,33,32,0:00:25,25,0:02:30,2,800
20160528-ccc_tax_script,2016/05/28,ccc_tax_script,0,0,0:00:00,0,0:00:00,0,0
20160528-ccc_waste_recycling_script,2016/05/28,ccc_waste_recycling_script,0,0,0:00:00,0,0:00:00,0,0
20160529-ccc_311_calgary_script,2016/05/29,ccc_311_calgary_script,1245,1142,0:00:49,49,0:11:53,103,55958
20160529-ccc_311_lobby_ph_script,2016/05/29,ccc_311_lobby_ph_script,0,0,0:00:00,0,0:00:00,0,0
20160529-ccc_aserv_info_script,2016/05/29,ccc_aserv_info_script,0,0,0:00:00,0,0:00:00,0,0
20160529-ccc_bylaw_script,2016/05/29,ccc_bylaw_script,0,0,0:00:00,0,0:00:00,0,0
20160529-ccc_city_script,2016/05/29,ccc_city_script,0,0,0:00:00,0,0:00:00,0,0
20160529-ccc_cty_online_script,2016/05/29,ccc_cty_online_script,0,0,0:00:00,0,0:00:00,0,0
20160529-ccc_feedback_script,2016/05/29,ccc_feedback_script,0,0,0:00:00,0,0:00:00,0,0
20160529-ccc_fpb_script,2016/05/29,ccc_fpb_script,0,0,0:00:00,0,0:00:00,0,0
20160529-ccc_help_script,2016/05/29,ccc_help_script,5,4,0:00:06,6,0:00:10,1,24
20160529-ccc_link_script,2016/05/29,ccc_link_script,0,0,0:00:00,0,0:00:00,0,0
20160529-ccc_media_line_script,2016/05/29,ccc_media_line_script,1,1,0:00:10,10,0:00:10,0,10
20160529-ccc_priority_script,2016/05/29,ccc_priority_script,20,19,0:00:21,21,0:01:29,1,399
20160529-ccc_tax_script,2016/05/29,ccc_tax_script,2,2,0:02:45,165,0:05:28,0,330
20160529-ccc_waste_recycling_script,2016/05/29,ccc_waste_recycling_script,0,0,0:00:00,0,0:00:00,0,0
20160530-ccc_311_calgary_script,2016/05/30,ccc_311_calgary_script,5154,3943,0:04:21,261,0:25:32,1211,1029123
20160530-ccc_311_lobby_ph_script,2016/05/30,ccc_311_lobby_ph_script,2,2,0:00:06,6,0:00:06,0,12
20160530-ccc_aserv_info_script,2016/05/30,ccc_aserv_info_script,0,0,0:00:00,0,0:00:00,0,0
20160530-ccc_bylaw_script,2016/05/30,ccc_bylaw_script,0,0,0:00:00,0,0:00:00,0,0
20160530-ccc_city_script,2016/05/30,ccc_city_script,21,21,0:00:31,31,0:02:25,0,651
20160530-ccc_cty_online_script,2016/05/30,ccc_cty_online_script,0,0,0:00:00,0,0:00:00,0,0
20160530-ccc_feedback_script,2016/05/30,ccc_feedback_script,0,0,0:00:00,0,0:00:00,0,0
20160530-ccc_fpb_script,2016/05/30,ccc_fpb_script,0,0,0:00:00,0,0:00:00,0,0
20160530-ccc_help_script,2016/05/30,ccc_help_script,31,27,0:00:20,20,0:01:34,4,540
20160530-ccc_link_script,2016/05/30,ccc_link_script,0,0,0:00:00,0,0:00:00,0,0
20160530-ccc_media_line_script,2016/05/30,ccc_media_line_script,1,1,0:01:34,94,0:01:34,0,94
20160530-ccc_priority_script,2016/05/30,ccc_priority_script,46,46,0:00:19,19,0:02:40,0,874
20160530-ccc_tax_script,2016/05/30,ccc_tax_script,22,19,0:03:03,183,0:08:27,3,3477
20160530-ccc_waste_recycling_script,2016/05/30,ccc_waste_recycling_script,0,0,0:00:00,0,0:00:00,0,0
20160531-ccc_311_calgary_script,2016/05/31,ccc_311_calgary_script,6165,4006,0:07:57,477,0:15:50,2159,1910862
20160531-ccc_311_lobby_ph_script,2016/05/31,ccc_311_lobby_ph_script,2,2,0:00:06,6,0:00:09,0,12
20160531-ccc_aserv_info_script,2016/05/31,ccc_aserv_info_script,0,0,0:00:00,0,0:00:00,0,0
20160531-ccc_bylaw_script,2016/05/31,ccc_bylaw_script,0,0,0:00:00,0,0:00:00,0,0
20160531-ccc_city_script,2016/05/31,ccc_city_script,8,6,0:04:30,270,0:11:34,2,1620
20160531-ccc_cty_online_script,2016/05/31,ccc_cty_online_script,0,0,0:00:00,0,0:00:00,0,0
20160531-ccc_feedback_script,2016/05/31,ccc_feedback_script,0,0,0:00:00,0,0:00:00,0,0
20160531-ccc_fpb_script,2016/05/31,ccc_fpb_script,2,0,0:00:00,0,0:00:00,2,0
20160531-ccc_help_script,2016/05/31,ccc_help_script,23,21,0:00:17,17,0:01:12,2,357
20160531-ccc_link_script,2016/05/31,ccc_link_script,0,0,0:00:00,0,0:00:00,0,0
20160531-ccc_media_line_script,2016/05/31,ccc_media_line_script,4,3,0:00:04,4,0:00:06,1,12
20160531-ccc_priority_script,2016/05/31,ccc_priority_script,40,38,0:00:15,15,0:00:47,2,570
20160531-ccc_tax_script,2016/05/31,ccc_tax_script,19,10,0:09:42,582,0:15:28,9,5820
20160531-ccc_waste_recycling_script,2016/05/31,ccc_waste_recycling_script,0,0,0:00:00,0,0:00:00,0,0
20160601-ccc_311_calgary_script,2016/06/01,ccc_311_calgary_script,5769,3698,0:08:25,505,0:17:53,2071,1867490
20160601-ccc_311_lobby_ph_script,2016/06/01,ccc_311_lobby_ph_script,3,2,0:00:09,9,0:00:09,1,18
20160601-ccc_aserv_info_script,2016/06/01,ccc_aserv_info_script,0,0,0:00:00,0,0:00:00,0,0
20160601-ccc_bylaw_script,2016/06/01,ccc_bylaw_script,0,0,0:00:00,0,0:00:00,0,0
20160601-ccc_city_script,2016/06/01,ccc_city_script,21,19,0:03:39,219,0:16:07,2,4161
20160601-ccc_cty_online_script,2016/06/01,ccc_cty_online_script,0,0,0:00:00,0,0:00:00,0,0
20160601-ccc_feedback_script,2016/06/01,ccc_feedback_script,0,0,0:00:00,0,0:00:00,0,0
20160601-ccc_fpb_script,2016/06/01,ccc_fpb_script,0,0,0:00:00,0,0:00:00,0,0
20160601-ccc_help_script,2016/06/01,ccc_help_script,24,22,0:00:17,17,0:00:52,2,374
20160601-ccc_link_script,2016/06/01,ccc_link_script,0,0,0:00:00,0,0:00:00,0,0
20160601-ccc_media_line_script,2016/06/01,ccc_media_line_script,0,0,0:00:00,0,0:00:00,0,0
20160601-ccc_priority_script,2016/06/01,ccc_priority_script,40,40,0:00:21,21,0:01:59,0,840
20160601-ccc_tax_script,2016/06/01,ccc_tax_script,27,13,0:10:32,632,0:14:50,14,8216
20160601-ccc_waste_recycling_script,2016/06/01,ccc_waste_recycling_script,0,0,0:00:00,0,0:00:00,0,0
20160602-ccc_311_calgary_script,2016/06/02,ccc_311_calgary_script,4914,3909,0:03:50,230,0:09:55,1005,899070
20160602-ccc_311_lobby_ph_script,2016/06/02,ccc_311_lobby_ph_script,2,1,0:00:09,9,0:00:09,1,9
20160602-ccc_aserv_info_script,2016/06/02,ccc_aserv_info_script,0,0,0:00:00,0,0:00:00,0,0
20160602-ccc_bylaw_script,2016/06/02,ccc_bylaw_script,0,0,0:00:00,0,0:00:00,0,0
20160602-ccc_city_script,2016/06/02,ccc_city_script,16,16,0:00:49,49,0:05:22,0,784
20160602-ccc_cty_online_script,2016/06/02,ccc_cty_online_script,0,0,0:00:00,0,0:00:00,0,0
20160602-ccc_feedback_script,2016/06/02,ccc_feedback_script,0,0,0:00:00,0,0:00:00,0,0
20160602-ccc_fpb_script,2016/06/02,ccc_fpb_script,1,0,0:00:00,0,0:00:00,1,0
20160602-ccc_help_script,2016/06/02,ccc_help_script,22,18,0:00:14,14,0:00:50,4,252
20160602-ccc_link_script,2016/06/02,ccc_link_script,0,0,0:00:00,0,0:00:00,0,0
20160602-ccc_media_line_script,2016/06/02,ccc_media_line_script,0,0,0:00:00,0,0:00:00,0,0
20160602-ccc_priority_script,2016/06/02,ccc_priority_script,37,34,0:00:15,15,0:01:04,3,510
20160602-ccc_tax_script,2016/06/02,ccc_tax_script,27,20,0:04:27,267,0:08:05,7,5340
20160602-ccc_waste_recycling_script,2016/06/02,ccc_waste_recycling_script,0,0,0:00:00,0,0:00:00,0,0
20160603-ccc_311_calgary_script,2016/06/03,ccc_311_calgary_script,4317,3292,0:04:33,273,0:11:10,1025,898716
20160603-ccc_311_lobby_ph_script,2016/06/03,ccc_311_lobby_ph_script,1,0,0:00:00,0,0:00:00,1,0
20160603-ccc_aserv_info_script,2016/06/03,ccc_aserv_info_script,0,0,0:00:00,0,0:00:00,0,0
20160603-ccc_bylaw_script,2016/06/03,ccc_bylaw_script,0,0,0:00:00,0,0:00:00,0,0
20160603-ccc_city_script,2016/06/03,ccc_city_script,12,10,0:02:19,139,0:07:41,2,1390
20160603-ccc_cty_online_script,2016/06/03,ccc_cty_online_script,0,0,0:00:00,0,0:00:00,0,0
20160603-ccc_feedback_script,2016/06/03,ccc_feedback_script,0,0,0:00:00,0,0:00:00,0,0
20160603-ccc_fpb_script,2016/06/03,ccc_fpb_script,0,0,0:00:00,0,0:00:00,0,0
20160603-ccc_help_script,2016/06/03,ccc_help_script,28,26,0:00:10,10,0:00:42,2,260
20160603-ccc_link_script,2016/06/03,ccc_link_script,0,0,0:00:00,0,0:00:00,0,0
20160603-ccc_media_line_script,2016/06/03,ccc_media_line_script,3,3,0:00:30,30,0:00:59,0,90
20160603-ccc_priority_script,2016/06/03,ccc_priority_script,30,29,0:00:13,13,0:00:40,1,377
20160603-ccc_tax_script,2016/06/03,ccc_tax_script,20,11,0:05:03,303,0:09:46,9,3333
20160603-ccc_waste_recycling_script,2016/06/03,ccc_waste_recycling_script,0,0,0:00:00,0,0:00:00,0,0
20160604-ccc_311_calgary_script,2016/06/04,ccc_311_calgary_script,1769,1616,0:00:57,57,0:12:52,153,92112
20160604-ccc_311_lobby_ph_script,2016/06/04,ccc_311_lobby_ph_script,0,0,0:00:00,0,0:00:00,0,0
20160604-ccc_aserv_info_script,2016/06/04,ccc_aserv_info_script,0,0,0:00:00,0,0:00:00,0,0
20160604-ccc_bylaw_script,2016/06/04,ccc_bylaw_script,0,0,0:00:00,0,0:00:00,0,0
20160604-ccc_city_script,2016/06/04,ccc_city_script,0,0,0:00:00,0,0:00:00,0,0
20160604-ccc_cty_online_script,2016/06/04,ccc_cty_online_script,0,0,0:00:00,0,0:00:00,0,0
20160604-ccc_feedback_script,2016/06/04,ccc_feedback_script,0,0,0:00:00,0,0:00:00,0,0
20160604-ccc_fpb_script,2016/06/04,ccc_fpb_script,0,0,0:00:00,0,0:00:00,0,0
20160604-ccc_help_script,2016/06/04,ccc_help_script,7,7,0:00:14,14,0:00:33,0,98
20160604-ccc_link_script,2016/06/04,ccc_link_script,0,0,0:00:00,0,0:00:00,0,0
20160604-ccc_media_line_script,2016/06/04,ccc_media_line_script,1,1,0:00:08,8,0:00:08,0,8
20160604-ccc_priority_script,2016/06/04,ccc_priority_script,28,28,0:00:16,16,0:01:26,0,448
20160604-ccc_tax_script,2016/06/04,ccc_tax_script,0,0,0:00:00,0,0:00:00,0,0
20160604-ccc_waste_recycling_script,2016/06/04,ccc_waste_recycling_script,0,0,0:00:00,0,0:00:00,0,0
20160605-ccc_311_calgary_script,2016/06/05,ccc_311_calgary_script,1367,1296,0:00:40,40,0:11:17,71,51840
20160605-ccc_311_lobby_ph_script,2016/06/05,ccc_311_lobby_ph_script,0,0,0:00:00,0,0:00:00,0,0
20160605-ccc_aserv_info_script,2016/06/05,ccc_aserv_info_script,0,0,0:00:00,0,0:00:00,0,0
20160605-ccc_bylaw_script,2016/06/05,ccc_bylaw_script,0,0,0:00:00,0,0:00:00,0,0
20160605-ccc_city_script,2016/06/05,ccc_city_script,0,0,0:00:00,0,0:00:00,0,0
20160605-ccc_cty_online_script,2016/06/05,ccc_cty_online_script,0,0,0:00:00,0,0:00:00,0,0
20160605-ccc_feedback_script,2016/06/05,ccc_feedback_script,0,0,0:00:00,0,0:00:00,0,0
20160605-ccc_fpb_script,2016/06/05,ccc_fpb_script,0,0,0:00:00,0,0:00:00,0,0
20160605-ccc_help_script,2016/06/05,ccc_help_script,1,1,0:00:09,9,0:00:09,0,9
20160605-ccc_link_script,2016/06/05,ccc_link_script,0,0,0:00:00,0,0:00:00,0,0
20160605-ccc_media_line_script,2016/06/05,ccc_media_line_script,1,1,0:00:02,2,0:00:02,0,2
20160605-ccc_priority_script,2016/06/05,ccc_priority_script,27,26,0:00:18,18,0:01:16,1,468
20160605-ccc_tax_script,2016/06/05,ccc_tax_script,0,0,0:00:00,0,0:00:00,0,0
20160605-ccc_waste_recycling_script,2016/06/05,ccc_waste_recycling_script,0,0,0:00:00,0,0:00:00,0,0
20160606-ccc_311_calgary_script,2016/06/06,ccc_311_calgary_script,5293,4085,0:04:23,263,0:13:42,1208,1074355
20160606-ccc_311_lobby_ph_script,2016/06/06,ccc_311_lobby_ph_script,1,0,0:00:00,0,0:00:00,1,0
20160606-ccc_aserv_info_script,2016/06/06,ccc_aserv_info_script,0,0,0:00:00,0,0:00:00,0,0
20160606-ccc_bylaw_script,2016/06/06,ccc_bylaw_script,0,0,0:00:00,0,0:00:00,0,0
20160606-ccc_city_script,2016/06/06,ccc_city_script,33,30,0:01:30,90,0:09:50,3,2700
20160606-ccc_cty_online_script,2016/06/06,ccc_cty_online_script,0,0,0:00:00,0,0:00:00,0,0
20160606-ccc_feedback_script,2016/06/06,ccc_feedback_script,0,0,0:00:00,0,0:00:00,0,0
20160606-ccc_fpb_script,2016/06/06,ccc_fpb_script,0,0,0:00:00,0,0:00:00,0,0
20160606-ccc_help_script,2016/06/06,ccc_help_script,45,42,0:00:10,10,0:00:29,3,420
20160606-ccc_link_script,2016/06/06,ccc_link_script,0,0,0:00:00,0,0:00:00,0,0
20160606-ccc_media_line_script,2016/06/06,ccc_media_line_script,1,0,0:00:00,0,0:00:00,1,0
20160606-ccc_priority_script,2016/06/06,ccc_priority_script,31,30,0:00:30,30,0:02:46,1,900
20160606-ccc_tax_script,2016/06/06,ccc_tax_script,21,15,0:03:53,233,0:08:59,6,3495
20160606-ccc_waste_recycling_script,2016/06/06,ccc_waste_recycling_script,0,0,0:00:00,0,0:00:00,0,0
20160607-ccc_311_calgary_script,2016/06/07,ccc_311_calgary_script,5192,3863,0:05:08,308,0:28:08,1328,1189804
20160607-ccc_311_lobby_ph_script,2016/06/07,ccc_311_lobby_ph_script,5,3,0:00:12,12,0:00:15,2,36
20160607-ccc_aserv_info_script,2016/06/07,ccc_aserv_info_script,0,0,0:00:00,0,0:00:00,0,0
20160607-ccc_bylaw_script,2016/06/07,ccc_bylaw_script,0,0,0:00:00,0,0:00:00,0,0
20160607-ccc_city_script,2016/06/07,ccc_city_script,27,24,0:01:11,71,0:06:34,3,1704
20160607-ccc_cty_online_script,2016/06/07,ccc_cty_online_script,0,0,0:00:00,0,0:00:00,0,0
20160607-ccc_feedback_script,2016/06/07,ccc_feedback_script,0,0,0:00:00,0,0:00:00,0,0
20160607-ccc_fpb_script,2016/06/07,ccc_fpb_script,8,2,0:05:50,350,0:07:11,6,700
20160607-ccc_help_script,2016/06/07,ccc_help_script,22,22,0:00:07,7,0:00:21,0,154
20160607-ccc_link_script,2016/06/07,ccc_link_script,0,0,0:00:00,0,0:00:00,0,0
20160607-ccc_media_line_script,2016/06/07,ccc_media_line_script,0,0,0:00:00,0,0:00:00,0,0
20160607-ccc_priority_script,2016/06/07,ccc_priority_script,40,38,0:00:15,15,0:00:59,2,570
20160607-ccc_tax_script,2016/06/07,ccc_tax_script,28,23,0:05:47,347,0:20:14,5,7981
20160607-ccc_waste_recycling_script,2016/06/07,ccc_waste_recycling_script,0,0,0:00:00,0,0:00:00,0,0
20160608-ccc_311_calgary_script,2016/06/08,ccc_311_calgary_script,4809,3599,0:04:51,291,0:22:50,1211,1047309
20160608-ccc_311_lobby_ph_script,2016/06/08,ccc_311_lobby_ph_script,3,1,0:00:19,19,0:00:19,2,19
20160608-ccc_aserv_info_script,2016/06/08,ccc_aserv_info_script,0,0,0:00:00,0,0:00:00,0,0
20160608-ccc_bylaw_script,2016/06/08,ccc_bylaw_script,0,0,0:00:00,0,0:00:00,0,0
20160608-ccc_city_script,2016/06/08,ccc_city_script,30,27,0:01:39,99,0:08:42,3,2673
20160608-ccc_cty_online_script,2016/06/08,ccc_cty_online_script,0,0,0:00:00,0,0:00:00,0,0
20160608-ccc_feedback_script,2016/06/08,ccc_feedback_script,0,0,0:00:00,0,0:00:00,0,0
20160608-ccc_fpb_script,2016/06/08,ccc_fpb_script,1,1,0:03:16,196,0:03:16,0,196
20160608-ccc_help_script,2016/06/08,ccc_help_script,32,31,0:00:12,12,0:00:40,1,372
20160608-ccc_link_script,2016/06/08,ccc_link_script,0,0,0:00:00,0,0:00:00,0,0
20160608-ccc_media_line_script,2016/06/08,ccc_media_line_script,0,0,0:00:00,0,0:00:00,0,0
20160608-ccc_priority_script,2016/06/08,ccc_priority_script,35,33,0:00:24,24,0:03:39,2,792
20160608-ccc_tax_script,2016/06/08,ccc_tax_script,14,10,0:06:38,398,0:09:48,4,3980
20160608-ccc_waste_recycling_script,2016/06/08,ccc_waste_recycling_script,0,0,0:00:00,0,0:00:00,0,0
20160609-ccc_311_calgary_script,2016/06/09,ccc_311_calgary_script,4526,3430,0:05:04,304,0:11:25,1096,1042720
20160609-ccc_311_lobby_ph_script,2016/06/09,ccc_311_lobby_ph_script,4,4,0:00:10,10,0:00:21,0,40
20160609-ccc_aserv_info_script,2016/06/09,ccc_aserv_info_script,0,0,0:00:00,0,0:00:00,0,0
20160609-ccc_bylaw_script,2016/06/09,ccc_bylaw_script,0,0,0:00:00,0,0:00:00,0,0
20160609-ccc_city_script,2016/06/09,ccc_city_script,37,32,0:02:15,135,0:07:47,5,4320
20160609-ccc_cty_online_script,2016/06/09,ccc_cty_online_script,0,0,0:00:00,0,0:00:00,0,0
20160609-ccc_feedback_script,2016/06/09,ccc_feedback_script,0,0,0:00:00,0,0:00:00,0,0
20160609-ccc_fpb_script,2016/06/09,ccc_fpb_script,1,1,0:05:28,328,0:05:28,0,328
20160609-ccc_help_script,2016/06/09,ccc_help_script,37,32,0:00:12,12,0:00:51,5,384
20160609-ccc_link_script,2016/06/09,ccc_link_script,0,0,0:00:00,0,0:00:00,0,0
20160609-ccc_media_line_script,2016/06/09,ccc_media_line_script,2,1,0:00:08,8,0:00:08,1,8
20160609-ccc_priority_script,2016/06/09,ccc_priority_script,38,37,0:00:12,12,0:00:27,1,444
20160609-ccc_tax_script,2016/06/09,ccc_tax_script,17,15,0:04:59,299,0:09:10,2,4485
20160609-ccc_waste_recycling_script,2016/06/09,ccc_waste_recycling_script,0,0,0:00:00,0,0:00:00,0,0
20160610-ccc_311_calgary_script,2016/06/10,ccc_311_calgary_script,3865,3351,0:02:27,147,0:09:06,514,492597
20160610-ccc_311_lobby_ph_script,2016/06/10,ccc_311_lobby_ph_script,0,0,0:00:00,0,0:00:00,0,0
20160610-ccc_aserv_info_script,2016/06/10,ccc_aserv_info_script,0,0,0:00:00,0,0:00:00,0,0
20160610-ccc_bylaw_script,2016/06/10,ccc_bylaw_script,0,0,0:00:00,0,0:00:00,0,0
20160610-ccc_city_script,2016/06/10,ccc_city_script,22,21,0:00:56,56,0:06:21,1,1176
20160610-ccc_cty_online_script,2016/06/10,ccc_cty_online_script,0,0,0:00:00,0,0:00:00,0,0
20160610-ccc_feedback_script,2016/06/10,ccc_feedback_script,0,0,0:00:00,0,0:00:00,0,0
20160610-ccc_fpb_script,2016/06/10,ccc_fpb_script,1,1,0:00:04,4,0:00:04,0,4
20160610-ccc_help_script,2016/06/10,ccc_help_script,19,18,0:00:08,8,0:00:19,1,144
20160610-ccc_link_script,2016/06/10,ccc_link_script,1,0,0:00:00,0,0:00:00,1,0
20160610-ccc_media_line_script,2016/06/10,ccc_media_line_script,0,0,0:00:00,0,0:00:00,0,0
20160610-ccc_priority_script,2016/06/10,ccc_priority_script,29,29,0:00:13,13,0:01:19,0,377
20160610-ccc_tax_script,2016/06/10,ccc_tax_script,18,16,0:01:54,114,0:05:50,2,1824
20160610-ccc_waste_recycling_script,2016/06/10,ccc_waste_recycling_script,0,0,0:00:00,0,0:00:00,0,0
20160611-ccc_311_calgary_script,2016/06/11,ccc_311_calgary_script,1450,1412,0:00:22,22,0:09:18,38,31064
20160611-ccc_311_lobby_ph_script,2016/06/11,ccc_311_lobby_ph_script,0,0,0:00:00,0,0:00:00,0,0
20160611-ccc_aserv_info_script,2016/06/11,ccc_aserv_info_script,0,0,0:00:00,0,0:00:00,0,0
20160611-ccc_bylaw_script,2016/06/11,ccc_bylaw_script,0,0,0:00:00,0,0:00:00,0,0
20160611-ccc_city_script,2016/06/11,ccc_city_script,0,0,0:00:00,0,0:00:00,0,0
20160611-ccc_cty_online_script,2016/06/11,ccc_cty_online_script,0,0,0:00:00,0,0:00:00,0,0
20160611-ccc_feedback_script,2016/06/11,ccc_feedback_script,0,0,0:00:00,0,0:00:00,0,0
20160611-ccc_fpb_script,2016/06/11,ccc_fpb_script,2,2,0:00:06,6,0:00:10,0,12
20160611-ccc_help_script,2016/06/11,ccc_help_script,7,6,0:00:04,4,0:00:11,1,24
20160611-ccc_link_script,2016/06/11,ccc_link_script,0,0,0:00:00,0,0:00:00,0,0
20160611-ccc_media_line_script,2016/06/11,ccc_media_line_script,0,0,0:00:00,0,0:00:00,0,0
20160611-ccc_priority_script,2016/06/11,ccc_priority_script,34,33,0:00:14,14,0:01:32,1,462
20160611-ccc_tax_script,2016/06/11,ccc_tax_script,0,0,0:00:00,0,0:00:00,0,0
20160611-ccc_waste_recycling_script,2016/06/11,ccc_waste_recycling_script,0,0,0:00:00,0,0:00:00,0,0
20160612-ccc_311_calgary_script,2016/06/12,ccc_311_calgary_script,1171,1151,0:00:23,23,0:09:27,20,26473
20160612-ccc_311_lobby_ph_script,2016/06/12,ccc_311_lobby_ph_script,0,0,0:00:00,0,0:00:00,0,0
20160612-ccc_aserv_info_script,2016/06/12,ccc_aserv_info_script,0,0,0:00:00,0,0:00:00,0,0
20160612-ccc_bylaw_script,2016/06/12,ccc_bylaw_script,0,0,0:00:00,0,0:00:00,0,0
20160612-ccc_city_script,2016/06/12,ccc_city_script,0,0,0:00:00,0,0:00:00,0,0
20160612-ccc_cty_online_script,2016/06/12,ccc_cty_online_script,0,0,0:00:00,0,0:00:00,0,0
20160612-ccc_feedback_script,2016/06/12,ccc_feedback_script,0,0,0:00:00,0,0:00:00,0,0
20160612-ccc_fpb_script,2016/06/12,ccc_fpb_script,0,0,0:00:00,0,0:00:00,0,0
20160612-ccc_help_script,2016/06/12,ccc_help_script,2,2,0:00:05,5,0:00:08,0,10
20160612-ccc_link_script,2016/06/12,ccc_link_script,0,0,0:00:00,0,0:00:00,0,0
20160612-ccc_media_line_script,2016/06/12,ccc_media_line_script,0,0,0:00:00,0,0:00:00,0,0
20160612-ccc_priority_script,2016/06/12,ccc_priority_script,25,24,0:00:11,11,0:01:52,1,264
20160612-ccc_tax_script,2016/06/12,ccc_tax_script,0,0,0:00:00,0,0:00:00,0,0
20160612-ccc_waste_recycling_script,2016/06/12,ccc_waste_recycling_script,0,0,0:00:00,0,0:00:00,0,0
20160613-ccc_311_calgary_script,2016/06/13,ccc_311_calgary_script,5106,3781,0:05:04,304,0:13:33,1325,1149424
20160613-ccc_311_lobby_ph_script,2016/06/13,ccc_311_lobby_ph_script,4,4,0:00:14,14,0:00:36,0,56
20160613-ccc_aserv_info_script,2016/06/13,ccc_aserv_info_script,0,0,0:00:00,0,0:00:00,0,0
20160613-ccc_bylaw_script,2016/06/13,ccc_bylaw_script,0,0,0:00:00,0,0:00:00,0,0
20160613-ccc_city_script,2016/06/13,ccc_city_script,19,18,0:02:21,141,0:08:08,1,2538
20160613-ccc_cty_online_script,2016/06/13,ccc_cty_online_script,0,0,0:00:00,0,0:00:00,0,0
20160613-ccc_feedback_script,2016/06/13,ccc_feedback_script,0,0,0:00:00,0,0:00:00,0,0
20160613-ccc_fpb_script,2016/06/13,ccc_fpb_script,3,0,0:00:00,0,0:00:00,3,0
20160613-ccc_help_script,2016/06/13,ccc_help_script,26,25,0:00:17,17,0:02:55,1,425
20160613-ccc_link_script,2016/06/13,ccc_link_script,1,0,0:00:00,0,0:00:00,0,0
20160613-ccc_media_line_script,2016/06/13,ccc_media_line_script,1,1,0:00:04,4,0:00:04,0,4
20160613-ccc_priority_script,2016/06/13,ccc_priority_script,43,41,0:00:13,13,0:01:27,2,533
20160613-ccc_tax_script,2016/06/13,ccc_tax_script,21,15,0:05:15,315,0:12:11,6,4725
20160613-ccc_waste_recycling_script,2016/06/13,ccc_waste_recycling_script,0,0,0:00:00,0,0:00:00,0,0
20160614-ccc_311_calgary_script,2016/06/14,ccc_311_calgary_script,4379,3720,0:02:57,177,0:16:27,659,658440
20160614-ccc_311_lobby_ph_script,2016/06/14,ccc_311_lobby_ph_script,2,2,0:00:11,11,0:00:14,0,22
20160614-ccc_aserv_info_script,2016/06/14,ccc_aserv_info_script,0,0,0:00:00,0,0:00:00,0,0
20160614-ccc_bylaw_script,2016/06/14,ccc_bylaw_script,0,0,0:00:00,0,0:00:00,0,0
20160614-ccc_city_script,2016/06/14,ccc_city_script,19,17,0:00:19,19,0:01:49,2,323
20160614-ccc_cty_online_script,2016/06/14,ccc_cty_online_script,0,0,0:00:00,0,0:00:00,0,0
20160614-ccc_feedback_script,2016/06/14,ccc_feedback_script,0,0,0:00:00,0,0:00:00,0,0
20160614-ccc_fpb_script,2016/06/14,ccc_fpb_script,2,1,0:00:39,39,0:00:39,1,39
20160614-ccc_help_script,2016/06/14,ccc_help_script,22,20,0:00:13,13,0:00:47,2,260
20160614-ccc_link_script,2016/06/14,ccc_link_script,0,0,0:00:00,0,0:00:00,0,0
20160614-ccc_media_line_script,2016/06/14,ccc_media_line_script,0,0,0:00:00,0,0:00:00,0,0
20160614-ccc_priority_script,2016/06/14,ccc_priority_script,31,30,0:00:19,19,0:01:11,1,570
20160614-ccc_tax_script,2016/06/14,ccc_tax_script,21,17,0:03:50,230,0:07:10,4,3910
20160614-ccc_waste_recycling_script,2016/06/14,ccc_waste_recycling_script,0,0,0:00:00,0,0:00:00,0,0
20160615-ccc_311_calgary_script,2016/06/15,ccc_311_calgary_script,4466,3340,0:05:11,311,0:12:58,1126,1038740
20160615-ccc_311_lobby_ph_script,2016/06/15,ccc_311_lobby_ph_script,0,0,0:00:00,0,0:00:00,0,0
20160615-ccc_aserv_info_script,2016/06/15,ccc_aserv_info_script,0,0,0:00:00,0,0:00:00,0,0
20160615-ccc_bylaw_script,2016/06/15,ccc_bylaw_script,0,0,0:00:00,0,0:00:00,0,0
20160615-ccc_city_script,2016/06/15,ccc_city_script,22,18,0:02:30,150,0:05:55,4,2700
20160615-ccc_cty_online_script,2016/06/15,ccc_cty_online_script,0,0,0:00:00,0,0:00:00,0,0
20160615-ccc_feedback_script,2016/06/15,ccc_feedback_script,0,0,0:00:00,0,0:00:00,0,0
20160615-ccc_fpb_script,2016/06/15,ccc_fpb_script,3,2,0:06:28,388,0:09:20,1,776
20160615-ccc_help_script,2016/06/15,ccc_help_script,34,33,0:00:14,14,0:00:47,1,462
20160615-ccc_link_script,2016/06/15,ccc_link_script,0,0,0:00:00,0,0:00:00,0,0
20160615-ccc_media_line_script,2016/06/15,ccc_media_line_script,0,0,0:00:00,0,0:00:00,0,0
20160615-ccc_priority_script,2016/06/15,ccc_priority_script,26,25,0:00:12,12,0:00:28,1,300
20160615-ccc_tax_script,2016/06/15,ccc_tax_script,12,9,0:05:48,348,0:11:52,3,3132
20160615-ccc_waste_recycling_script,2016/06/15,ccc_waste_recycling_script,0,0,0:00:00,0,0:00:00,0,0
20160616-ccc_311_calgary_script,2016/06/16,ccc_311_calgary_script,4011,3246,0:03:34,214,0:10:45,765,694644
20160616-ccc_311_lobby_ph_script,2016/06/16,ccc_311_lobby_ph_script,2,2,0:00:03,3,0:00:05,0,6
20160616-ccc_aserv_info_script,2016/06/16,ccc_aserv_info_script,0,0,0:00:00,0,0:00:00,0,0
20160616-ccc_bylaw_script,2016/06/16,ccc_bylaw_script,0,0,0:00:00,0,0:00:00,0,0
20160616-ccc_city_script,2016/06/16,ccc_city_script,11,11,0:01:16,76,0:05:20,0,836
20160616-ccc_cty_online_script,2016/06/16,ccc_cty_online_script,0,0,0:00:00,0,0:00:00,0,0
20160616-ccc_feedback_script,2016/06/16,ccc_feedback_script,0,0,0:00:00,0,0:00:00,0,0
20160616-ccc_fpb_script,2016/06/16,ccc_fpb_script,0,0,0:00:00,0,0:00:00,0,0
20160616-ccc_help_script,2016/06/16,ccc_help_script,42,41,0:00:14,14,0:00:41,1,574
20160616-ccc_link_script,2016/06/16,ccc_link_script,0,0,0:00:00,0,0:00:00,0,0
20160616-ccc_media_line_script,2016/06/16,ccc_media_line_script,1,1,0:00:08,8,0:00:08,0,8
20160616-ccc_priority_script,2016/06/16,ccc_priority_script,35,35,0:00:13,13,0:01:06,0,455
20160616-ccc_tax_script,2016/06/16,ccc_tax_script,20,17,0:04:26,266,0:09:51,3,4522
20160616-ccc_waste_recycling_script,2016/06/16,ccc_waste_recycling_script,0,0,0:00:00,0,0:00:00,0,0
20160617-ccc_311_calgary_script,2016/06/17,ccc_311_calgary_script,3850,3229,0:03:12,192,0:11:13,621,619968
20160617-ccc_311_lobby_ph_script,2016/06/17,ccc_311_lobby_ph_script,5,5,0:00:21,21,0:00:35,0,105
20160617-ccc_aserv_info_script,2016/06/17,ccc_aserv_info_script,0,0,0:00:00,0,0:00:00,0,0
20160617-ccc_bylaw_script,2016/06/17,ccc_bylaw_script,0,0,0:00:00,0,0:00:00,0,0
20160617-ccc_city_script,2016/06/17,ccc_city_script,21,20,0:00:42,42,0:03:36,1,840
20160617-ccc_cty_online_script,2016/06/17,ccc_cty_online_script,0,0,0:00:00,0,0:00:00,0,0
20160617-ccc_feedback_script,2016/06/17,ccc_feedback_script,0,0,0:00:00,0,0:00:00,0,0
20160617-ccc_fpb_script,2016/06/17,ccc_fpb_script,1,1,0:02:53,173,0:02:53,0,173
20160617-ccc_help_script,2016/06/17,ccc_help_script,29,27,0:00:19,19,0:01:32,2,513
20160617-ccc_link_script,2016/06/17,ccc_link_script,0,0,0:00:00,0,0:00:00,0,0
20160617-ccc_media_line_script,2016/06/17,ccc_media_line_script,0,0,0:00:00,0,0:00:00,0,0
20160617-ccc_priority_script,2016/06/17,ccc_priority_script,22,19,0:00:11,11,0:00:52,3,209
20160617-ccc_tax_script,2016/06/17,ccc_tax_script,23,18,0:03:10,190,0:07:35,5,3420
20160617-ccc_waste_recycling_script,2016/06/17,ccc_waste_recycling_script,0,0,0:00:00,0,0:00:00,0,0
20160618-ccc_311_calgary_script,2016/06/18,ccc_311_calgary_script,1417,1350,0:00:30,30,0:13:51,65,40500
20160618-ccc_311_lobby_ph_script,2016/06/18,ccc_311_lobby_ph_script,0,0,0:00:00,0,0:00:00,0,0
20160618-ccc_aserv_info_script,2016/06/18,ccc_aserv_info_script,0,0,0:00:00,0,0:00:00,0,0
20160618-ccc_bylaw_script,2016/06/18,ccc_bylaw_script,0,0,0:00:00,0,0:00:00,0,0
20160618-ccc_city_script,2016/06/18,ccc_city_script,0,0,0:00:00,0,0:00:00,0,0
20160618-ccc_cty_online_script,2016/06/18,ccc_cty_online_script,0,0,0:00:00,0,0:00:00,0,0
20160618-ccc_feedback_script,2016/06/18,ccc_feedback_script,0,0,0:00:00,0,0:00:00,0,0
20160618-ccc_fpb_script,2016/06/18,ccc_fpb_script,1,1,0:00:10,10,0:00:10,0,10
20160618-ccc_help_script,2016/06/18,ccc_help_script,8,8,0:00:31,31,0:01:36,0,248
20160618-ccc_link_script,2016/06/18,ccc_link_script,0,0,0:00:00,0,0:00:00,0,0
20160618-ccc_media_line_script,2016/06/18,ccc_media_line_script,0,0,0:00:00,0,0:00:00,0,0
20160618-ccc_priority_script,2016/06/18,ccc_priority_script,24,24,0:00:18,18,0:03:59,0,432
20160618-ccc_tax_script,2016/06/18,ccc_tax_script,3,2,0:00:06,6,0:00:09,1,12
20160618-ccc_waste_recycling_script,2016/06/18,ccc_waste_recycling_script,0,0,0:00:00,0,0:00:00,0,0
20160619-ccc_311_calgary_script,2016/06/19,ccc_311_calgary_script,1013,988,0:00:22,22,0:11:12,27,21736
20160619-ccc_311_lobby_ph_script,2016/06/19,ccc_311_lobby_ph_script,0,0,0:00:00,0,0:00:00,0,0
20160619-ccc_aserv_info_script,2016/06/19,ccc_aserv_info_script,0,0,0:00:00,0,0:00:00,0,0
20160619-ccc_bylaw_script,2016/06/19,ccc_bylaw_script,0,0,0:00:00,0,0:00:00,0,0
20160619-ccc_city_script,2016/06/19,ccc_city_script,0,0,0:00:00,0,0:00:00,0,0
20160619-ccc_cty_online_script,2016/06/19,ccc_cty_online_script,0,0,0:00:00,0,0:00:00,0,0
20160619-ccc_feedback_script,2016/06/19,ccc_feedback_script,0,0,0:00:00,0,0:00:00,0,0
20160619-ccc_fpb_script,2016/06/19,ccc_fpb_script,0,0,0:00:00,0,0:00:00,0,0
20160619-ccc_help_script,2016/06/19,ccc_help_script,1,1,0:00:06,6,0:00:06,0,6
20160619-ccc_link_script,2016/06/19,ccc_link_script,0,0,0:00:00,0,0:00:00,0,0
20160619-ccc_media_line_script,2016/06/19,ccc_media_line_script,1,1,0:00:05,5,0:00:05,0,5
20160619-ccc_priority_script,2016/06/19,ccc_priority_script,22,22,0:00:14,14,0:02:43,0,308
20160619-ccc_tax_script,2016/06/19,ccc_tax_script,1,0,0:00:00,0,0:00:00,1,0
20160619-ccc_waste_recycling_script,2016/06/19,ccc_waste_recycling_script,0,0,0:00:00,0,0:00:00,0,0
20160620-ccc_311_calgary_script,2016/06/20,ccc_311_calgary_script,4789,3927,0:03:31,211,0:16:44,860,828597
20160620-ccc_311_lobby_ph_script,2016/06/20,ccc_311_lobby_ph_script,2,2,0:00:04,4,0:00:06,0,8
20160620-ccc_aserv_info_script,2016/06/20,ccc_aserv_info_script,0,0,0:00:00,0,0:00:00,0,0
20160620-ccc_bylaw_script,2016/06/20,ccc_bylaw_script,0,0,0:00:00,0,0:00:00,0,0
20160620-ccc_city_script,2016/06/20,ccc_city_script,23,20,0:00:57,57,0:07:04,3,1140
20160620-ccc_cty_online_script,2016/06/20,ccc_cty_online_script,0,0,0:00:00,0,0:00:00,0,0
20160620-ccc_feedback_script,2016/06/20,ccc_feedback_script,0,0,0:00:00,0,0:00:00,0,0
20160620-ccc_fpb_script,2016/06/20,ccc_fpb_script,0,0,0:00:00,0,0:00:00,0,0
20160620-ccc_help_script,2016/06/20,ccc_help_script,18,18,0:00:09,9,0:00:31,0,162
20160620-ccc_link_script,2016/06/20,ccc_link_script,0,0,0:00:00,0,0:00:00,0,0
20160620-ccc_media_line_script,2016/06/20,ccc_media_line_script,1,1,0:00:03,3,0:00:03,0,3
20160620-ccc_priority_script,2016/06/20,ccc_priority_script,29,28,0:00:16,16,0:01:06,1,448
20160620-ccc_tax_script,2016/06/20,ccc_tax_script,18,16,0:03:25,205,0:08:59,2,3280
20160620-ccc_waste_recycling_script,2016/06/20,ccc_waste_recycling_script,0,0,0:00:00,0,0:00:00,0,0
20160621-ccc_311_calgary_script,2016/06/21,ccc_311_calgary_script,4428,3991,0:01:39,99,0:10:36,438,395109
20160621-ccc_311_lobby_ph_script,2016/06/21,ccc_311_lobby_ph_script,8,6,0:00:06,6,0:00:13,2,36
20160621-ccc_aserv_info_script,2016/06/21,ccc_aserv_info_script,0,0,0:00:00,0,0:00:00,0,0
20160621-ccc_bylaw_script,2016/06/21,ccc_bylaw_script,0,0,0:00:00,0,0:00:00,0,0
20160621-ccc_city_script,2016/06/21,ccc_city_script,47,42,0:00:45,45,0:05:15,5,1890
20160621-ccc_cty_online_script,2016/06/21,ccc_cty_online_script,0,0,0:00:00,0,0:00:00,0,0
20160621-ccc_feedback_script,2016/06/21,ccc_feedback_script,0,0,0:00:00,0,0:00:00,0,0
20160621-ccc_fpb_script,2016/06/21,ccc_fpb_script,1,1,0:02:56,176,0:02:56,0,176
20160621-ccc_help_script,2016/06/21,ccc_help_script,24,22,0:00:12,12,0:00:38,2,264
20160621-ccc_link_script,2016/06/21,ccc_link_script,0,0,0:00:00,0,0:00:00,0,0
20160621-ccc_media_line_script,2016/06/21,ccc_media_line_script,2,2,0:00:07,7,0:00:13,0,14
20160621-ccc_priority_script,2016/06/21,ccc_priority_script,42,40,0:00:12,12,0:00:45,2,480
20160621-ccc_tax_script,2016/06/21,ccc_tax_script,15,14,0:02:30,150,0:05:40,1,2100
20160621-ccc_waste_recycling_script,2016/06/21,ccc_waste_recycling_script,0,0,0:00:00,0,0:00:00,0,0
20160622-ccc_311_calgary_script,2016/06/22,ccc_311_calgary_script,4241,3565,0:02:56,176,0:19:53,677,627440
20160622-ccc_311_lobby_ph_script,2016/06/22,ccc_311_lobby_ph_script,0,0,0:00:00,0,0:00:00,0,0
20160622-ccc_aserv_info_script,2016/06/22,ccc_aserv_info_script,0,0,0:00:00,0,0:00:00,0,0
20160622-ccc_bylaw_script,2016/06/22,ccc_bylaw_script,0,0,0:00:00,0,0:00:00,0,0
20160622-ccc_city_script,2016/06/22,ccc_city_script,26,24,0:01:00,60,0:03:55,2,1440
20160622-ccc_cty_online_script,2016/06/22,ccc_cty_online_script,0,0,0:00:00,0,0:00:00,0,0
20160622-ccc_feedback_script,2016/06/22,ccc_feedback_script,0,0,0:00:00,0,0:00:00,0,0
20160622-ccc_fpb_script,2016/06/22,ccc_fpb_script,2,1,0:00:05,5,0:00:05,1,5
20160622-ccc_help_script,2016/06/22,ccc_help_script,43,35,0:00:13,13,0:01:27,8,455
20160622-ccc_link_script,2016/06/22,ccc_link_script,0,0,0:00:00,0,0:00:00,0,0
20160622-ccc_media_line_script,2016/06/22,ccc_media_line_script,2,2,0:00:05,5,0:00:05,0,10
20160622-ccc_priority_script,2016/06/22,ccc_priority_script,38,35,0:00:21,21,0:02:22,3,735
20160622-ccc_tax_script,2016/06/22,ccc_tax_script,15,10,0:01:59,119,0:04:48,5,1190
20160622-ccc_waste_recycling_script,2016/06/22,ccc_waste_recycling_script,0,0,0:00:00,0,0:00:00,0,0
20160623-ccc_311_calgary_script,2016/06/23,ccc_311_calgary_script,4329,3758,0:02:12,132,0:11:27,571,496056
20160623-ccc_311_lobby_ph_script,2016/06/23,ccc_311_lobby_ph_script,3,3,0:00:11,11,0:00:21,0,33
20160623-ccc_aserv_info_script,2016/06/23,ccc_aserv_info_script,0,0,0:00:00,0,0:00:00,0,0
20160623-ccc_bylaw_script,2016/06/23,ccc_bylaw_script,0,0,0:00:00,0,0:00:00,0,0
20160623-ccc_city_script,2016/06/23,ccc_city_script,30,27,0:00:40,40,0:03:56,3,1080
20160623-ccc_cty_online_script,2016/06/23,ccc_cty_online_script,0,0,0:00:00,0,0:00:00,0,0
20160623-ccc_feedback_script,2016/06/23,ccc_feedback_script,0,0,0:00:00,0,0:00:00,0,0
20160623-ccc_fpb_script,2016/06/23,ccc_fpb_script,0,0,0:00:00,0,0:00:00,0,0
20160623-ccc_help_script,2016/06/23,ccc_help_script,30,25,0:00:14,14,0:01:02,5,350
20160623-ccc_link_script,2016/06/23,ccc_link_script,0,0,0:00:00,0,0:00:00,0,0
20160623-ccc_media_line_script,2016/06/23,ccc_media_line_script,1,1,0:00:13,13,0:00:13,0,13
20160623-ccc_priority_script,2016/06/23,ccc_priority_script,33,31,0:00:18,18,0:02:48,2,558
20160623-ccc_tax_script,2016/06/23,ccc_tax_script,19,19,0:02:02,122,0:06:24,0,2318
20160623-ccc_waste_recycling_script,2016/06/23,ccc_waste_recycling_script,0,0,0:00:00,0,0:00:00,0,0
20160624-ccc_311_calgary_script,2016/06/24,ccc_311_calgary_script,3855,3240,0:03:18,198,0:11:58,615,641520
20160624-ccc_311_lobby_ph_script,2016/06/24,ccc_311_lobby_ph_script,4,4,0:00:12,12,0:00:18,0,48
20160624-ccc_aserv_info_script,2016/06/24,ccc_aserv_info_script,0,0,0:00:00,0,0:00:00,0,0
20160624-ccc_bylaw_script,2016/06/24,ccc_bylaw_script,0,0,0:00:00,0,0:00:00,0,0
20160624-ccc_city_script,2016/06/24,ccc_city_script,23,21,0:00:57,57,0:05:24,2,1197
20160624-ccc_cty_online_script,2016/06/24,ccc_cty_online_script,0,0,0:00:00,0,0:00:00,0,0
20160624-ccc_feedback_script,2016/06/24,ccc_feedback_script,0,0,0:00:00,0,0:00:00,0,0
20160624-ccc_fpb_script,2016/06/24,ccc_fpb_script,0,0,0:00:00,0,0:00:00,0,0
20160624-ccc_help_script,2016/06/24,ccc_help_script,18,17,0:00:07,7,0:00:31,1,119
20160624-ccc_link_script,2016/06/24,ccc_link_script,0,0,0:00:00,0,0:00:00,0,0
20160624-ccc_media_line_script,2016/06/24,ccc_media_line_script,1,1,0:00:08,8,0:00:08,0,8
20160624-ccc_priority_script,2016/06/24,ccc_priority_script,37,35,0:00:12,12,0:01:29,2,420
20160624-ccc_tax_script,2016/06/24,ccc_tax_script,17,12,0:05:21,321,0:08:01,5,3852
20160624-ccc_waste_recycling_script,2016/06/24,ccc_waste_recycling_script,0,0,0:00:00,0,0:00:00,0,0
20160625-ccc_311_calgary_script,2016/06/25,ccc_311_calgary_script,1504,1424,0:00:36,36,0:06:13,80,51264
20160625-ccc_311_lobby_ph_script,2016/06/25,ccc_311_lobby_ph_script,0,0,0:00:00,0,0:00:00,0,0
20160625-ccc_aserv_info_script,2016/06/25,ccc_aserv_info_script,0,0,0:00:00,0,0:00:00,0,0
20160625-ccc_bylaw_script,2016/06/25,ccc_bylaw_script,0,0,0:00:00,0,0:00:00,0,0
20160625-ccc_city_script,2016/06/25,ccc_city_script,0,0,0:00:00,0,0:00:00,0,0
20160625-ccc_cty_online_script,2016/06/25,ccc_cty_online_script,0,0,0:00:00,0,0:00:00,0,0
20160625-ccc_feedback_script,2016/06/25,ccc_feedback_script,0,0,0:00:00,0,0:00:00,0,0
20160625-ccc_fpb_script,2016/06/25,ccc_fpb_script,0,0,0:00:00,0,0:00:00,0,0
20160625-ccc_help_script,2016/06/25,ccc_help_script,24,22,0:00:21,21,0:01:42,2,462
20160625-ccc_link_script,2016/06/25,ccc_link_script,1,0,0:00:00,0,0:00:00,0,0
20160625-ccc_media_line_script,2016/06/25,ccc_media_line_script,1,1,0:00:25,25,0:00:25,0,25
20160625-ccc_priority_script,2016/06/25,ccc_priority_script,27,26,0:00:43,43,0:09:29,1,1118
20160625-ccc_tax_script,2016/06/25,ccc_tax_script,2,2,0:00:05,5,0:00:05,0,10
20160625-ccc_waste_recycling_script,2016/06/25,ccc_waste_recycling_script,0,0,0:00:00,0,0:00:00,0,0
20160626-ccc_311_calgary_script,2016/06/26,ccc_311_calgary_script,1159,1116,0:00:29,29,0:11:40,43,32364
20160626-ccc_311_lobby_ph_script,2016/06/26,ccc_311_lobby_ph_script,0,0,0:00:00,0,0:00:00,0,0
20160626-ccc_aserv_info_script,2016/06/26,ccc_aserv_info_script,0,0,0:00:00,0,0:00:00,0,0
20160626-ccc_bylaw_script,2016/06/26,ccc_bylaw_script,0,0,0:00:00,0,0:00:00,0,0
20160626-ccc_city_script,2016/06/26,ccc_city_script,0,0,0:00:00,0,0:00:00,0,0
20160626-ccc_cty_online_script,2016/06/26,ccc_cty_online_script,0,0,0:00:00,0,0:00:00,0,0
20160626-ccc_feedback_script,2016/06/26,ccc_feedback_script,0,0,0:00:00,0,0:00:00,0,0
20160626-ccc_fpb_script,2016/06/26,ccc_fpb_script,0,0,0:00:00,0,0:00:00,0,0
20160626-ccc_help_script,2016/06/26,ccc_help_script,6,5,0:00:06,6,0:00:10,1,30
20160626-ccc_link_script,2016/06/26,ccc_link_script,0,0,0:00:00,0,0:00:00,0,0
20160626-ccc_media_line_script,2016/06/26,ccc_media_line_script,1,1,0:00:09,9,0:00:09,0,9
20160626-ccc_priority_script,2016/06/26,ccc_priority_script,39,37,0:00:20,20,0:02:35,2,740
20160626-ccc_tax_script,2016/06/26,ccc_tax_script,1,1,0:00:06,6,0:00:06,0,6
20160626-ccc_waste_recycling_script,2016/06/26,ccc_waste_recycling_script,0,0,0:00:00,0,0:00:00,0,0
20160627-ccc_311_calgary_script,2016/06/27,ccc_311_calgary_script,5032,4428,0:02:23,143,0:08:08,604,633204
20160627-ccc_311_lobby_ph_script,2016/06/27,ccc_311_lobby_ph_script,4,4,0:00:17,17,0:00:22,0,68
20160627-ccc_aserv_info_script,2016/06/27,ccc_aserv_info_script,0,0,0:00:00,0,0:00:00,0,0
20160627-ccc_bylaw_script,2016/06/27,ccc_bylaw_script,0,0,0:00:00,0,0:00:00,0,0
20160627-ccc_city_script,2016/06/27,ccc_city_script,34,34,0:00:18,18,0:01:39,0,612
20160627-ccc_cty_online_script,2016/06/27,ccc_cty_online_script,0,0,0:00:00,0,0:00:00,0,0
20160627-ccc_feedback_script,2016/06/27,ccc_feedback_script,0,0,0:00:00,0,0:00:00,0,0
20160627-ccc_fpb_script,2016/06/27,ccc_fpb_script,0,0,0:00:00,0,0:00:00,0,0
20160627-ccc_help_script,2016/06/27,ccc_help_script,44,40,0:00:11,11,0:00:47,4,440
20160627-ccc_link_script,2016/06/27,ccc_link_script,0,0,0:00:00,0,0:00:00,0,0
20160627-ccc_media_line_script,2016/06/27,ccc_media_line_script,1,1,0:01:10,70,0:01:10,0,70
20160627-ccc_priority_script,2016/06/27,ccc_priority_script,32,32,0:00:13,13,0:00:59,0,416
20160627-ccc_tax_script,2016/06/27,ccc_tax_script,26,22,0:03:31,211,0:07:40,4,4642
20160627-ccc_waste_recycling_script,2016/06/27,ccc_waste_recycling_script,0,0,0:00:00,0,0:00:00,0,0
20160628-ccc_311_calgary_script,2016/06/28,ccc_311_calgary_script,5236,3807,0:05:40,340,0:16:28,1429,1294380
20160628-ccc_311_lobby_ph_script,2016/06/28,ccc_311_lobby_ph_script,4,4,0:00:16,16,0:00:17,0,64
20160628-ccc_aserv_info_script,2016/06/28,ccc_aserv_info_script,0,0,0:00:00,0,0:00:00,0,0
20160628-ccc_bylaw_script,2016/06/28,ccc_bylaw_script,0,0,0:00:00,0,0:00:00,0,0
20160628-ccc_city_script,2016/06/28,ccc_city_script,12,12,0:02:15,135,0:12:50,0,1620
20160628-ccc_cty_online_script,2016/06/28,ccc_cty_online_script,0,0,0:00:00,0,0:00:00,0,0
20160628-ccc_feedback_script,2016/06/28,ccc_feedback_script,1,0,0:00:00,0,0:00:00,0,0
20160628-ccc_fpb_script,2016/06/28,ccc_fpb_script,0,0,0:00:00,0,0:00:00,0,0
20160628-ccc_help_script,2016/06/28,ccc_help_script,55,44,0:00:15,15,0:01:03,11,660
20160628-ccc_link_script,2016/06/28,ccc_link_script,0,0,0:00:00,0,0:00:00,0,0
20160628-ccc_media_line_script,2016/06/28,ccc_media_line_script,0,0,0:00:00,0,0:00:00,0,0
20160628-ccc_priority_script,2016/06/28,ccc_priority_script,38,36,0:00:18,18,0:00:50,2,648
20160628-ccc_tax_script,2016/06/28,ccc_tax_script,14,12,0:05:42,342,0:11:35,2,4104
20160628-ccc_waste_recycling_script,2016/06/28,ccc_waste_recycling_script,0,0,0:00:00,0,0:00:00,0,0
20160629-ccc_311_calgary_script,2016/06/29,ccc_311_calgary_script,5512,4391,0:03:44,224,0:12:01,1121,983584
20160629-ccc_311_lobby_ph_script,2016/06/29,ccc_311_lobby_ph_script,1,0,0:00:00,0,0:00:00,1,0
20160629-ccc_aserv_info_script,2016/06/29,ccc_aserv_info_script,0,0,0:00:00,0,0:00:00,0,0
20160629-ccc_bylaw_script,2016/06/29,ccc_bylaw_script,0,0,0:00:00,0,0:00:00,0,0
20160629-ccc_city_script,2016/06/29,ccc_city_script,18,17,0:01:42,102,0:05:14,1,1734
20160629-ccc_cty_online_script,2016/06/29,ccc_cty_online_script,0,0,0:00:00,0,0:00:00,0,0
20160629-ccc_feedback_script,2016/06/29,ccc_feedback_script,1,0,0:00:00,0,0:00:00,0,0
20160629-ccc_fpb_script,2016/06/29,ccc_fpb_script,1,0,0:00:00,0,0:00:00,1,0
20160629-ccc_help_script,2016/06/29,ccc_help_script,34,31,0:00:11,11,0:01:00,3,341
20160629-ccc_link_script,2016/06/29,ccc_link_script,0,0,0:00:00,0,0:00:00,0,0
20160629-ccc_media_line_script,2016/06/29,ccc_media_line_script,0,0,0:00:00,0,0:00:00,0,0
20160629-ccc_priority_script,2016/06/29,ccc_priority_script,35,33,0:00:10,10,0:00:35,2,330
20160629-ccc_tax_script,2016/06/29,ccc_tax_script,16,12,0:03:37,217,0:09:15,4,2604
20160629-ccc_waste_recycling_script,2016/06/29,ccc_waste_recycling_script,0,0,0:00:00,0,0:00:00,0,0
20160630-ccc_311_calgary_script,2016/06/30,ccc_311_calgary_script,5115,4912,0:00:38,38,0:07:39,203,186656
20160630-ccc_311_lobby_ph_script,2016/06/30,ccc_311_lobby_ph_script,2,2,0:00:10,10,0:00:15,0,20
20160630-ccc_aserv_info_script,2016/06/30,ccc_aserv_info_script,0,0,0:00:00,0,0:00:00,0,0
20160630-ccc_bylaw_script,2016/06/30,ccc_bylaw_script,0,0,0:00:00,0,0:00:00,0,0
20160630-ccc_city_script,2016/06/30,ccc_city_script,15,15,0:00:17,17,0:02:55,0,255
20160630-ccc_cty_online_script,2016/06/30,ccc_cty_online_script,0,0,0:00:00,0,0:00:00,0,0
20160630-ccc_feedback_script,2016/06/30,ccc_feedback_script,1,0,0:00:00,0,0:00:00,0,0
20160630-ccc_fpb_script,2016/06/30,ccc_fpb_script,0,0,0:00:00,0,0:00:00,0,0
20160630-ccc_help_script,2016/06/30,ccc_help_script,32,32,0:00:08,8,0:00:32,0,256
20160630-ccc_link_script,2016/06/30,ccc_link_script,0,0,0:00:00,0,0:00:00,0,0
20160630-ccc_media_line_script,2016/06/30,ccc_media_line_script,1,1,0:00:18,18,0:00:18,0,18
20160630-ccc_priority_script,2016/06/30,ccc_priority_script,27,27,0:00:11,11,0:02:47,0,297
20160630-ccc_tax_script,2016/06/30,ccc_tax_script,14,13,0:00:51,51,0:02:45,1,663
20160630-ccc_waste_recycling_script,2016/06/30,ccc_waste_recycling_script,0,0,0:00:00,0,0:00:00,0,0
20160701-ccc_311_calgary_script,2016/07/01,ccc_311_calgary_script,1822,1712,0:00:28,28,0:16:00,110,47936
20160701-ccc_311_lobby_ph_script,2016/07/01,ccc_311_lobby_ph_script,0,0,0:00:00,0,0:00:00,0,0
20160701-ccc_aserv_info_script,2016/07/01,ccc_aserv_info_script,0,0,0:00:00,0,0:00:00,0,0
20160701-ccc_bylaw_script,2016/07/01,ccc_bylaw_script,0,0,0:00:00,0,0:00:00,0,0
20160701-ccc_city_script,2016/07/01,ccc_city_script,0,0,0:00:00,0,0:00:00,0,0
20160701-ccc_cty_online_script,2016/07/01,ccc_cty_online_script,0,0,0:00:00,0,0:00:00,0,0
20160701-ccc_feedback_script,2016/07/01,ccc_feedback_script,0,0,0:00:00,0,0:00:00,0,0
20160701-ccc_fpb_script,2016/07/01,ccc_fpb_script,0,0,0:00:00,0,0:00:00,0,0
20160701-ccc_help_script,2016/07/01,ccc_help_script,8,7,0:00:07,7,0:00:09,1,49
20160701-ccc_link_script,2016/07/01,ccc_link_script,0,0,0:00:00,0,0:00:00,0,0
20160701-ccc_media_line_script,2016/07/01,ccc_media_line_script,6,5,0:00:13,13,0:00:44,1,65
20160701-ccc_priority_script,2016/07/01,ccc_priority_script,21,21,0:00:08,8,0:00:33,0,168
20160701-ccc_tax_script,2016/07/01,ccc_tax_script,1,1,0:00:02,2,0:00:02,0,2
20160701-ccc_waste_recycling_script,2016/07/01,ccc_waste_recycling_script,0,0,0:00:00,0,0:00:00,0,0
20160702-ccc_311_calgary_script,2016/07/02,ccc_311_calgary_script,1385,1353,0:00:11,11,0:05:16,32,14883
20160702-ccc_311_lobby_ph_script,2016/07/02,ccc_311_lobby_ph_script,0,0,0:00:00,0,0:00:00,0,0
20160702-ccc_aserv_info_script,2016/07/02,ccc_aserv_info_script,0,0,0:00:00,0,0:00:00,0,0
20160702-ccc_bylaw_script,2016/07/02,ccc_bylaw_script,0,0,0:00:00,0,0:00:00,0,0
20160702-ccc_city_script,2016/07/02,ccc_city_script,0,0,0:00:00,0,0:00:00,0,0
20160702-ccc_cty_online_script,2016/07/02,ccc_cty_online_script,0,0,0:00:00,0,0:00:00,0,0
20160702-ccc_feedback_script,2016/07/02,ccc_feedback_script,0,0,0:00:00,0,0:00:00,0,0
20160702-ccc_fpb_script,2016/07/02,ccc_fpb_script,0,0,0:00:00,0,0:00:00,0,0
20160702-ccc_help_script,2016/07/02,ccc_help_script,5,5,0:00:03,3,0:00:06,0,15
20160702-ccc_link_script,2016/07/02,ccc_link_script,0,0,0:00:00,0,0:00:00,0,0
20160702-ccc_media_line_script,2016/07/02,ccc_media_line_script,1,1,0:00:02,2,0:00:02,0,2
20160702-ccc_priority_script,2016/07/02,ccc_priority_script,22,20,0:00:14,14,0:01:14,2,280
20160702-ccc_tax_script,2016/07/02,ccc_tax_script,0,0,0:00:00,0,0:00:00,0,0
20160702-ccc_waste_recycling_script,2016/07/02,ccc_waste_recycling_script,0,0,0:00:00,0,0:00:00,0,0
20160703-ccc_311_calgary_script,2016/07/03,ccc_311_calgary_script,1111,1088,0:00:19,19,0:07:21,23,20672
20160703-ccc_311_lobby_ph_script,2016/07/03,ccc_311_lobby_ph_script,0,0,0:00:00,0,0:00:00,0,0
20160703-ccc_aserv_info_script,2016/07/03,ccc_aserv_info_script,0,0,0:00:00,0,0:00:00,0,0
20160703-ccc_bylaw_script,2016/07/03,ccc_bylaw_script,0,0,0:00:00,0,0:00:00,0,0
20160703-ccc_city_script,2016/07/03,ccc_city_script,0,0,0:00:00,0,0:00:00,0,0
20160703-ccc_cty_online_script,2016/07/03,ccc_cty_online_script,0,0,0:00:00,0,0:00:00,0,0
20160703-ccc_feedback_script,2016/07/03,ccc_feedback_script,0,0,0:00:00,0,0:00:00,0,0
20160703-ccc_fpb_script,2016/07/03,ccc_fpb_script,0,0,0:00:00,0,0:00:00,0,0
20160703-ccc_help_script,2016/07/03,ccc_help_script,6,6,0:00:06,6,0:00:08,0,36
20160703-ccc_link_script,2016/07/03,ccc_link_script,0,0,0:00:00,0,0:00:00,0,0
20160703-ccc_media_line_script,2016/07/03,ccc_media_line_script,2,2,0:00:11,11,0:00:15,0,22
20160703-ccc_priority_script,2016/07/03,ccc_priority_script,20,20,0:00:23,23,0:02:08,0,460
20160703-ccc_tax_script,2016/07/03,ccc_tax_script,1,1,0:00:10,10,0:00:10,0,10
20160703-ccc_waste_recycling_script,2016/07/03,ccc_waste_recycling_script,0,0,0:00:00,0,0:00:00,0,0
20160704-ccc_311_calgary_script,2016/07/04,ccc_311_calgary_script,4483,3678,0:03:01,181,0:07:51,805,665718
20160704-ccc_311_lobby_ph_script,2016/07/04,ccc_311_lobby_ph_script,2,2,0:00:15,15,0:00:22,0,30
20160704-ccc_aserv_info_script,2016/07/04,ccc_aserv_info_script,0,0,0:00:00,0,0:00:00,0,0
20160704-ccc_bylaw_script,2016/07/04,ccc_bylaw_script,0,0,0:00:00,0,0:00:00,0,0
20160704-ccc_city_script,2016/07/04,ccc_city_script,34,33,0:00:53,53,0:04:38,1,1749
20160704-ccc_cty_online_script,2016/07/04,ccc_cty_online_script,0,0,0:00:00,0,0:00:00,0,0
20160704-ccc_feedback_script,2016/07/04,ccc_feedback_script,0,0,0:00:00,0,0:00:00,0,0
20160704-ccc_fpb_script,2016/07/04,ccc_fpb_script,2,2,0:05:14,314,0:06:23,0,628
20160704-ccc_help_script,2016/07/04,ccc_help_script,30,24,0:00:15,15,0:00:59,6,360
20160704-ccc_link_script,2016/07/04,ccc_link_script,0,0,0:00:00,0,0:00:00,0,0
20160704-ccc_media_line_script,2016/07/04,ccc_media_line_script,2,2,0:00:11,11,0:00:19,0,22
20160704-ccc_priority_script,2016/07/04,ccc_priority_script,36,33,0:00:21,21,0:03:05,3,693
20160704-ccc_tax_script,2016/07/04,ccc_tax_script,23,19,0:04:20,260,0:06:46,4,4940
20160704-ccc_waste_recycling_script,2016/07/04,ccc_waste_recycling_script,0,0,0:00:00,0,0:00:00,0,0
20160705-ccc_311_calgary_script,2016/07/05,ccc_311_calgary_script,4222,3084,0:05:12,312,0:12:37,1138,962208
20160705-ccc_311_lobby_ph_script,2016/07/05,ccc_311_lobby_ph_script,6,5,0:00:14,14,0:00:18,1,70
20160705-ccc_aserv_info_script,2016/07/05,ccc_aserv_info_script,0,0,0:00:00,0,0:00:00,0,0
20160705-ccc_bylaw_script,2016/07/05,ccc_bylaw_script,0,0,0:00:00,0,0:00:00,0,0
20160705-ccc_city_script,2016/07/05,ccc_city_script,26,24,0:03:35,215,0:08:41,2,5160
20160705-ccc_cty_online_script,2016/07/05,ccc_cty_online_script,0,0,0:00:00,0,0:00:00,0,0
20160705-ccc_feedback_script,2016/07/05,ccc_feedback_script,1,0,0:00:00,0,0:00:00,0,0
20160705-ccc_fpb_script,2016/07/05,ccc_fpb_script,1,0,0:00:00,0,0:00:00,1,0
20160705-ccc_help_script,2016/07/05,ccc_help_script,30,26,0:00:16,16,0:01:36,4,416
20160705-ccc_link_script,2016/07/05,ccc_link_script,0,0,0:00:00,0,0:00:00,0,0
20160705-ccc_media_line_script,2016/07/05,ccc_media_line_script,1,1,0:00:04,4,0:00:04,0,4
20160705-ccc_priority_script,2016/07/05,ccc_priority_script,35,33,0:00:15,15,0:01:08,2,495
20160705-ccc_tax_script,2016/07/05,ccc_tax_script,29,20,0:06:28,388,0:10:08,9,7760
20160705-ccc_waste_recycling_script,2016/07/05,ccc_waste_recycling_script,0,0,0:00:00,0,0:00:00,0,0
20160706-ccc_311_calgary_script,2016/07/06,ccc_311_calgary_script,4024,2889,0:05:07,307,0:20:32,1131,886923
20160706-ccc_311_lobby_ph_script,2016/07/06,ccc_311_lobby_ph_script,6,3,0:00:17,17,0:00:36,3,51
20160706-ccc_aserv_info_script,2016/07/06,ccc_aserv_info_script,0,0,0:00:00,0,0:00:00,0,0
20160706-ccc_bylaw_script,2016/07/06,ccc_bylaw_script,0,0,0:00:00,0,0:00:00,0,0
20160706-ccc_city_script,2016/07/06,ccc_city_script,19,18,0:02:42,162,0:07:45,1,2916
20160706-ccc_cty_online_script,2016/07/06,ccc_cty_online_script,0,0,0:00:00,0,0:00:00,0,0
20160706-ccc_feedback_script,2016/07/06,ccc_feedback_script,0,0,0:00:00,0,0:00:00,0,0
20160706-ccc_fpb_script,2016/07/06,ccc_fpb_script,1,0,0:00:00,0,0:00:00,1,0
20160706-ccc_help_script,2016/07/06,ccc_help_script,34,30,0:00:16,16,0:00:57,4,480
20160706-ccc_link_script,2016/07/06,ccc_link_script,0,0,0:00:00,0,0:00:00,0,0
20160706-ccc_media_line_script,2016/07/06,ccc_media_line_script,0,0,0:00:00,0,0:00:00,0,0
20160706-ccc_priority_script,2016/07/06,ccc_priority_script,40,40,0:00:32,32,0:05:27,0,1280
20160706-ccc_tax_script,2016/07/06,ccc_tax_script,31,23,0:04:42,282,0:10:15,8,6486
20160706-ccc_waste_recycling_script,2016/07/06,ccc_waste_recycling_script,0,0,0:00:00,0,0:00:00,0,0
20160707-ccc_311_calgary_script,2016/07/07,ccc_311_calgary_script,3845,3327,0:01:55,115,0:19:30,522,382605
20160707-ccc_311_lobby_ph_script,2016/07/07,ccc_311_lobby_ph_script,3,3,0:00:04,4,0:00:06,0,12
20160707-ccc_aserv_info_script,2016/07/07,ccc_aserv_info_script,0,0,0:00:00,0,0:00:00,0,0
20160707-ccc_bylaw_script,2016/07/07,ccc_bylaw_script,0,0,0:00:00,0,0:00:00,0,0
20160707-ccc_city_script,2016/07/07,ccc_city_script,24,22,0:00:39,39,0:03:19,2,858
20160707-ccc_cty_online_script,2016/07/07,ccc_cty_online_script,0,0,0:00:00,0,0:00:00,0,0
20160707-ccc_feedback_script,2016/07/07,ccc_feedback_script,0,0,0:00:00,0,0:00:00,0,0
20160707-ccc_fpb_script,2016/07/07,ccc_fpb_script,2,2,0:00:29,29,0:00:50,0,58
20160707-ccc_help_script,2016/07/07,ccc_help_script,13,12,0:00:11,11,0:00:33,1,132
20160707-ccc_link_script,2016/07/07,ccc_link_script,0,0,0:00:00,0,0:00:00,0,0
20160707-ccc_media_line_script,2016/07/07,ccc_media_line_script,3,2,0:00:10,10,0:00:12,1,20
20160707-ccc_priority_script,2016/07/07,ccc_priority_script,36,35,0:00:21,21,0:03:26,1,735
20160707-ccc_tax_script,2016/07/07,ccc_tax_script,18,16,0:00:45,45,0:04:30,2,720
20160707-ccc_waste_recycling_script,2016/07/07,ccc_waste_recycling_script,0,0,0:00:00,0,0:00:00,0,0
20160708-ccc_311_calgary_script,2016/07/08,ccc_311_calgary_script,3129,3000,0:00:33,33,0:06:52,129,99000
20160708-ccc_311_lobby_ph_script,2016/07/08,ccc_311_lobby_ph_script,2,2,0:00:15,15,0:00:25,0,30
20160708-ccc_aserv_info_script,2016/07/08,ccc_aserv_info_script,0,0,0:00:00,0,0:00:00,0,0
20160708-ccc_bylaw_script,2016/07/08,ccc_bylaw_script,0,0,0:00:00,0,0:00:00,0,0
20160708-ccc_city_script,2016/07/08,ccc_city_script,22,22,0:00:13,13,0:01:31,0,286
20160708-ccc_cty_online_script,2016/07/08,ccc_cty_online_script,0,0,0:00:00,0,0:00:00,0,0
20160708-ccc_feedback_script,2016/07/08,ccc_feedback_script,0,0,0:00:00,0,0:00:00,0,0
20160708-ccc_fpb_script,2016/07/08,ccc_fpb_script,2,1,0:00:12,12,0:00:12,1,12
20160708-ccc_help_script,2016/07/08,ccc_help_script,35,34,0:00:06,6,0:00:19,1,204
20160708-ccc_link_script,2016/07/08,ccc_link_script,0,0,0:00:00,0,0:00:00,0,0
20160708-ccc_media_line_script,2016/07/08,ccc_media_line_script,2,2,0:00:42,42,0:01:18,0,84
20160708-ccc_priority_script,2016/07/08,ccc_priority_script,37,35,0:00:08,8,0:00:30,2,280
20160708-ccc_tax_script,2016/07/08,ccc_tax_script,11,11,0:00:31,31,0:02:10,0,341
20160708-ccc_waste_recycling_script,2016/07/08,ccc_waste_recycling_script,0,0,0:00:00,0,0:00:00,0,0
20160709-ccc_311_calgary_script,2016/07/09,ccc_311_calgary_script,1725,1397,0:01:48,108,0:10:12,328,150876
20160709-ccc_311_lobby_ph_script,2016/07/09,ccc_311_lobby_ph_script,0,0,0:00:00,0,0:00:00,0,0
20160709-ccc_aserv_info_script,2016/07/09,ccc_aserv_info_script,0,0,0:00:00,0,0:00:00,0,0
20160709-ccc_bylaw_script,2016/07/09,ccc_bylaw_script,0,0,0:00:00,0,0:00:00,0,0
20160709-ccc_city_script,2016/07/09,ccc_city_script,0,0,0:00:00,0,0:00:00,0,0
20160709-ccc_cty_online_script,2016/07/09,ccc_cty_online_script,0,0,0:00:00,0,0:00:00,0,0
20160709-ccc_feedback_script,2016/07/09,ccc_feedback_script,0,0,0:00:00,0,0:00:00,0,0
20160709-ccc_fpb_script,2016/07/09,ccc_fpb_script,0,0,0:00:00,0,0:00:00,0,0
20160709-ccc_help_script,2016/07/09,ccc_help_script,9,8,0:00:20,20,0:01:37,1,160
20160709-ccc_link_script,2016/07/09,ccc_link_script,0,0,0:00:00,0,0:00:00,0,0
20160709-ccc_media_line_script,2016/07/09,ccc_media_line_script,4,4,0:00:48,48,0:02:01,0,192
20160709-ccc_priority_script,2016/07/09,ccc_priority_script,51,48,0:00:23,23,0:02:16,3,1104
20160709-ccc_tax_script,2016/07/09,ccc_tax_script,0,0,0:00:00,0,0:00:00,0,0
20160709-ccc_waste_recycling_script,2016/07/09,ccc_waste_recycling_script,0,0,0:00:00,0,0:00:00,0,0
20160710-ccc_311_calgary_script,2016/07/10,ccc_311_calgary_script,1131,1081,0:00:27,27,0:10:02,50,29187
20160710-ccc_311_lobby_ph_script,2016/07/10,ccc_311_lobby_ph_script,0,0,0:00:00,0,0:00:00,0,0
20160710-ccc_aserv_info_script,2016/07/10,ccc_aserv_info_script,0,0,0:00:00,0,0:00:00,0,0
20160710-ccc_bylaw_script,2016/07/10,ccc_bylaw_script,0,0,0:00:00,0,0:00:00,0,0
20160710-ccc_city_script,2016/07/10,ccc_city_script,0,0,0:00:00,0,0:00:00,0,0
20160710-ccc_cty_online_script,2016/07/10,ccc_cty_online_script,0,0,0:00:00,0,0:00:00,0,0
20160710-ccc_feedback_script,2016/07/10,ccc_feedback_script,0,0,0:00:00,0,0:00:00,0,0
20160710-ccc_fpb_script,2016/07/10,ccc_fpb_script,0,0,0:00:00,0,0:00:00,0,0
20160710-ccc_help_script,2016/07/10,ccc_help_script,9,9,0:00:21,21,0:01:18,0,189
20160710-ccc_link_script,2016/07/10,ccc_link_script,0,0,0:00:00,0,0:00:00,0,0
20160710-ccc_media_line_script,2016/07/10,ccc_media_line_script,2,2,0:00:19,19,0:00:25,0,38
20160710-ccc_priority_script,2016/07/10,ccc_priority_script,27,24,0:00:16,16,0:01:04,3,384
20160710-ccc_tax_script,2016/07/10,ccc_tax_script,0,0,0:00:00,0,0:00:00,0,0
20160710-ccc_waste_recycling_script,2016/07/10,ccc_waste_recycling_script,0,0,0:00:00,0,0:00:00,0,0
20160711-ccc_311_calgary_script,2016/07/11,ccc_311_calgary_script,3935,3540,0:01:18,78,0:07:25,395,276120
20160711-ccc_media_line_script,2016/07/11,ccc_media_line_script,4,4,0:00:11,11,0:00:24,0,44
20160711-ccc_priority_script,2016/07/11,ccc_priority_script,36,31,0:00:13,13,0:00:55,5,403
20160711-ccc_tax_script,2016/07/11,ccc_tax_script,15,12,0:01:40,100,0:04:18,3,1200
20160711-ccc_waste_recycling_script,2016/07/11,ccc_waste_recycling_script,0,0,0:00:00,0,0:00:00,0,0
20160712-ccc_311_calgary_script,2016/07/12,ccc_311_calgary_script,3700,2990,0:02:32,152,0:09:09,710,454480
20160712-ccc_311_lobby_ph_script,2016/07/12,ccc_311_lobby_ph_script,6,4,0:00:06,6,0:00:09,2,24
20160712-ccc_aserv_info_script,2016/07/12,ccc_aserv_info_script,0,0,0:00:00,0,0:00:00,0,0
20160712-ccc_bylaw_script,2016/07/12,ccc_bylaw_script,0,0,0:00:00,0,0:00:00,0,0
20160712-ccc_city_script,2016/07/12,ccc_city_script,12,11,0:00:47,47,0:03:48,1,517
20160712-ccc_cty_online_script,2016/07/12,ccc_cty_online_script,0,0,0:00:00,0,0:00:00,0,0
20160712-ccc_feedback_script,2016/07/12,ccc_feedback_script,0,0,0:00:00,0,0:00:00,0,0
20160712-ccc_fpb_script,2016/07/12,ccc_fpb_script,0,0,0:00:00,0,0:00:00,0,0
20160712-ccc_help_script,2016/07/12,ccc_help_script,15,13,0:00:12,12,0:00:38,2,156
20160712-ccc_link_script,2016/07/12,ccc_link_script,0,0,0:00:00,0,0:00:00,0,0
20160712-ccc_media_line_script,2016/07/12,ccc_media_line_script,3,1,0:00:12,12,0:00:12,2,12
20160712-ccc_priority_script,2016/07/12,ccc_priority_script,53,52,0:00:14,14,0:00:51,1,728
20160712-ccc_tax_script,2016/07/12,ccc_tax_script,23,21,0:02:46,166,0:06:26,2,3486
20160712-ccc_waste_recycling_script,2016/07/12,ccc_waste_recycling_script,0,0,0:00:00,0,0:00:00,0,0
20160713-ccc_cty_online_script,2016/07/13,ccc_cty_online_script,0,0,0:00:00,0,0:00:00,0,0
20160713-ccc_feedback_script,2016/07/13,ccc_feedback_script,0,0,0:00:00,0,0:00:00,0,0
20160713-ccc_fpb_script,2016/07/13,ccc_fpb_script,0,0,0:00:00,0,0:00:00,0,0
20160713-ccc_help_script,2016/07/13,ccc_help_script,16,16,0:00:13,13,0:00:54,0,208
20160713-ccc_link_script,2016/07/13,ccc_link_script,0,0,0:00:00,0,0:00:00,0,0
20160713-ccc_media_line_script,2016/07/13,ccc_media_line_script,0,0,0:00:00,0,0:00:00,0,0
20160713-ccc_priority_script,2016/07/13,ccc_priority_script,38,38,0:00:16,16,0:01:24,0,608
20160713-ccc_tax_script,2016/07/13,ccc_tax_script,15,13,0:01:01,61,0:03:52,2,793
20160713-ccc_waste_recycling_script,2016/07/13,ccc_waste_recycling_script,0,0,0:00:00,0,0:00:00,0,0
20160714-ccc_311_calgary_script,2016/07/14,ccc_311_calgary_script,3118,3027,0:00:23,23,0:05:36,91,69621
20160714-ccc_311_lobby_ph_script,2016/07/14,ccc_311_lobby_ph_script,3,1,0:00:04,4,0:00:04,2,4
20160714-ccc_aserv_info_script,2016/07/14,ccc_aserv_info_script,0,0,0:00:00,0,0:00:00,0,0
20160714-ccc_bylaw_script,2016/07/14,ccc_bylaw_script,0,0,0:00:00,0,0:00:00,0,0
20160714-ccc_city_script,2016/07/14,ccc_city_script,16,16,0:00:09,9,0:00:32,0,144
20160714-ccc_cty_online_script,2016/07/14,ccc_cty_online_script,0,0,0:00:00,0,0:00:00,0,0
20160714-ccc_feedback_script,2016/07/14,ccc_feedback_script,0,0,0:00:00,0,0:00:00,0,0
20160714-ccc_fpb_script,2016/07/14,ccc_fpb_script,1,1,0:00:53,53,0:00:53,0,53
20160714-ccc_help_script,2016/07/14,ccc_help_script,21,21,0:00:06,6,0:00:22,0,126
20160714-ccc_link_script,2016/07/14,ccc_link_script,1,0,0:00:00,0,0:00:00,1,0
20160714-ccc_media_line_script,2016/07/14,ccc_media_line_script,4,4,0:00:08,8,0:00:12,0,32
20160714-ccc_priority_script,2016/07/14,ccc_priority_script,35,35,0:00:11,11,0:01:06,0,385
20160714-ccc_tax_script,2016/07/14,ccc_tax_script,18,18,0:00:15,15,0:01:29,0,270
20160714-ccc_waste_recycling_script,2016/07/14,ccc_waste_recycling_script,0,0,0:00:00,0,0:00:00,0,0
20160715-ccc_311_calgary_script,2016/07/15,ccc_311_calgary_script,2965,2642,0:01:14,74,0:08:40,315,195508
20160715-ccc_311_lobby_ph_script,2016/07/15,ccc_311_lobby_ph_script,0,0,0:00:00,0,0:00:00,0,0
20160715-ccc_aserv_info_script,2016/07/15,ccc_aserv_info_script,0,0,0:00:00,0,0:00:00,0,0
20160715-ccc_bylaw_script,2016/07/15,ccc_bylaw_script,0,0,0:00:00,0,0:00:00,0,0
20160715-ccc_city_script,2016/07/15,ccc_city_script,21,21,0:00:24,24,0:02:57,0,504
20160715-ccc_cty_online_script,2016/07/15,ccc_cty_online_script,0,0,0:00:00,0,0:00:00,0,0
20160715-ccc_feedback_script,2016/07/15,ccc_feedback_script,0,0,0:00:00,0,0:00:00,0,0
20160715-ccc_fpb_script,2016/07/15,ccc_fpb_script,1,0,0:00:00,0,0:00:00,1,0
20160715-ccc_help_script,2016/07/15,ccc_help_script,22,22,0:00:09,9,0:00:40,0,198
20160715-ccc_link_script,2016/07/15,ccc_link_script,0,0,0:00:00,0,0:00:00,0,0
20160715-ccc_media_line_script,2016/07/15,ccc_media_line_script,0,0,0:00:00,0,0:00:00,0,0
20160715-ccc_priority_script,2016/07/15,ccc_priority_script,48,47,0:00:10,10,0:01:43,1,470
20160715-ccc_tax_script,2016/07/15,ccc_tax_script,23,21,0:00:54,54,0:05:12,2,1134
20160715-ccc_waste_recycling_script,2016/07/15,ccc_waste_recycling_script,0,0,0:00:00,0,0:00:00,0,0
20160716-ccc_311_calgary_script,2016/07/16,ccc_311_calgary_script,1148,1123,0:00:13,13,0:05:39,25,14599
20160716-ccc_311_lobby_ph_script,2016/07/16,ccc_311_lobby_ph_script,0,0,0:00:00,0,0:00:00,0,0
20160716-ccc_aserv_info_script,2016/07/16,ccc_aserv_info_script,0,0,0:00:00,0,0:00:00,0,0
20160716-ccc_bylaw_script,2016/07/16,ccc_bylaw_script,0,0,0:00:00,0,0:00:00,0,0
20160716-ccc_city_script,2016/07/16,ccc_city_script,0,0,0:00:00,0,0:00:00,0,0
20160716-ccc_cty_online_script,2016/07/16,ccc_cty_online_script,0,0,0:00:00,0,0:00:00,0,0
20160716-ccc_feedback_script,2016/07/16,ccc_feedback_script,0,0,0:00:00,0,0:00:00,0,0
20160716-ccc_fpb_script,2016/07/16,ccc_fpb_script,0,0,0:00:00,0,0:00:00,0,0
20160716-ccc_help_script,2016/07/16,ccc_help_script,9,9,0:00:12,12,0:01:04,0,108
20160716-ccc_link_script,2016/07/16,ccc_link_script,0,0,0:00:00,0,0:00:00,0,0
20160716-ccc_media_line_script,2016/07/16,ccc_media_line_script,0,0,0:00:00,0,0:00:00,0,0
20160716-ccc_priority_script,2016/07/16,ccc_priority_script,28,28,0:00:18,18,0:02:02,0,504
20160716-ccc_tax_script,2016/07/16,ccc_tax_script,0,0,0:00:00,0,0:00:00,0,0
20160716-ccc_waste_recycling_script,2016/07/16,ccc_waste_recycling_script,0,0,0:00:00,0,0:00:00,0,0
20160717-ccc_311_calgary_script,2016/07/17,ccc_311_calgary_script,991,961,0:00:14,14,0:04:47,30,13454
20160717-ccc_311_lobby_ph_script,2016/07/17,ccc_311_lobby_ph_script,0,0,0:00:00,0,0:00:00,0,0
20160717-ccc_aserv_info_script,2016/07/17,ccc_aserv_info_script,0,0,0:00:00,0,0:00:00,0,0
20160717-ccc_bylaw_script,2016/07/17,ccc_bylaw_script,0,0,0:00:00,0,0:00:00,0,0
20160717-ccc_city_script,2016/07/17,ccc_city_script,0,0,0:00:00,0,0:00:00,0,0
20160717-ccc_cty_online_script,2016/07/17,ccc_cty_online_script,0,0,0:00:00,0,0:00:00,0,0
20160717-ccc_feedback_script,2016/07/17,ccc_feedback_script,0,0,0:00:00,0,0:00:00,0,0
20160717-ccc_fpb_script,2016/07/17,ccc_fpb_script,0,0,0:00:00,0,0:00:00,0,0
20160717-ccc_help_script,2016/07/17,ccc_help_script,11,11,0:00:13,13,0:00:23,0,143
20160717-ccc_link_script,2016/07/17,ccc_link_script,0,0,0:00:00,0,0:00:00,0,0
20160717-ccc_media_line_script,2016/07/17,ccc_media_line_script,4,4,0:00:04,4,0:00:07,0,16
20160717-ccc_priority_script,2016/07/17,ccc_priority_script,31,28,0:00:13,13,0:02:12,3,364
20160717-ccc_tax_script,2016/07/17,ccc_tax_script,0,0,0:00:00,0,0:00:00,0,0
20160717-ccc_waste_recycling_script,2016/07/17,ccc_waste_recycling_script,0,0,0:00:00,0,0:00:00,0,0
20160718-ccc_311_calgary_script,2016/07/18,ccc_311_calgary_script,3427,3205,0:00:46,46,0:28:49,222,147430
20160718-ccc_311_lobby_ph_script,2016/07/18,ccc_311_lobby_ph_script,0,0,0:00:00,0,0:00:00,0,0
20160718-ccc_aserv_info_script,2016/07/18,ccc_aserv_info_script,0,0,0:00:00,0,0:00:00,0,0
20160718-ccc_bylaw_script,2016/07/18,ccc_bylaw_script,0,0,0:00:00,0,0:00:00,0,0
20160718-ccc_city_script,2016/07/18,ccc_city_script,48,47,0:00:21,21,0:03:19,1,987
20160718-ccc_cty_online_script,2016/07/18,ccc_cty_online_script,0,0,0:00:00,0,0:00:00,0,0
20160718-ccc_feedback_script,2016/07/18,ccc_feedback_script,0,0,0:00:00,0,0:00:00,0,0
20160718-ccc_fpb_script,2016/07/18,ccc_fpb_script,1,0,0:00:00,0,0:00:00,1,0
20160718-ccc_help_script,2016/07/18,ccc_help_script,17,16,0:00:09,9,0:00:43,1,144
20160718-ccc_link_script,2016/07/18,ccc_link_script,0,0,0:00:00,0,0:00:00,0,0
20160718-ccc_media_line_script,2016/07/18,ccc_media_line_script,0,0,0:00:00,0,0:00:00,0,0
20160718-ccc_priority_script,2016/07/18,ccc_priority_script,30,28,0:00:14,14,0:02:21,2,392
20160718-ccc_tax_script,2016/07/18,ccc_tax_script,27,24,0:01:07,67,0:03:35,3,1608
20160718-ccc_waste_recycling_script,2016/07/18,ccc_waste_recycling_script,0,0,0:00:00,0,0:00:00,0,0
20160719-ccc_311_calgary_script,2016/07/19,ccc_311_calgary_script,3380,3076,0:01:15,75,0:24:54,303,230700
20160719-ccc_311_lobby_ph_script,2016/07/19,ccc_311_lobby_ph_script,2,2,0:00:09,9,0:00:10,0,18
20160719-ccc_aserv_info_script,2016/07/19,ccc_aserv_info_script,0,0,0:00:00,0,0:00:00,0,0
20160719-ccc_bylaw_script,2016/07/19,ccc_bylaw_script,0,0,0:00:00,0,0:00:00,0,0
20160719-ccc_city_script,2016/07/19,ccc_city_script,35,33,0:00:32,32,0:03:23,2,1056
20160719-ccc_cty_online_script,2016/07/19,ccc_cty_online_script,0,0,0:00:00,0,0:00:00,0,0
20160719-ccc_feedback_script,2016/07/19,ccc_feedback_script,0,0,0:00:00,0,0:00:00,0,0
20160719-ccc_fpb_script,2016/07/19,ccc_fpb_script,1,1,0:00:08,8,0:00:08,0,8
20160719-ccc_help_script,2016/07/19,ccc_help_script,20,20,0:00:10,10,0:00:33,0,200
20160719-ccc_link_script,2016/07/19,ccc_link_script,0,0,0:00:00,0,0:00:00,0,0
20160719-ccc_media_line_script,2016/07/19,ccc_media_line_script,1,1,0:00:05,5,0:00:05,0,5
20160719-ccc_priority_script,2016/07/19,ccc_priority_script,49,46,0:00:22,22,0:03:02,3,1012
20160719-ccc_tax_script,2016/07/19,ccc_tax_script,13,11,0:01:14,74,0:05:10,2,814
20160719-ccc_waste_recycling_script,2016/07/19,ccc_waste_recycling_script,0,0,0:00:00,0,0:00:00,0,0
20160720-ccc_311_calgary_script,2016/07/20,ccc_311_calgary_script,3796,3104,0:02:55,175,0:30:32,692,543200
20160720-ccc_311_lobby_ph_script,2016/07/20,ccc_311_lobby_ph_script,3,3,0:00:07,7,0:00:13,0,21
20160720-ccc_aserv_info_script,2016/07/20,ccc_aserv_info_script,0,0,0:00:00,0,0:00:00,0,0
20160720-ccc_bylaw_script,2016/07/20,ccc_bylaw_script,0,0,0:00:00,0,0:00:00,0,0
20160720-ccc_city_script,2016/07/20,ccc_city_script,25,22,0:01:56,116,0:07:47,3,2552
20160720-ccc_cty_online_script,2016/07/20,ccc_cty_online_script,0,0,0:00:00,0,0:00:00,0,0
20160720-ccc_feedback_script,2016/07/20,ccc_feedback_script,0,0,0:00:00,0,0:00:00,0,0
20160720-ccc_fpb_script,2016/07/20,ccc_fpb_script,2,1,0:06:03,363,0:06:03,1,363
20160720-ccc_help_script,2016/07/20,ccc_help_script,40,34,0:00:09,9,0:00:33,6,306
20160720-ccc_link_script,2016/07/20,ccc_link_script,0,0,0:00:00,0,0:00:00,0,0
20160720-ccc_media_line_script,2016/07/20,ccc_media_line_script,0,0,0:00:00,0,0:00:00,0,0
20160720-ccc_priority_script,2016/07/20,ccc_priority_script,45,42,0:00:28,28,0:02:43,3,1176
20160720-ccc_tax_script,2016/07/20,ccc_tax_script,25,22,0:03:54,234,0:17:54,3,5148
20160720-ccc_waste_recycling_script,2016/07/20,ccc_waste_recycling_script,0,0,0:00:00,0,0:00:00,0,0
20160721-ccc_311_calgary_script,2016/07/21,ccc_311_calgary_script,3893,3330,0:02:07,127,0:24:13,564,422910
20160721-ccc_311_lobby_ph_script,2016/07/21,ccc_311_lobby_ph_script,3,3,0:00:22,22,0:00:42,0,66
20160721-ccc_aserv_info_script,2016/07/21,ccc_aserv_info_script,0,0,0:00:00,0,0:00:00,0,0
20160721-ccc_bylaw_script,2016/07/21,ccc_bylaw_script,0,0,0:00:00,0,0:00:00,0,0
20160721-ccc_city_script,2016/07/21,ccc_city_script,24,21,0:01:10,70,0:06:40,3,1470
20160721-ccc_cty_online_script,2016/07/21,ccc_cty_online_script,0,0,0:00:00,0,0:00:00,0,0
20160721-ccc_feedback_script,2016/07/21,ccc_feedback_script,0,0,0:00:00,0,0:00:00,0,0
20160721-ccc_fpb_script,2016/07/21,ccc_fpb_script,0,0,0:00:00,0,0:00:00,0,0
20160721-ccc_help_script,2016/07/21,ccc_help_script,39,36,0:00:09,9,0:00:40,3,324
20160721-ccc_link_script,2016/07/21,ccc_link_script,0,0,0:00:00,0,0:00:00,0,0
20160721-ccc_media_line_script,2016/07/21,ccc_media_line_script,0,0,0:00:00,0,0:00:00,0,0
20160721-ccc_priority_script,2016/07/21,ccc_priority_script,28,25,0:00:17,17,0:01:09,3,425
20160721-ccc_tax_script,2016/07/21,ccc_tax_script,16,13,0:03:23,203,0:09:11,3,2639
20160721-ccc_waste_recycling_script,2016/07/21,ccc_waste_recycling_script,0,0,0:00:00,0,0:00:00,0,0
20160722-ccc_311_calgary_script,2016/07/22,ccc_311_calgary_script,3406,3068,0:01:31,91,0:09:04,338,279188
20160722-ccc_311_lobby_ph_script,2016/07/22,ccc_311_lobby_ph_script,4,4,0:00:05,5,0:00:08,0,20
20160722-ccc_aserv_info_script,2016/07/22,ccc_aserv_info_script,0,0,0:00:00,0,0:00:00,0,0
20160722-ccc_bylaw_script,2016/07/22,ccc_bylaw_script,0,0,0:00:00,0,0:00:00,0,0
20160722-ccc_city_script,2016/07/22,ccc_city_script,24,22,0:00:31,31,0:02:23,2,682
20160722-ccc_cty_online_script,2016/07/22,ccc_cty_online_script,0,0,0:00:00,0,0:00:00,0,0
20160722-ccc_feedback_script,2016/07/22,ccc_feedback_script,0,0,0:00:00,0,0:00:00,0,0
20160722-ccc_fpb_script,2016/07/22,ccc_fpb_script,0,0,0:00:00,0,0:00:00,0,0
20160722-ccc_help_script,2016/07/22,ccc_help_script,19,18,0:00:10,10,0:00:28,1,180
20160722-ccc_link_script,2016/07/22,ccc_link_script,0,0,0:00:00,0,0:00:00,0,0
20160722-ccc_media_line_script,2016/07/22,ccc_media_line_script,3,3,0:00:31,31,0:01:17,0,93
20160722-ccc_priority_script,2016/07/22,ccc_priority_script,37,37,0:00:08,8,0:00:20,0,296
20160722-ccc_tax_script,2016/07/22,ccc_tax_script,12,11,0:01:25,85,0:05:26,1,935
20160722-ccc_waste_recycling_script,2016/07/22,ccc_waste_recycling_script,0,0,0:00:00,0,0:00:00,0,0
20160723-ccc_311_calgary_script,2016/07/23,ccc_311_calgary_script,1333,1282,0:00:28,28,0:06:25,51,35896
20160723-ccc_311_lobby_ph_script,2016/07/23,ccc_311_lobby_ph_script,0,0,0:00:00,0,0:00:00,0,0
20160723-ccc_aserv_info_script,2016/07/23,ccc_aserv_info_script,0,0,0:00:00,0,0:00:00,0,0
20160723-ccc_bylaw_script,2016/07/23,ccc_bylaw_script,0,0,0:00:00,0,0:00:00,0,0
20160723-ccc_city_script,2016/07/23,ccc_city_script,0,0,0:00:00,0,0:00:00,0,0
20160723-ccc_cty_online_script,2016/07/23,ccc_cty_online_script,0,0,0:00:00,0,0:00:00,0,0
20160723-ccc_feedback_script,2016/07/23,ccc_feedback_script,0,0,0:00:00,0,0:00:00,0,0
20160723-ccc_fpb_script,2016/07/23,ccc_fpb_script,0,0,0:00:00,0,0:00:00,0,0
20160723-ccc_help_script,2016/07/23,ccc_help_script,8,8,0:00:15,15,0:01:12,0,120
20160723-ccc_link_script,2016/07/23,ccc_link_script,0,0,0:00:00,0,0:00:00,0,0
20160723-ccc_media_line_script,2016/07/23,ccc_media_line_script,1,1,0:00:04,4,0:00:04,0,4
20160723-ccc_priority_script,2016/07/23,ccc_priority_script,23,23,0:00:06,6,0:00:25,0,138
20160723-ccc_tax_script,2016/07/23,ccc_tax_script,1,1,0:00:04,4,0:00:04,0,4
20160723-ccc_waste_recycling_script,2016/07/23,ccc_waste_recycling_script,0,0,0:00:00,0,0:00:00,0,0
20160724-ccc_311_calgary_script,2016/07/24,ccc_311_calgary_script,1196,1141,0:00:24,24,0:09:43,55,27384
20160724-ccc_311_lobby_ph_script,2016/07/24,ccc_311_lobby_ph_script,0,0,0:00:00,0,0:00:00,0,0
20160724-ccc_aserv_info_script,2016/07/24,ccc_aserv_info_script,0,0,0:00:00,0,0:00:00,0,0
20160724-ccc_bylaw_script,2016/07/24,ccc_bylaw_script,0,0,0:00:00,0,0:00:00,0,0
20160724-ccc_city_script,2016/07/24,ccc_city_script,0,0,0:00:00,0,0:00:00,0,0
20160724-ccc_cty_online_script,2016/07/24,ccc_cty_online_script,0,0,0:00:00,0,0:00:00,0,0
20160724-ccc_feedback_script,2016/07/24,ccc_feedback_script,0,0,0:00:00,0,0:00:00,0,0
20160724-ccc_fpb_script,2016/07/24,ccc_fpb_script,0,0,0:00:00,0,0:00:00,0,0
20160724-ccc_help_script,2016/07/24,ccc_help_script,8,8,0:00:05,5,0:00:12,0,40
20160724-ccc_link_script,2016/07/24,ccc_link_script,0,0,0:00:00,0,0:00:00,0,0
20160724-ccc_media_line_script,2016/07/24,ccc_media_line_script,0,0,0:00:00,0,0:00:00,0,0
20160724-ccc_priority_script,2016/07/24,ccc_priority_script,32,31,0:00:06,6,0:00:27,1,186
20160724-ccc_tax_script,2016/07/24,ccc_tax_script,2,2,0:00:48,48,0:01:20,0,96
20160724-ccc_waste_recycling_script,2016/07/24,ccc_waste_recycling_script,0,0,0:00:00,0,0:00:00,0,0
20160725-ccc_311_calgary_script,2016/07/25,ccc_311_calgary_script,3942,3539,0:01:37,97,0:14:30,403,343283
20160725-ccc_311_lobby_ph_script,2016/07/25,ccc_311_lobby_ph_script,3,3,0:00:20,20,0:00:24,0,60
20160725-ccc_aserv_info_script,2016/07/25,ccc_aserv_info_script,0,0,0:00:00,0,0:00:00,0,0
20160725-ccc_bylaw_script,2016/07/25,ccc_bylaw_script,0,0,0:00:00,0,0:00:00,0,0
20160725-ccc_city_script,2016/07/25,ccc_city_script,24,21,0:00:19,19,0:01:57,3,399
20160725-ccc_cty_online_script,2016/07/25,ccc_cty_online_script,0,0,0:00:00,0,0:00:00,0,0
20160725-ccc_feedback_script,2016/07/25,ccc_feedback_script,0,0,0:00:00,0,0:00:00,0,0
20160725-ccc_fpb_script,2016/07/25,ccc_fpb_script,1,1,0:00:09,9,0:00:09,0,9
20160725-ccc_help_script,2016/07/25,ccc_help_script,21,21,0:00:06,6,0:00:34,0,126
20160725-ccc_link_script,2016/07/25,ccc_link_script,0,0,0:00:00,0,0:00:00,0,0
20160725-ccc_media_line_script,2016/07/25,ccc_media_line_script,2,2,0:00:17,17,0:00:30,0,34
20160725-ccc_priority_script,2016/07/25,ccc_priority_script,48,47,0:00:07,7,0:00:38,1,329
20160725-ccc_tax_script,2016/07/25,ccc_tax_script,27,23,0:01:36,96,0:04:57,4,2208
20160725-ccc_waste_recycling_script,2016/07/25,ccc_waste_recycling_script,0,0,0:00:00,0,0:00:00,0,0
20160726-ccc_311_calgary_script,2016/07/26,ccc_311_calgary_script,3893,3429,0:01:46,106,0:11:24,464,363474
20160726-ccc_311_lobby_ph_script,2016/07/26,ccc_311_lobby_ph_script,3,2,0:00:10,10,0:00:15,1,20
20160726-ccc_aserv_info_script,2016/07/26,ccc_aserv_info_script,0,0,0:00:00,0,0:00:00,0,0
20160726-ccc_bylaw_script,2016/07/26,ccc_bylaw_script,0,0,0:00:00,0,0:00:00,0,0
20160726-ccc_city_script,2016/07/26,ccc_city_script,29,27,0:00:28,28,0:04:40,2,756
20160726-ccc_cty_online_script,2016/07/26,ccc_cty_online_script,0,0,0:00:00,0,0:00:00,0,0
20160726-ccc_feedback_script,2016/07/26,ccc_feedback_script,0,0,0:00:00,0,0:00:00,0,0
20160726-ccc_fpb_script,2016/07/26,ccc_fpb_script,0,0,0:00:00,0,0:00:00,0,0
20160726-ccc_help_script,2016/07/26,ccc_help_script,25,25,0:00:11,11,0:00:45,0,275
20160726-ccc_link_script,2016/07/26,ccc_link_script,0,0,0:00:00,0,0:00:00,0,0
20160726-ccc_media_line_script,2016/07/26,ccc_media_line_script,5,4,0:00:10,10,0:00:18,1,40
20160726-ccc_priority_script,2016/07/26,ccc_priority_script,32,32,0:00:11,11,0:00:38,0,352
20160726-ccc_tax_script,2016/07/26,ccc_tax_script,17,15,0:01:39,99,0:08:59,2,1485
20160726-ccc_waste_recycling_script,2016/07/26,ccc_waste_recycling_script,0,0,0:00:00,0,0:00:00,0,0
20160727-ccc_311_calgary_script,2016/07/27,ccc_311_calgary_script,3530,3040,0:01:59,119,0:09:16,490,361760
20160727-ccc_311_lobby_ph_script,2016/07/27,ccc_311_lobby_ph_script,5,5,0:00:29,29,0:00:52,0,145
20160727-ccc_aserv_info_script,2016/07/27,ccc_aserv_info_script,0,0,0:00:00,0,0:00:00,0,0
20160727-ccc_bylaw_script,2016/07/27,ccc_bylaw_script,0,0,0:00:00,0,0:00:00,0,0
20160727-ccc_city_script,2016/07/27,ccc_city_script,21,21,0:00:32,32,0:03:31,0,672
20160727-ccc_cty_online_script,2016/07/27,ccc_cty_online_script,0,0,0:00:00,0,0:00:00,0,0
20160727-ccc_feedback_script,2016/07/27,ccc_feedback_script,0,0,0:00:00,0,0:00:00,0,0
20160727-ccc_fpb_script,2016/07/27,ccc_fpb_script,1,0,0:00:00,0,0:00:00,1,0
20160727-ccc_help_script,2016/07/27,ccc_help_script,19,17,0:00:16,16,0:01:01,2,272
20160727-ccc_link_script,2016/07/27,ccc_link_script,0,0,0:00:00,0,0:00:00,0,0
20160727-ccc_media_line_script,2016/07/27,ccc_media_line_script,0,0,0:00:00,0,0:00:00,0,0
20160727-ccc_priority_script,2016/07/27,ccc_priority_script,38,38,0:00:11,11,0:01:28,0,418
20160727-ccc_tax_script,2016/07/27,ccc_tax_script,18,18,0:01:52,112,0:05:00,0,2016
20160727-ccc_waste_recycling_script,2016/07/27,ccc_waste_recycling_script,0,0,0:00:00,0,0:00:00,0,0
20160728-ccc_311_calgary_script,2016/07/28,ccc_311_calgary_script,3650,3218,0:01:54,114,0:11:54,432,366852
20160728-ccc_311_lobby_ph_script,2016/07/28,ccc_311_lobby_ph_script,3,3,0:00:14,14,0:00:20,0,42
20160728-ccc_aserv_info_script,2016/07/28,ccc_aserv_info_script,0,0,0:00:00,0,0:00:00,0,0
20160728-ccc_bylaw_script,2016/07/28,ccc_bylaw_script,0,0,0:00:00,0,0:00:00,0,0
20160728-ccc_city_script,2016/07/28,ccc_city_script,23,23,0:00:30,30,0:06:33,0,690
20160728-ccc_cty_online_script,2016/07/28,ccc_cty_online_script,0,0,0:00:00,0,0:00:00,0,0
20160728-ccc_feedback_script,2016/07/28,ccc_feedback_script,0,0,0:00:00,0,0:00:00,0,0
20160728-ccc_fpb_script,2016/07/28,ccc_fpb_script,1,0,0:00:00,0,0:00:00,1,0
20160728-ccc_help_script,2016/07/28,ccc_help_script,15,14,0:00:12,12,0:00:38,1,168
20160728-ccc_link_script,2016/07/28,ccc_link_script,0,0,0:00:00,0,0:00:00,0,0
20160728-ccc_media_line_script,2016/07/28,ccc_media_line_script,2,2,0:00:06,6,0:00:10,0,12
20160728-ccc_priority_script,2016/07/28,ccc_priority_script,46,45,0:00:10,10,0:00:44,1,450
20160728-ccc_tax_script,2016/07/28,ccc_tax_script,18,15,0:01:25,85,0:11:17,3,1275
20160728-ccc_waste_recycling_script,2016/07/28,ccc_waste_recycling_script,0,0,0:00:00,0,0:00:00,0,0
20160729-ccc_311_calgary_script,2016/07/29,ccc_311_calgary_script,3174,2977,0:00:52,52,0:05:49,192,154804
20160729-ccc_311_lobby_ph_script,2016/07/29,ccc_311_lobby_ph_script,2,2,0:00:04,4,0:00:05,0,8
20160729-ccc_aserv_info_script,2016/07/29,ccc_aserv_info_script,0,0,0:00:00,0,0:00:00,0,0
20160729-ccc_bylaw_script,2016/07/29,ccc_bylaw_script,0,0,0:00:00,0,0:00:00,0,0
20160729-ccc_city_script,2016/07/29,ccc_city_script,21,20,0:00:11,11,0:00:44,1,220
20160729-ccc_cty_online_script,2016/07/29,ccc_cty_online_script,0,0,0:00:00,0,0:00:00,0,0
20160729-ccc_feedback_script,2016/07/29,ccc_feedback_script,0,0,0:00:00,0,0:00:00,0,0
20160729-ccc_fpb_script,2016/07/29,ccc_fpb_script,0,0,0:00:00,0,0:00:00,0,0
20160729-ccc_help_script,2016/07/29,ccc_help_script,16,16,0:00:08,8,0:00:34,0,128
20160729-ccc_link_script,2016/07/29,ccc_link_script,0,0,0:00:00,0,0:00:00,0,0
20160729-ccc_media_line_script,2016/07/29,ccc_media_line_script,2,2,0:00:34,34,0:01:00,0,68
20160729-ccc_priority_script,2016/07/29,ccc_priority_script,34,34,0:00:05,5,0:00:28,0,170
20160729-ccc_tax_script,2016/07/29,ccc_tax_script,18,16,0:01:51,111,0:05:25,2,1776
20160729-ccc_waste_recycling_script,2016/07/29,ccc_waste_recycling_script,0,0,0:00:00,0,0:00:00,0,0
20160730-ccc_311_calgary_script,2016/07/30,ccc_311_calgary_script,1384,1285,0:00:44,44,0:18:03,104,56540
20160730-ccc_311_lobby_ph_script,2016/07/30,ccc_311_lobby_ph_script,0,0,0:00:00,0,0:00:00,0,0
20160730-ccc_aserv_info_script,2016/07/30,ccc_aserv_info_script,0,0,0:00:00,0,0:00:00,0,0
20160730-ccc_bylaw_script,2016/07/30,ccc_bylaw_script,0,0,0:00:00,0,0:00:00,0,0
20160730-ccc_city_script,2016/07/30,ccc_city_script,0,0,0:00:00,0,0:00:00,0,0
20160730-ccc_cty_online_script,2016/07/30,ccc_cty_online_script,0,0,0:00:00,0,0:00:00,0,0
20160730-ccc_feedback_script,2016/07/30,ccc_feedback_script,0,0,0:00:00,0,0:00:00,0,0
20160730-ccc_fpb_script,2016/07/30,ccc_fpb_script,0,0,0:00:00,0,0:00:00,0,0
20160730-ccc_help_script,2016/07/30,ccc_help_script,12,11,0:00:07,7,0:00:25,1,77
20160730-ccc_link_script,2016/07/30,ccc_link_script,0,0,0:00:00,0,0:00:00,0,0
20160730-ccc_media_line_script,2016/07/30,ccc_media_line_script,1,1,0:00:13,13,0:00:13,0,13
20160730-ccc_priority_script,2016/07/30,ccc_priority_script,60,58,0:00:16,16,0:01:50,2,928
20160730-ccc_tax_script,2016/07/30,ccc_tax_script,1,1,0:00:06,6,0:00:06,0,6
20160730-ccc_waste_recycling_script,2016/07/30,ccc_waste_recycling_script,0,0,0:00:00,0,0:00:00,0,0
20160731-ccc_311_calgary_script,2016/07/31,ccc_311_calgary_script,1082,994,0:00:36,36,0:22:33,88,35784
20160731-ccc_311_lobby_ph_script,2016/07/31,ccc_311_lobby_ph_script,0,0,0:00:00,0,0:00:00,0,0
20160731-ccc_aserv_info_script,2016/07/31,ccc_aserv_info_script,0,0,0:00:00,0,0:00:00,0,0
20160731-ccc_bylaw_script,2016/07/31,ccc_bylaw_script,0,0,0:00:00,0,0:00:00,0,0
20160731-ccc_city_script,2016/07/31,ccc_city_script,0,0,0:00:00,0,0:00:00,0,0
20160731-ccc_cty_online_script,2016/07/31,ccc_cty_online_script,0,0,0:00:00,0,0:00:00,0,0
20160731-ccc_feedback_script,2016/07/31,ccc_feedback_script,0,0,0:00:00,0,0:00:00,0,0
20160731-ccc_fpb_script,2016/07/31,ccc_fpb_script,0,0,0:00:00,0,0:00:00,0,0
20160731-ccc_help_script,2016/07/31,ccc_help_script,11,10,0:00:09,9,0:00:17,1,90
20160731-ccc_link_script,2016/07/31,ccc_link_script,0,0,0:00:00,0,0:00:00,0,0
20160731-ccc_media_line_script,2016/07/31,ccc_media_line_script,1,0,0:00:00,0,0:00:00,1,0
20160731-ccc_priority_script,2016/07/31,ccc_priority_script,23,23,0:00:24,24,0:02:54,0,552
20160731-ccc_tax_script,2016/07/31,ccc_tax_script,0,0,0:00:00,0,0:00:00,0,0
20160731-ccc_waste_recycling_script,2016/07/31,ccc_waste_recycling_script,0,0,0:00:00,0,0:00:00,0,0
20160801-ccc_311_calgary_script,2016/08/01,ccc_311_calgary_script,1378,1350,0:00:14,14,0:12:17,28,18900
20160801-ccc_311_lobby_ph_script,2016/08/01,ccc_311_lobby_ph_script,0,0,0:00:00,0,0:00:00,0,0
20160801-ccc_aserv_info_script,2016/08/01,ccc_aserv_info_script,0,0,0:00:00,0,0:00:00,0,0
20160801-ccc_bylaw_script,2016/08/01,ccc_bylaw_script,0,0,0:00:00,0,0:00:00,0,0
20160801-ccc_city_script,2016/08/01,ccc_city_script,0,0,0:00:00,0,0:00:00,0,0
20160801-ccc_cty_online_script,2016/08/01,ccc_cty_online_script,0,0,0:00:00,0,0:00:00,0,0
20160801-ccc_feedback_script,2016/08/01,ccc_feedback_script,0,0,0:00:00,0,0:00:00,0,0
20160801-ccc_fpb_script,2016/08/01,ccc_fpb_script,0,0,0:00:00,0,0:00:00,0,0
20160801-ccc_help_script,2016/08/01,ccc_help_script,9,9,0:00:16,16,0:01:22,0,144
20160801-ccc_link_script,2016/08/01,ccc_link_script,0,0,0:00:00,0,0:00:00,0,0
20160801-ccc_media_line_script,2016/08/01,ccc_media_line_script,2,2,0:00:05,5,0:00:05,0,10
20160801-ccc_priority_script,2016/08/01,ccc_priority_script,19,18,0:00:25,25,0:05:10,1,450
20160801-ccc_tax_script,2016/08/01,ccc_tax_script,0,0,0:00:00,0,0:00:00,0,0
20160801-ccc_waste_recycling_script,2016/08/01,ccc_waste_recycling_script,0,0,0:00:00,0,0:00:00,0,0
20160802-ccc_311_calgary_script,2016/08/02,ccc_311_calgary_script,4016,3397,0:02:53,173,0:11:04,619,587681
20160802-ccc_311_lobby_ph_script,2016/08/02,ccc_311_lobby_ph_script,3,3,0:00:06,6,0:00:09,0,18
20160802-ccc_aserv_info_script,2016/08/02,ccc_aserv_info_script,0,0,0:00:00,0,0:00:00,0,0
20160802-ccc_bylaw_script,2016/08/02,ccc_bylaw_script,0,0,0:00:00,0,0:00:00,0,0
20160802-ccc_city_script,2016/08/02,ccc_city_script,28,27,0:00:42,42,0:04:19,1,1134
20160802-ccc_cty_online_script,2016/08/02,ccc_cty_online_script,0,0,0:00:00,0,0:00:00,0,0
20160802-ccc_feedback_script,2016/08/02,ccc_feedback_script,0,0,0:00:00,0,0:00:00,0,0
20160802-ccc_fpb_script,2016/08/02,ccc_fpb_script,0,0,0:00:00,0,0:00:00,0,0
20160802-ccc_help_script,2016/08/02,ccc_help_script,18,15,0:00:12,12,0:00:40,3,180
20160802-ccc_link_script,2016/08/02,ccc_link_script,0,0,0:00:00,0,0:00:00,0,0
20160802-ccc_media_line_script,2016/08/02,ccc_media_line_script,0,0,0:00:00,0,0:00:00,0,0
20160802-ccc_priority_script,2016/08/02,ccc_priority_script,36,36,0:00:09,9,0:00:55,0,324
20160802-ccc_tax_script,2016/08/02,ccc_tax_script,15,14,0:03:14,194,0:06:36,1,2716
20160802-ccc_waste_recycling_script,2016/08/02,ccc_waste_recycling_script,0,0,0:00:00,0,0:00:00,0,0
20160803-ccc_311_calgary_script,2016/08/03,ccc_311_calgary_script,3362,2743,0:03:22,202,0:13:34,619,554086
20160803-ccc_311_lobby_ph_script,2016/08/03,ccc_311_lobby_ph_script,3,3,0:00:09,9,0:00:14,0,27
20160803-ccc_aserv_info_script,2016/08/03,ccc_aserv_info_script,0,0,0:00:00,0,0:00:00,0,0
20160803-ccc_bylaw_script,2016/08/03,ccc_bylaw_script,0,0,0:00:00,0,0:00:00,0,0
20160803-ccc_city_script,2016/08/03,ccc_city_script,23,23,0:01:21,81,0:07:22,0,1863
20160803-ccc_cty_online_script,2016/08/03,ccc_cty_online_script,0,0,0:00:00,0,0:00:00,0,0
20160803-ccc_feedback_script,2016/08/03,ccc_feedback_script,0,0,0:00:00,0,0:00:00,0,0
20160803-ccc_fpb_script,2016/08/03,ccc_fpb_script,1,1,0:02:55,175,0:02:55,0,175
20160803-ccc_help_script,2016/08/03,ccc_help_script,17,16,0:00:07,7,0:00:15,1,112
20160803-ccc_link_script,2016/08/03,ccc_link_script,0,0,0:00:00,0,0:00:00,0,0
20160803-ccc_media_line_script,2016/08/03,ccc_media_line_script,1,1,0:01:04,64,0:01:04,0,64
20160803-ccc_priority_script,2016/08/03,ccc_priority_script,27,26,0:00:09,9,0:00:47,1,234
20160803-ccc_tax_script,2016/08/03,ccc_tax_script,16,15,0:03:42,222,0:08:31,1,3330
20160803-ccc_waste_recycling_script,2016/08/03,ccc_waste_recycling_script,0,0,0:00:00,0,0:00:00,0,0
20160804-ccc_311_calgary_script,2016/08/04,ccc_311_calgary_script,3508,2805,0:03:43,223,0:11:58,703,625515
20160804-ccc_311_lobby_ph_script,2016/08/04,ccc_311_lobby_ph_script,1,0,0:00:00,0,0:00:00,1,0
20160804-ccc_aserv_info_script,2016/08/04,ccc_aserv_info_script,0,0,0:00:00,0,0:00:00,0,0
20160804-ccc_bylaw_script,2016/08/04,ccc_bylaw_script,0,0,0:00:00,0,0:00:00,0,0
20160804-ccc_city_script,2016/08/04,ccc_city_script,32,31,0:01:23,83,0:05:56,1,2573
20160804-ccc_cty_online_script,2016/08/04,ccc_cty_online_script,0,0,0:00:00,0,0:00:00,0,0
20160804-ccc_feedback_script,2016/08/04,ccc_feedback_script,0,0,0:00:00,0,0:00:00,0,0
20160804-ccc_fpb_script,2016/08/04,ccc_fpb_script,1,0,0:00:00,0,0:00:00,1,0
20160804-ccc_help_script,2016/08/04,ccc_help_script,16,16,0:00:14,14,0:01:11,0,224
20160804-ccc_link_script,2016/08/04,ccc_link_script,0,0,0:00:00,0,0:00:00,0,0
20160804-ccc_media_line_script,2016/08/04,ccc_media_line_script,0,0,0:00:00,0,0:00:00,0,0
20160804-ccc_priority_script,2016/08/04,ccc_priority_script,41,37,0:00:17,17,0:01:42,4,629
20160804-ccc_tax_script,2016/08/04,ccc_tax_script,12,10,0:03:29,209,0:07:27,2,2090
20160804-ccc_waste_recycling_script,2016/08/04,ccc_waste_recycling_script,0,0,0:00:00,0,0:00:00,0,0
20160805-ccc_311_calgary_script,2016/08/05,ccc_311_calgary_script,3354,2836,0:02:31,151,0:08:09,518,428236
20160805-ccc_311_lobby_ph_script,2016/08/05,ccc_311_lobby_ph_script,0,0,0:00:00,0,0:00:00,0,0
20160805-ccc_aserv_info_script,2016/08/05,ccc_aserv_info_script,0,0,0:00:00,0,0:00:00,0,0
20160805-ccc_bylaw_script,2016/08/05,ccc_bylaw_script,0,0,0:00:00,0,0:00:00,0,0
20160805-ccc_city_script,2016/08/05,ccc_city_script,31,29,0:01:15,75,0:06:54,2,2175
20160805-ccc_cty_online_script,2016/08/05,ccc_cty_online_script,0,0,0:00:00,0,0:00:00,0,0
20160805-ccc_feedback_script,2016/08/05,ccc_feedback_script,0,0,0:00:00,0,0:00:00,0,0
20160805-ccc_fpb_script,2016/08/05,ccc_fpb_script,0,0,0:00:00,0,0:00:00,0,0
20160805-ccc_help_script,2016/08/05,ccc_help_script,9,6,0:00:13,13,0:00:35,3,78
20160805-ccc_link_script,2016/08/05,ccc_link_script,0,0,0:00:00,0,0:00:00,0,0
20160805-ccc_media_line_script,2016/08/05,ccc_media_line_script,0,0,0:00:00,0,0:00:00,0,0
20160805-ccc_priority_script,2016/08/05,ccc_priority_script,43,41,0:00:09,9,0:01:35,2,369
20160805-ccc_tax_script,2016/08/05,ccc_tax_script,11,10,0:04:14,254,0:07:36,1,2540
20160805-ccc_waste_recycling_script,2016/08/05,ccc_waste_recycling_script,0,0,0:00:00,0,0:00:00,0,0
20160806-ccc_311_calgary_script,2016/08/06,ccc_311_calgary_script,1375,1165,0:01:44,104,0:12:18,208,121160
20160806-ccc_311_lobby_ph_script,2016/08/06,ccc_311_lobby_ph_script,0,0,0:00:00,0,0:00:00,0,0
20160806-ccc_aserv_info_script,2016/08/06,ccc_aserv_info_script,0,0,0:00:00,0,0:00:00,0,0
20160806-ccc_bylaw_script,2016/08/06,ccc_bylaw_script,0,0,0:00:00,0,0:00:00,0,0
20160806-ccc_city_script,2016/08/06,ccc_city_script,0,0,0:00:00,0,0:00:00,0,0
20160806-ccc_cty_online_script,2016/08/06,ccc_cty_online_script,0,0,0:00:00,0,0:00:00,0,0
20160806-ccc_feedback_script,2016/08/06,ccc_feedback_script,0,0,0:00:00,0,0:00:00,0,0
20160806-ccc_fpb_script,2016/08/06,ccc_fpb_script,0,0,0:00:00,0,0:00:00,0,0
20160806-ccc_help_script,2016/08/06,ccc_help_script,6,6,0:00:08,8,0:00:11,0,48
20160806-ccc_link_script,2016/08/06,ccc_link_script,0,0,0:00:00,0,0:00:00,0,0
20160806-ccc_media_line_script,2016/08/06,ccc_media_line_script,1,1,0:00:05,5,0:00:05,0,5
20160806-ccc_priority_script,2016/08/06,ccc_priority_script,41,40,0:00:45,45,0:04:32,1,1800
20160806-ccc_tax_script,2016/08/06,ccc_tax_script,0,0,0:00:00,0,0:00:00,0,0
20160806-ccc_waste_recycling_script,2016/08/06,ccc_waste_recycling_script,0,0,0:00:00,0,0:00:00,0,0
20160807-ccc_311_calgary_script,2016/08/07,ccc_311_calgary_script,1220,1126,0:00:51,51,0:13:49,96,57426
20160807-ccc_311_lobby_ph_script,2016/08/07,ccc_311_lobby_ph_script,0,0,0:00:00,0,0:00:00,0,0
20160807-ccc_aserv_info_script,2016/08/07,ccc_aserv_info_script,0,0,0:00:00,0,0:00:00,0,0
20160807-ccc_bylaw_script,2016/08/07,ccc_bylaw_script,0,0,0:00:00,0,0:00:00,0,0
20160807-ccc_city_script,2016/08/07,ccc_city_script,0,0,0:00:00,0,0:00:00,0,0
20160807-ccc_cty_online_script,2016/08/07,ccc_cty_online_script,0,0,0:00:00,0,0:00:00,0,0
20160807-ccc_feedback_script,2016/08/07,ccc_feedback_script,0,0,0:00:00,0,0:00:00,0,0
20160807-ccc_fpb_script,2016/08/07,ccc_fpb_script,0,0,0:00:00,0,0:00:00,0,0
20160807-ccc_help_script,2016/08/07,ccc_help_script,2,2,0:00:05,5,0:00:06,0,10
20160807-ccc_link_script,2016/08/07,ccc_link_script,0,0,0:00:00,0,0:00:00,0,0
20160807-ccc_media_line_script,2016/08/07,ccc_media_line_script,1,1,0:00:38,38,0:00:38,0,38
20160807-ccc_priority_script,2016/08/07,ccc_priority_script,31,28,0:00:32,32,0:04:05,3,896
20160807-ccc_tax_script,2016/08/07,ccc_tax_script,0,0,0:00:00,0,0:00:00,0,0
20160807-ccc_waste_recycling_script,2016/08/07,ccc_waste_recycling_script,0,0,0:00:00,0,0:00:00,0,0
20160808-ccc_311_calgary_script,2016/08/08,ccc_311_calgary_script,4316,2860,0:06:33,393,0:17:42,1453,1123980
20160808-ccc_311_lobby_ph_script,2016/08/08,ccc_311_lobby_ph_script,5,3,0:00:16,16,0:00:24,2,48
20160808-ccc_aserv_info_script,2016/08/08,ccc_aserv_info_script,0,0,0:00:00,0,0:00:00,0,0
20160808-ccc_bylaw_script,2016/08/08,ccc_bylaw_script,0,0,0:00:00,0,0:00:00,0,0
20160808-ccc_city_script,2016/08/08,ccc_city_script,24,19,0:02:54,174,0:07:39,5,3306
20160808-ccc_cty_online_script,2016/08/08,ccc_cty_online_script,0,0,0:00:00,0,0:00:00,0,0
20160808-ccc_feedback_script,2016/08/08,ccc_feedback_script,0,0,0:00:00,0,0:00:00,0,0
20160808-ccc_fpb_script,2016/08/08,ccc_fpb_script,1,0,0:00:00,0,0:00:00,1,0
20160808-ccc_help_script,2016/08/08,ccc_help_script,33,28,0:00:14,14,0:00:43,5,392
20160808-ccc_link_script,2016/08/08,ccc_link_script,0,0,0:00:00,0,0:00:00,0,0
20160808-ccc_media_line_script,2016/08/08,ccc_media_line_script,1,1,0:00:04,4,0:00:04,0,4
20160808-ccc_priority_script,2016/08/08,ccc_priority_script,38,34,0:00:13,13,0:01:14,4,442
20160808-ccc_tax_script,2016/08/08,ccc_tax_script,24,10,0:08:13,493,0:15:27,14,4930
20160808-ccc_waste_recycling_script,2016/08/08,ccc_waste_recycling_script,0,0,0:00:00,0,0:00:00,0,0
20160809-ccc_311_calgary_script,2016/08/09,ccc_311_calgary_script,3967,2983,0:04:29,269,0:14:01,985,802427
20160809-ccc_311_lobby_ph_script,2016/08/09,ccc_311_lobby_ph_script,6,3,0:00:13,13,0:00:18,3,39
20160809-ccc_aserv_info_script,2016/08/09,ccc_aserv_info_script,0,0,0:00:00,0,0:00:00,0,0
20160809-ccc_bylaw_script,2016/08/09,ccc_bylaw_script,1,0,0:00:00,0,0:00:00,1,0
20160809-ccc_city_script,2016/08/09,ccc_city_script,14,14,0:01:15,75,0:08:27,0,1050
20160809-ccc_cty_online_script,2016/08/09,ccc_cty_online_script,0,0,0:00:00,0,0:00:00,0,0
20160809-ccc_feedback_script,2016/08/09,ccc_feedback_script,0,0,0:00:00,0,0:00:00,0,0
20160809-ccc_fpb_script,2016/08/09,ccc_fpb_script,3,0,0:00:00,0,0:00:00,3,0
20160809-ccc_help_script,2016/08/09,ccc_help_script,38,33,0:00:22,22,0:04:41,5,726
20160809-ccc_link_script,2016/08/09,ccc_link_script,0,0,0:00:00,0,0:00:00,0,0
20160809-ccc_media_line_script,2016/08/09,ccc_media_line_script,0,0,0:00:00,0,0:00:00,0,0
20160809-ccc_priority_script,2016/08/09,ccc_priority_script,35,33,0:00:12,12,0:00:38,2,396
20160809-ccc_tax_script,2016/08/09,ccc_tax_script,35,24,0:04:43,283,0:10:11,11,6792
20160809-ccc_waste_recycling_script,2016/08/09,ccc_waste_recycling_script,0,0,0:00:00,0,0:00:00,0,0
20160810-ccc_311_calgary_script,2016/08/10,ccc_311_calgary_script,3565,2534,0:06:35,395,0:15:53,1033,1000930
20160810-ccc_311_lobby_ph_script,2016/08/10,ccc_311_lobby_ph_script,5,5,0:00:11,11,0:00:18,0,55
20160810-ccc_aserv_info_script,2016/08/10,ccc_aserv_info_script,0,0,0:00:00,0,0:00:00,0,0
20160810-ccc_bylaw_script,2016/08/10,ccc_bylaw_script,0,0,0:00:00,0,0:00:00,0,0
20160810-ccc_city_script,2016/08/10,ccc_city_script,12,11,0:04:20,260,0:14:16,1,2860
20160810-ccc_cty_online_script,2016/08/10,ccc_cty_online_script,0,0,0:00:00,0,0:00:00,0,0
20160810-ccc_feedback_script,2016/08/10,ccc_feedback_script,0,0,0:00:00,0,0:00:00,0,0
20160810-ccc_fpb_script,2016/08/10,ccc_fpb_script,0,0,0:00:00,0,0:00:00,0,0
20160810-ccc_help_script,2016/08/10,ccc_help_script,21,16,0:00:18,18,0:01:02,5,288
20160810-ccc_link_script,2016/08/10,ccc_link_script,0,0,0:00:00,0,0:00:00,0,0
20160810-ccc_media_line_script,2016/08/10,ccc_media_line_script,1,1,0:00:07,7,0:00:07,0,7
20160810-ccc_priority_script,2016/08/10,ccc_priority_script,26,25,0:00:12,12,0:00:37,1,300
20160810-ccc_tax_script,2016/08/10,ccc_tax_script,16,12,0:09:50,590,0:14:42,4,7080
20160810-ccc_waste_recycling_script,2016/08/10,ccc_waste_recycling_script,0,0,0:00:00,0,0:00:00,0,0
20160811-ccc_311_calgary_script,2016/08/11,ccc_311_calgary_script,3557,2690,0:04:15,255,0:12:05,867,685950
20160811-ccc_311_lobby_ph_script,2016/08/11,ccc_311_lobby_ph_script,3,3,0:00:16,16,0:00:22,0,48
20160811-ccc_aserv_info_script,2016/08/11,ccc_aserv_info_script,0,0,0:00:00,0,0:00:00,0,0
20160811-ccc_bylaw_script,2016/08/11,ccc_bylaw_script,0,0,0:00:00,0,0:00:00,0,0
20160811-ccc_city_script,2016/08/11,ccc_city_script,14,12,0:01:03,63,0:03:49,2,756
20160811-ccc_cty_online_script,2016/08/11,ccc_cty_online_script,0,0,0:00:00,0,0:00:00,0,0
20160811-ccc_feedback_script,2016/08/11,ccc_feedback_script,0,0,0:00:00,0,0:00:00,0,0
20160811-ccc_fpb_script,2016/08/11,ccc_fpb_script,2,1,0:07:02,422,0:07:02,1,422
20160811-ccc_help_script,2016/08/11,ccc_help_script,19,19,0:00:10,10,0:00:59,0,190
20160811-ccc_link_script,2016/08/11,ccc_link_script,0,0,0:00:00,0,0:00:00,0,0
20160811-ccc_media_line_script,2016/08/11,ccc_media_line_script,0,0,0:00:00,0,0:00:00,0,0
20160811-ccc_priority_script,2016/08/11,ccc_priority_script,27,25,0:00:06,6,0:00:18,2,150
20160811-ccc_tax_script,2016/08/11,ccc_tax_script,18,11,0:05:15,315,0:10:42,7,3465
20160811-ccc_waste_recycling_script,2016/08/11,ccc_waste_recycling_script,0,0,0:00:00,0,0:00:00,0,0
20160812-ccc_311_calgary_script,2016/08/12,ccc_311_calgary_script,3147,2618,0:02:57,177,0:10:28,529,463386
20160812-ccc_311_lobby_ph_script,2016/08/12,ccc_311_lobby_ph_script,0,0,0:00:00,0,0:00:00,0,0
20160812-ccc_aserv_info_script,2016/08/12,ccc_aserv_info_script,0,0,0:00:00,0,0:00:00,0,0
20160812-ccc_bylaw_script,2016/08/12,ccc_bylaw_script,0,0,0:00:00,0,0:00:00,0,0
20160812-ccc_city_script,2016/08/12,ccc_city_script,26,25,0:00:57,57,0:04:11,1,1425
20160812-ccc_cty_online_script,2016/08/12,ccc_cty_online_script,0,0,0:00:00,0,0:00:00,0,0
20160812-ccc_feedback_script,2016/08/12,ccc_feedback_script,0,0,0:00:00,0,0:00:00,0,0
20160813-ccc_help_script,2016/08/13,ccc_help_script,6,5,0:00:06,6,0:00:07,1,30
20160813-ccc_link_script,2016/08/13,ccc_link_script,0,0,0:00:00,0,0:00:00,0,0
20160813-ccc_media_line_script,2016/08/13,ccc_media_line_script,0,0,0:00:00,0,0:00:00,0,0
20160813-ccc_priority_script,2016/08/13,ccc_priority_script,25,23,0:00:14,14,0:01:38,2,322
20160813-ccc_tax_script,2016/08/13,ccc_tax_script,0,0,0:00:00,0,0:00:00,0,0
20160813-ccc_waste_recycling_script,2016/08/13,ccc_waste_recycling_script,0,0,0:00:00,0,0:00:00,0,0
20160814-ccc_cty_online_script,2016/08/14,ccc_cty_online_script,0,0,0:00:00,0,0:00:00,0,0
20160814-ccc_feedback_script,2016/08/14,ccc_feedback_script,0,0,0:00:00,0,0:00:00,0,0
20160814-ccc_fpb_script,2016/08/14,ccc_fpb_script,0,0,0:00:00,0,0:00:00,0,0
20160814-ccc_help_script,2016/08/14,ccc_help_script,1,1,0:00:05,5,0:00:05,0,5
20160814-ccc_link_script,2016/08/14,ccc_link_script,0,0,0:00:00,0,0:00:00,0,0
20160814-ccc_media_line_script,2016/08/14,ccc_media_line_script,0,0,0:00:00,0,0:00:00,0,0
20160814-ccc_priority_script,2016/08/14,ccc_priority_script,23,23,0:00:17,17,0:03:39,0,391
20160814-ccc_tax_script,2016/08/14,ccc_tax_script,1,1,0:00:07,7,0:00:07,0,7
20160814-ccc_waste_recycling_script,2016/08/14,ccc_waste_recycling_script,0,0,0:00:00,0,0:00:00,0,0
20160815-ccc_311_calgary_script,2016/08/15,ccc_311_calgary_script,3932,3194,0:03:18,198,0:11:43,738,632412
20160815-ccc_311_lobby_ph_script,2016/08/15,ccc_311_lobby_ph_script,1,1,0:00:02,2,0:00:02,0,2
20160815-ccc_aserv_info_script,2016/08/15,ccc_aserv_info_script,0,0,0:00:00,0,0:00:00,0,0
20160815-ccc_bylaw_script,2016/08/15,ccc_bylaw_script,0,0,0:00:00,0,0:00:00,0,0
20160815-ccc_city_script,2016/08/15,ccc_city_script,28,24,0:00:55,55,0:05:09,4,1320
20160815-ccc_cty_online_script,2016/08/15,ccc_cty_online_script,0,0,0:00:00,0,0:00:00,0,0
20160815-ccc_feedback_script,2016/08/15,ccc_feedback_script,0,0,0:00:00,0,0:00:00,0,0
20160815-ccc_fpb_script,2016/08/15,ccc_fpb_script,0,0,0:00:00,0,0:00:00,0,0
20160815-ccc_help_script,2016/08/15,ccc_help_script,17,15,0:00:15,15,0:01:03,2,225
20160815-ccc_link_script,2016/08/15,ccc_link_script,0,0,0:00:00,0,0:00:00,0,0
20160815-ccc_media_line_script,2016/08/15,ccc_media_line_script,0,0,0:00:00,0,0:00:00,0,0
20160815-ccc_priority_script,2016/08/15,ccc_priority_script,23,20,0:00:12,12,0:00:51,3,240
20160815-ccc_tax_script,2016/08/15,ccc_tax_script,15,13,0:03:18,198,0:07:09,2,2574
20160815-ccc_waste_recycling_script,2016/08/15,ccc_waste_recycling_script,0,0,0:00:00,0,0:00:00,0,0
20160816-ccc_311_calgary_script,2016/08/16,ccc_311_calgary_script,3656,3094,0:01:50,110,0:07:45,508,340340
20160816-ccc_311_lobby_ph_script,2016/08/16,ccc_311_lobby_ph_script,0,0,0:00:00,0,0:00:00,0,0
20160816-ccc_aserv_info_script,2016/08/16,ccc_aserv_info_script,0,0,0:00:00,0,0:00:00,0,0
20160816-ccc_bylaw_script,2016/08/16,ccc_bylaw_script,0,0,0:00:00,0,0:00:00,0,0
20160816-ccc_city_script,2016/08/16,ccc_city_script,28,24,0:00:43,43,0:03:53,3,1032
20160816-ccc_cty_online_script,2016/08/16,ccc_cty_online_script,0,0,0:00:00,0,0:00:00,0,0
20160816-ccc_feedback_script,2016/08/16,ccc_feedback_script,0,0,0:00:00,0,0:00:00,0,0
20160816-ccc_fpb_script,2016/08/16,ccc_fpb_script,0,0,0:00:00,0,0:00:00,0,0
20160816-ccc_help_script,2016/08/16,ccc_help_script,23,20,0:00:10,10,0:00:34,2,200
20160816-ccc_link_script,2016/08/16,ccc_link_script,2,0,0:00:00,0,0:00:00,1,0
20160816-ccc_media_line_script,2016/08/16,ccc_media_line_script,2,1,0:01:44,104,0:01:44,1,104
20160816-ccc_priority_script,2016/08/16,ccc_priority_script,24,21,0:00:08,8,0:00:35,2,168
20160816-ccc_tax_script,2016/08/16,ccc_tax_script,13,13,0:01:14,74,0:03:48,0,962
20160816-ccc_waste_recycling_script,2016/08/16,ccc_waste_recycling_script,0,0,0:00:00,0,0:00:00,0,0
20160817-ccc_311_calgary_script,2016/08/17,ccc_311_calgary_script,3400,2858,0:02:41,161,0:11:25,542,460138
20160817-ccc_311_lobby_ph_script,2016/08/17,ccc_311_lobby_ph_script,2,2,0:00:38,38,0:00:44,0,76
20160817-ccc_aserv_info_script,2016/08/17,ccc_aserv_info_script,0,0,0:00:00,0,0:00:00,0,0
20160817-ccc_bylaw_script,2016/08/17,ccc_bylaw_script,0,0,0:00:00,0,0:00:00,0,0
20160817-ccc_city_script,2016/08/17,ccc_city_script,28,28,0:01:02,62,0:06:17,0,1736
20160817-ccc_cty_online_script,2016/08/17,ccc_cty_online_script,0,0,0:00:00,0,0:00:00,0,0
20160817-ccc_feedback_script,2016/08/17,ccc_feedback_script,0,0,0:00:00,0,0:00:00,0,0
20160817-ccc_fpb_script,2016/08/17,ccc_fpb_script,2,0,0:00:00,0,0:00:00,2,0
20160817-ccc_help_script,2016/08/17,ccc_help_script,36,25,0:00:18,18,0:02:33,11,450
20160817-ccc_link_script,2016/08/17,ccc_link_script,0,0,0:00:00,0,0:00:00,0,0
20160817-ccc_media_line_script,2016/08/17,ccc_media_line_script,3,3,0:00:08,8,0:00:12,0,24
20160817-ccc_priority_script,2016/08/17,ccc_priority_script,38,37,0:00:12,12,0:01:09,1,444
20160817-ccc_tax_script,2016/08/17,ccc_tax_script,8,8,0:01:10,70,0:05:51,0,560
20160817-ccc_waste_recycling_script,2016/08/17,ccc_waste_recycling_script,0,0,0:00:00,0,0:00:00,0,0
20160818-ccc_311_calgary_script,2016/08/18,ccc_311_calgary_script,3003,2900,0:00:27,27,0:11:50,103,78300
20160818-ccc_311_lobby_ph_script,2016/08/18,ccc_311_lobby_ph_script,2,2,0:00:06,6,0:00:08,0,12
20160818-ccc_aserv_info_script,2016/08/18,ccc_aserv_info_script,0,0,0:00:00,0,0:00:00,0,0
20160818-ccc_bylaw_script,2016/08/18,ccc_bylaw_script,0,0,0:00:00,0,0:00:00,0,0
20160818-ccc_city_script,2016/08/18,ccc_city_script,22,22,0:00:07,7,0:00:19,0,154
20160818-ccc_cty_online_script,2016/08/18,ccc_cty_online_script,0,0,0:00:00,0,0:00:00,0,0
20160818-ccc_feedback_script,2016/08/18,ccc_feedback_script,1,0,0:00:00,0,0:00:00,0,0
20160818-ccc_fpb_script,2016/08/18,ccc_fpb_script,1,1,0:00:06,6,0:00:06,0,6
20160818-ccc_help_script,2016/08/18,ccc_help_script,12,12,0:00:05,5,0:00:07,0,60
20160818-ccc_link_script,2016/08/18,ccc_link_script,0,0,0:00:00,0,0:00:00,0,0
20160818-ccc_media_line_script,2016/08/18,ccc_media_line_script,0,0,0:00:00,0,0:00:00,0,0
20160818-ccc_priority_script,2016/08/18,ccc_priority_script,24,24,0:00:14,14,0:01:42,0,336
20160818-ccc_tax_script,2016/08/18,ccc_tax_script,15,15,0:00:29,29,0:01:39,0,435
20160818-ccc_waste_recycling_script,2016/08/18,ccc_waste_recycling_script,0,0,0:00:00,0,0:00:00,0,0
20160819-ccc_311_calgary_script,2016/08/19,ccc_311_calgary_script,2909,2847,0:00:17,17,0:15:25,62,48399
20160819-ccc_311_lobby_ph_script,2016/08/19,ccc_311_lobby_ph_script,2,2,0:00:03,3,0:00:03,0,6
20160819-ccc_aserv_info_script,2016/08/19,ccc_aserv_info_script,0,0,0:00:00,0,0:00:00,0,0
20160819-ccc_bylaw_script,2016/08/19,ccc_bylaw_script,0,0,0:00:00,0,0:00:00,0,0
20160819-ccc_city_script,2016/08/19,ccc_city_script,22,22,0:00:06,6,0:00:19,0,132
20160819-ccc_cty_online_script,2016/08/19,ccc_cty_online_script,0,0,0:00:00,0,0:00:00,0,0
20160819-ccc_feedback_script,2016/08/19,ccc_feedback_script,0,0,0:00:00,0,0:00:00,0,0
20160819-ccc_fpb_script,2016/08/19,ccc_fpb_script,1,1,0:00:02,2,0:00:02,0,2
20160819-ccc_help_script,2016/08/19,ccc_help_script,16,16,0:00:15,15,0:01:13,0,240
20160819-ccc_link_script,2016/08/19,ccc_link_script,0,0,0:00:00,0,0:00:00,0,0
20160819-ccc_media_line_script,2016/08/19,ccc_media_line_script,0,0,0:00:00,0,0:00:00,0,0
20160819-ccc_priority_script,2016/08/19,ccc_priority_script,18,17,0:00:13,13,0:01:52,1,221
20160819-ccc_tax_script,2016/08/19,ccc_tax_script,19,19,0:00:05,5,0:00:19,0,95
20160819-ccc_waste_recycling_script,2016/08/19,ccc_waste_recycling_script,0,0,0:00:00,0,0:00:00,0,0
20160820-ccc_311_calgary_script,2016/08/20,ccc_311_calgary_script,1295,1217,0:00:33,33,0:19:04,78,40161
20160820-ccc_311_lobby_ph_script,2016/08/20,ccc_311_lobby_ph_script,0,0,0:00:00,0,0:00:00,0,0
20160820-ccc_aserv_info_script,2016/08/20,ccc_aserv_info_script,0,0,0:00:00,0,0:00:00,0,0
20160820-ccc_bylaw_script,2016/08/20,ccc_bylaw_script,0,0,0:00:00,0,0:00:00,0,0
20160820-ccc_city_script,2016/08/20,ccc_city_script,0,0,0:00:00,0,0:00:00,0,0
20160820-ccc_cty_online_script,2016/08/20,ccc_cty_online_script,0,0,0:00:00,0,0:00:00,0,0
20160820-ccc_feedback_script,2016/08/20,ccc_feedback_script,0,0,0:00:00,0,0:00:00,0,0
20160820-ccc_fpb_script,2016/08/20,ccc_fpb_script,0,0,0:00:00,0,0:00:00,0,0
20160820-ccc_help_script,2016/08/20,ccc_help_script,9,9,0:00:30,30,0:01:48,0,270
20160820-ccc_link_script,2016/08/20,ccc_link_script,0,0,0:00:00,0,0:00:00,0,0
20160820-ccc_media_line_script,2016/08/20,ccc_media_line_script,2,2,0:00:14,14,0:00:26,0,28
20160820-ccc_priority_script,2016/08/20,ccc_priority_script,25,24,0:00:19,19,0:02:52,1,456
20160820-ccc_tax_script,2016/08/20,ccc_tax_script,0,0,0:00:00,0,0:00:00,0,0
20160820-ccc_waste_recycling_script,2016/08/20,ccc_waste_recycling_script,0,0,0:00:00,0,0:00:00,0,0
20160821-ccc_311_calgary_script,2016/08/21,ccc_311_calgary_script,1086,997,0:00:51,51,0:20:19,88,50847
20160821-ccc_311_lobby_ph_script,2016/08/21,ccc_311_lobby_ph_script,0,0,0:00:00,0,0:00:00,0,0
20160821-ccc_aserv_info_script,2016/08/21,ccc_aserv_info_script,0,0,0:00:00,0,0:00:00,0,0
20160821-ccc_bylaw_script,2016/08/21,ccc_bylaw_script,0,0,0:00:00,0,0:00:00,0,0
20160821-ccc_city_script,2016/08/21,ccc_city_script,0,0,0:00:00,0,0:00:00,0,0
20160821-ccc_cty_online_script,2016/08/21,ccc_cty_online_script,0,0,0:00:00,0,0:00:00,0,0
20160821-ccc_feedback_script,2016/08/21,ccc_feedback_script,0,0,0:00:00,0,0:00:00,0,0
20160821-ccc_fpb_script,2016/08/21,ccc_fpb_script,0,0,0:00:00,0,0:00:00,0,0
20160821-ccc_help_script,2016/08/21,ccc_help_script,1,1,0:00:07,7,0:00:07,0,7
20160821-ccc_link_script,2016/08/21,ccc_link_script,0,0,0:00:00,0,0:00:00,0,0
20160821-ccc_media_line_script,2016/08/21,ccc_media_line_script,3,3,0:00:25,25,0:00:55,0,75
20160821-ccc_priority_script,2016/08/21,ccc_priority_script,19,18,0:00:24,24,0:03:18,1,432
20160821-ccc_tax_script,2016/08/21,ccc_tax_script,0,0,0:00:00,0,0:00:00,0,0
20160821-ccc_waste_recycling_script,2016/08/21,ccc_waste_recycling_script,0,0,0:00:00,0,0:00:00,0,0
20160822-ccc_311_calgary_script,2016/08/22,ccc_311_calgary_script,3678,3512,0:00:39,39,0:09:16,166,136968
20160822-ccc_311_lobby_ph_script,2016/08/22,ccc_311_lobby_ph_script,3,3,0:00:04,4,0:00:07,0,12
20160822-ccc_aserv_info_script,2016/08/22,ccc_aserv_info_script,0,0,0:00:00,0,0:00:00,0,0
20160822-ccc_bylaw_script,2016/08/22,ccc_bylaw_script,1,1,0:00:32,32,0:00:32,0,32
20160822-ccc_city_script,2016/08/22,ccc_city_script,19,19,0:00:12,12,0:00:33,0,228
20160822-ccc_cty_online_script,2016/08/22,ccc_cty_online_script,0,0,0:00:00,0,0:00:00,0,0
20160822-ccc_feedback_script,2016/08/22,ccc_feedback_script,0,0,0:00:00,0,0:00:00,0,0
20160822-ccc_fpb_script,2016/08/22,ccc_fpb_script,0,0,0:00:00,0,0:00:00,0,0
20160822-ccc_help_script,2016/08/22,ccc_help_script,24,24,0:00:06,6,0:00:27,0,144
20160822-ccc_link_script,2016/08/22,ccc_link_script,0,0,0:00:00,0,0:00:00,0,0
20160822-ccc_media_line_script,2016/08/22,ccc_media_line_script,1,1,0:00:03,3,0:00:03,0,3
20160822-ccc_priority_script,2016/08/22,ccc_priority_script,34,32,0:00:21,21,0:03:29,2,672
20160822-ccc_tax_script,2016/08/22,ccc_tax_script,18,17,0:00:36,36,0:03:41,1,612
20160822-ccc_waste_recycling_script,2016/08/22,ccc_waste_recycling_script,0,0,0:00:00,0,0:00:00,0,0
20160823-ccc_311_calgary_script,2016/08/23,ccc_311_calgary_script,3704,3362,0:01:18,78,0:08:19,342,262236
20160823-ccc_311_lobby_ph_script,2016/08/23,ccc_311_lobby_ph_script,4,2,0:00:08,8,0:00:12,2,16
20160823-ccc_aserv_info_script,2016/08/23,ccc_aserv_info_script,0,0,0:00:00,0,0:00:00,0,0
20160823-ccc_bylaw_script,2016/08/23,ccc_bylaw_script,0,0,0:00:00,0,0:00:00,0,0
20160823-ccc_city_script,2016/08/23,ccc_city_script,23,22,0:00:16,16,0:00:48,1,352
20160823-ccc_cty_online_script,2016/08/23,ccc_cty_online_script,0,0,0:00:00,0,0:00:00,0,0
20160823-ccc_feedback_script,2016/08/23,ccc_feedback_script,1,0,0:00:00,0,0:00:00,0,0
20160823-ccc_fpb_script,2016/08/23,ccc_fpb_script,1,1,0:01:16,76,0:01:16,0,76
20160823-ccc_help_script,2016/08/23,ccc_help_script,25,24,0:00:11,11,0:00:26,1,264
20160823-ccc_link_script,2016/08/23,ccc_link_script,0,0,0:00:00,0,0:00:00,0,0
20160823-ccc_media_line_script,2016/08/23,ccc_media_line_script,2,2,0:00:08,8,0:00:14,0,16
20160823-ccc_priority_script,2016/08/23,ccc_priority_script,39,38,0:00:11,11,0:00:40,1,418
20160823-ccc_tax_script,2016/08/23,ccc_tax_script,11,11,0:01:20,80,0:02:55,0,880
20160823-ccc_waste_recycling_script,2016/08/23,ccc_waste_recycling_script,0,0,0:00:00,0,0:00:00,0,0
20160824-ccc_311_calgary_script,2016/08/24,ccc_311_calgary_script,3497,3303,0:00:44,44,0:12:35,194,145332
20160824-ccc_311_lobby_ph_script,2016/08/24,ccc_311_lobby_ph_script,7,6,0:00:06,6,0:00:12,1,36
20160824-ccc_aserv_info_script,2016/08/24,ccc_aserv_info_script,0,0,0:00:00,0,0:00:00,0,0
20160824-ccc_bylaw_script,2016/08/24,ccc_bylaw_script,0,0,0:00:00,0,0:00:00,0,0
20160824-ccc_city_script,2016/08/24,ccc_city_script,19,19,0:00:10,10,0:00:43,0,190
20160824-ccc_cty_online_script,2016/08/24,ccc_cty_online_script,0,0,0:00:00,0,0:00:00,0,0
20160824-ccc_feedback_script,2016/08/24,ccc_feedback_script,0,0,0:00:00,0,0:00:00,0,0
20160824-ccc_fpb_script,2016/08/24,ccc_fpb_script,0,0,0:00:00,0,0:00:00,0,0
20160824-ccc_help_script,2016/08/24,ccc_help_script,22,20,0:00:11,11,0:00:40,2,220
20160824-ccc_link_script,2016/08/24,ccc_link_script,0,0,0:00:00,0,0:00:00,0,0
20160824-ccc_media_line_script,2016/08/24,ccc_media_line_script,0,0,0:00:00,0,0:00:00,0,0
20160824-ccc_priority_script,2016/08/24,ccc_priority_script,18,17,0:00:12,12,0:00:51,1,204
20160824-ccc_tax_script,2016/08/24,ccc_tax_script,19,19,0:00:30,30,0:03:43,0,570
20160824-ccc_waste_recycling_script,2016/08/24,ccc_waste_recycling_script,0,0,0:00:00,0,0:00:00,0,0
20160825-ccc_311_calgary_script,2016/08/25,ccc_311_calgary_script,3175,3120,0:00:12,12,0:08:45,55,37440
20160825-ccc_311_lobby_ph_script,2016/08/25,ccc_311_lobby_ph_script,1,1,0:00:02,2,0:00:02,0,2
20160825-ccc_aserv_info_script,2016/08/25,ccc_aserv_info_script,0,0,0:00:00,0,0:00:00,0,0
20160825-ccc_bylaw_script,2016/08/25,ccc_bylaw_script,0,0,0:00:00,0,0:00:00,0,0
20160825-ccc_city_script,2016/08/25,ccc_city_script,9,9,0:00:07,7,0:00:17,0,63
20160825-ccc_cty_online_script,2016/08/25,ccc_cty_online_script,0,0,0:00:00,0,0:00:00,0,0
20160825-ccc_feedback_script,2016/08/25,ccc_feedback_script,0,0,0:00:00,0,0:00:00,0,0
20160825-ccc_fpb_script,2016/08/25,ccc_fpb_script,2,2,0:00:03,3,0:00:04,0,6
20160825-ccc_help_script,2016/08/25,ccc_help_script,20,20,0:00:06,6,0:00:12,0,120
20160825-ccc_link_script,2016/08/25,ccc_link_script,0,0,0:00:00,0,0:00:00,0,0
20160825-ccc_media_line_script,2016/08/25,ccc_media_line_script,2,2,0:00:06,6,0:00:07,0,12
20160825-ccc_priority_script,2016/08/25,ccc_priority_script,36,36,0:00:06,6,0:00:22,0,216
20160825-ccc_tax_script,2016/08/25,ccc_tax_script,23,23,0:00:08,8,0:00:34,0,184
20160825-ccc_waste_recycling_script,2016/08/25,ccc_waste_recycling_script,0,0,0:00:00,0,0:00:00,0,0
20160826-ccc_311_calgary_script,2016/08/26,ccc_311_calgary_script,3178,3115,0:00:14,14,0:05:54,63,43610
20160826-ccc_311_lobby_ph_script,2016/08/26,ccc_311_lobby_ph_script,2,2,0:00:08,8,0:00:11,0,16
20160826-ccc_aserv_info_script,2016/08/26,ccc_aserv_info_script,0,0,0:00:00,0,0:00:00,0,0
20160826-ccc_bylaw_script,2016/08/26,ccc_bylaw_script,0,0,0:00:00,0,0:00:00,0,0
20160826-ccc_city_script,2016/08/26,ccc_city_script,17,17,0:00:07,7,0:00:22,0,119
20160826-ccc_cty_online_script,2016/08/26,ccc_cty_online_script,0,0,0:00:00,0,0:00:00,0,0
20160826-ccc_feedback_script,2016/08/26,ccc_feedback_script,0,0,0:00:00,0,0:00:00,0,0
20160826-ccc_fpb_script,2016/08/26,ccc_fpb_script,1,1,0:00:04,4,0:00:04,0,4
20160826-ccc_help_script,2016/08/26,ccc_help_script,10,10,0:00:14,14,0:01:21,0,140
20160826-ccc_link_script,2016/08/26,ccc_link_script,0,0,0:00:00,0,0:00:00,0,0
20160826-ccc_media_line_script,2016/08/26,ccc_media_line_script,0,0,0:00:00,0,0:00:00,0,0
20160826-ccc_priority_script,2016/08/26,ccc_priority_script,21,21,0:00:05,5,0:00:19,0,105
20160826-ccc_tax_script,2016/08/26,ccc_tax_script,12,12,0:00:16,16,0:01:00,0,192
20160826-ccc_waste_recycling_script,2016/08/26,ccc_waste_recycling_script,0,0,0:00:00,0,0:00:00,0,0
20160827-ccc_311_calgary_script,2016/08/27,ccc_311_calgary_script,1308,1274,0:00:16,16,0:06:14,34,20384
20160827-ccc_311_lobby_ph_script,2016/08/27,ccc_311_lobby_ph_script,0,0,0:00:00,0,0:00:00,0,0
20160827-ccc_aserv_info_script,2016/08/27,ccc_aserv_info_script,0,0,0:00:00,0,0:00:00,0,0
20160827-ccc_bylaw_script,2016/08/27,ccc_bylaw_script,0,0,0:00:00,0,0:00:00,0,0
20160827-ccc_city_script,2016/08/27,ccc_city_script,0,0,0:00:00,0,0:00:00,0,0
20160827-ccc_cty_online_script,2016/08/27,ccc_cty_online_script,0,0,0:00:00,0,0:00:00,0,0
20160827-ccc_feedback_script,2016/08/27,ccc_feedback_script,0,0,0:00:00,0,0:00:00,0,0
20160827-ccc_fpb_script,2016/08/27,ccc_fpb_script,0,0,0:00:00,0,0:00:00,0,0
20160827-ccc_help_script,2016/08/27,ccc_help_script,6,6,0:00:08,8,0:00:17,0,48
20160827-ccc_link_script,2016/08/27,ccc_link_script,0,0,0:00:00,0,0:00:00,0,0
20160827-ccc_media_line_script,2016/08/27,ccc_media_line_script,1,1,0:00:04,4,0:00:04,0,4
20160827-ccc_priority_script,2016/08/27,ccc_priority_script,19,19,0:00:05,5,0:00:14,0,95
20160827-ccc_tax_script,2016/08/27,ccc_tax_script,0,0,0:00:00,0,0:00:00,0,0
20160827-ccc_waste_recycling_script,2016/08/27,ccc_waste_recycling_script,0,0,0:00:00,0,0:00:00,0,0
20160828-ccc_311_calgary_script,2016/08/28,ccc_311_calgary_script,950,912,0:00:25,25,0:09:32,38,22800
20160828-ccc_311_lobby_ph_script,2016/08/28,ccc_311_lobby_ph_script,0,0,0:00:00,0,0:00:00,0,0
20160828-ccc_aserv_info_script,2016/08/28,ccc_aserv_info_script,0,0,0:00:00,0,0:00:00,0,0
20160828-ccc_bylaw_script,2016/08/28,ccc_bylaw_script,0,0,0:00:00,0,0:00:00,0,0
20160828-ccc_city_script,2016/08/28,ccc_city_script,0,0,0:00:00,0,0:00:00,0,0
20160828-ccc_cty_online_script,2016/08/28,ccc_cty_online_script,0,0,0:00:00,0,0:00:00,0,0
20160828-ccc_feedback_script,2016/08/28,ccc_feedback_script,0,0,0:00:00,0,0:00:00,0,0
20160828-ccc_fpb_script,2016/08/28,ccc_fpb_script,0,0,0:00:00,0,0:00:00,0,0
20160828-ccc_help_script,2016/08/28,ccc_help_script,3,3,0:00:12,12,0:00:23,0,36
20160828-ccc_link_script,2016/08/28,ccc_link_script,0,0,0:00:00,0,0:00:00,0,0
20160828-ccc_media_line_script,2016/08/28,ccc_media_line_script,1,1,0:00:06,6,0:00:06,0,6
20160828-ccc_priority_script,2016/08/28,ccc_priority_script,11,11,0:00:07,7,0:00:12,0,77
20160828-ccc_tax_script,2016/08/28,ccc_tax_script,0,0,0:00:00,0,0:00:00,0,0
20160828-ccc_waste_recycling_script,2016/08/28,ccc_waste_recycling_script,0,0,0:00:00,0,0:00:00,0,0
20160829-ccc_311_calgary_script,2016/08/29,ccc_311_calgary_script,3595,3456,0:00:33,33,0:05:54,139,114048
20160829-ccc_311_lobby_ph_script,2016/08/29,ccc_311_lobby_ph_script,0,0,0:00:00,0,0:00:00,0,0
20160829-ccc_aserv_info_script,2016/08/29,ccc_aserv_info_script,0,0,0:00:00,0,0:00:00,0,0
20160829-ccc_bylaw_script,2016/08/29,ccc_bylaw_script,0,0,0:00:00,0,0:00:00,0,0
20160829-ccc_city_script,2016/08/29,ccc_city_script,25,25,0:00:09,9,0:00:30,0,225
20160829-ccc_cty_online_script,2016/08/29,ccc_cty_online_script,0,0,0:00:00,0,0:00:00,0,0
20160829-ccc_feedback_script,2016/08/29,ccc_feedback_script,0,0,0:00:00,0,0:00:00,0,0
20160829-ccc_fpb_script,2016/08/29,ccc_fpb_script,3,3,0:00:20,20,0:00:39,0,60
20160829-ccc_help_script,2016/08/29,ccc_help_script,30,29,0:00:06,6,0:00:17,1,174
20160829-ccc_link_script,2016/08/29,ccc_link_script,0,0,0:00:00,0,0:00:00,0,0
20160829-ccc_media_line_script,2016/08/29,ccc_media_line_script,0,0,0:00:00,0,0:00:00,0,0
20160829-ccc_priority_script,2016/08/29,ccc_priority_script,29,27,0:00:12,12,0:01:09,2,324
20160829-ccc_tax_script,2016/08/29,ccc_tax_script,20,19,0:00:20,20,0:00:55,1,380
20160829-ccc_waste_recycling_script,2016/08/29,ccc_waste_recycling_script,0,0,0:00:00,0,0:00:00,0,0
20160830-ccc_311_calgary_script,2016/08/30,ccc_311_calgary_script,3617,3319,0:00:55,55,0:07:41,298,182545
20160830-ccc_311_lobby_ph_script,2016/08/30,ccc_311_lobby_ph_script,2,1,0:00:05,5,0:00:05,1,5
20160830-ccc_aserv_info_script,2016/08/30,ccc_aserv_info_script,0,0,0:00:00,0,0:00:00,0,0
20160830-ccc_bylaw_script,2016/08/30,ccc_bylaw_script,0,0,0:00:00,0,0:00:00,0,0
20160830-ccc_city_script,2016/08/30,ccc_city_script,33,31,0:00:17,17,0:02:54,2,527
20160830-ccc_cty_online_script,2016/08/30,ccc_cty_online_script,0,0,0:00:00,0,0:00:00,0,0
20160830-ccc_feedback_script,2016/08/30,ccc_feedback_script,0,0,0:00:00,0,0:00:00,0,0
20160830-ccc_fpb_script,2016/08/30,ccc_fpb_script,1,0,0:00:00,0,0:00:00,1,0
20160830-ccc_help_script,2016/08/30,ccc_help_script,24,21,0:00:10,10,0:00:57,3,210
20160830-ccc_link_script,2016/08/30,ccc_link_script,0,0,0:00:00,0,0:00:00,0,0
20160830-ccc_media_line_script,2016/08/30,ccc_media_line_script,1,1,0:00:03,3,0:00:03,0,3
20160830-ccc_priority_script,2016/08/30,ccc_priority_script,25,25,0:00:10,10,0:01:37,0,250
20160830-ccc_tax_script,2016/08/30,ccc_tax_script,19,17,0:00:51,51,0:02:27,2,867
20160830-ccc_waste_recycling_script,2016/08/30,ccc_waste_recycling_script,0,0,0:00:00,0,0:00:00,0,0
20160831-ccc_311_calgary_script,2016/08/31,ccc_311_calgary_script,3657,3499,0:00:33,33,0:06:48,158,115467
20160831-ccc_311_lobby_ph_script,2016/08/31,ccc_311_lobby_ph_script,4,4,0:00:06,6,0:00:13,0,24
20160831-ccc_aserv_info_script,2016/08/31,ccc_aserv_info_script,0,0,0:00:00,0,0:00:00,0,0
20160831-ccc_bylaw_script,2016/08/31,ccc_bylaw_script,0,0,0:00:00,0,0:00:00,0,0
20160831-ccc_city_script,2016/08/31,ccc_city_script,19,19,0:00:08,8,0:00:19,0,152
20160831-ccc_cty_online_script,2016/08/31,ccc_cty_online_script,0,0,0:00:00,0,0:00:00,0,0
20160831-ccc_feedback_script,2016/08/31,ccc_feedback_script,0,0,0:00:00,0,0:00:00,0,0
20160831-ccc_fpb_script,2016/08/31,ccc_fpb_script,0,0,0:00:00,0,0:00:00,0,0
20160831-ccc_help_script,2016/08/31,ccc_help_script,20,19,0:00:11,11,0:01:01,1,209
20160831-ccc_link_script,2016/08/31,ccc_link_script,0,0,0:00:00,0,0:00:00,0,0
20160831-ccc_media_line_script,2016/08/31,ccc_media_line_script,1,1,0:00:40,40,0:00:40,0,40
20160831-ccc_priority_script,2016/08/31,ccc_priority_script,37,36,0:00:08,8,0:00:41,1,288
20160831-ccc_tax_script,2016/08/31,ccc_tax_script,29,27,0:00:32,32,0:03:12,2,864
20160831-ccc_waste_recycling_script,2016/08/31,ccc_waste_recycling_script,0,0,0:00:00,0,0:00:00,0,0
20160901-ccc_311_calgary_script,2016/09/01,ccc_311_calgary_script,3423,3295,0:00:27,27,0:06:11,128,88965
20160901-ccc_311_lobby_ph_script,2016/09/01,ccc_311_lobby_ph_script,3,3,0:00:13,13,0:00:25,0,39
20160901-ccc_aserv_info_script,2016/09/01,ccc_aserv_info_script,0,0,0:00:00,0,0:00:00,0,0
20160901-ccc_bylaw_script,2016/09/01,ccc_bylaw_script,0,0,0:00:00,0,0:00:00,0,0
20160901-ccc_city_script,2016/09/01,ccc_city_script,27,27,0:00:11,11,0:01:33,0,297
20160901-ccc_cty_online_script,2016/09/01,ccc_cty_online_script,0,0,0:00:00,0,0:00:00,0,0
20160901-ccc_feedback_script,2016/09/01,ccc_feedback_script,1,0,0:00:00,0,0:00:00,0,0
20160901-ccc_fpb_script,2016/09/01,ccc_fpb_script,0,0,0:00:00,0,0:00:00,0,0
20160901-ccc_help_script,2016/09/01,ccc_help_script,25,23,0:00:16,16,0:01:45,2,368
20160901-ccc_link_script,2016/09/01,ccc_link_script,0,0,0:00:00,0,0:00:00,0,0
20160901-ccc_media_line_script,2016/09/01,ccc_media_line_script,0,0,0:00:00,0,0:00:00,0,0
20160901-ccc_priority_script,2016/09/01,ccc_priority_script,36,35,0:00:10,10,0:01:17,1,350
20160901-ccc_tax_script,2016/09/01,ccc_tax_script,7,7,0:00:24,24,0:01:20,0,168
20160901-ccc_waste_recycling_script,2016/09/01,ccc_waste_recycling_script,0,0,0:00:00,0,0:00:00,0,0
20160902-ccc_311_calgary_script,2016/09/02,ccc_311_calgary_script,2931,2870,0:00:13,13,0:02:59,61,37310
20160902-ccc_311_lobby_ph_script,2016/09/02,ccc_311_lobby_ph_script,1,1,0:00:02,2,0:00:02,0,2
20160902-ccc_aserv_info_script,2016/09/02,ccc_aserv_info_script,0,0,0:00:00,0,0:00:00,0,0
20160902-ccc_bylaw_script,2016/09/02,ccc_bylaw_script,0,0,0:00:00,0,0:00:00,0,0
20160902-ccc_city_script,2016/09/02,ccc_city_script,22,21,0:00:12,12,0:01:09,1,252
20160902-ccc_cty_online_script,2016/09/02,ccc_cty_online_script,0,0,0:00:00,0,0:00:00,0,0
20160902-ccc_feedback_script,2016/09/02,ccc_feedback_script,0,0,0:00:00,0,0:00:00,0,0
20160902-ccc_fpb_script,2016/09/02,ccc_fpb_script,0,0,0:00:00,0,0:00:00,0,0
20160902-ccc_help_script,2016/09/02,ccc_help_script,15,14,0:00:07,7,0:00:14,1,98
20160902-ccc_link_script,2016/09/02,ccc_link_script,0,0,0:00:00,0,0:00:00,0,0
20160902-ccc_media_line_script,2016/09/02,ccc_media_line_script,1,1,0:00:03,3,0:00:03,0,3
20160902-ccc_priority_script,2016/09/02,ccc_priority_script,30,29,0:00:07,7,0:00:29,1,203
20160902-ccc_tax_script,2016/09/02,ccc_tax_script,12,12,0:00:11,11,0:01:12,0,132
20160902-ccc_waste_recycling_script,2016/09/02,ccc_waste_recycling_script,0,0,0:00:00,0,0:00:00,0,0
20160903-ccc_311_calgary_script,2016/09/03,ccc_311_calgary_script,1263,1197,0:00:42,42,0:06:28,66,50274
20160903-ccc_311_lobby_ph_script,2016/09/03,ccc_311_lobby_ph_script,0,0,0:00:00,0,0:00:00,0,0
20160903-ccc_aserv_info_script,2016/09/03,ccc_aserv_info_script,0,0,0:00:00,0,0:00:00,0,0
20160903-ccc_bylaw_script,2016/09/03,ccc_bylaw_script,0,0,0:00:00,0,0:00:00,0,0
20160903-ccc_city_script,2016/09/03,ccc_city_script,0,0,0:00:00,0,0:00:00,0,0
20160903-ccc_cty_online_script,2016/09/03,ccc_cty_online_script,0,0,0:00:00,0,0:00:00,0,0
20160903-ccc_feedback_script,2016/09/03,ccc_feedback_script,0,0,0:00:00,0,0:00:00,0,0
20160903-ccc_fpb_script,2016/09/03,ccc_fpb_script,0,0,0:00:00,0,0:00:00,0,0
20160903-ccc_help_script,2016/09/03,ccc_help_script,5,5,0:00:07,7,0:00:10,0,35
20160903-ccc_link_script,2016/09/03,ccc_link_script,0,0,0:00:00,0,0:00:00,0,0
20160903-ccc_media_line_script,2016/09/03,ccc_media_line_script,0,0,0:00:00,0,0:00:00,0,0
20160903-ccc_priority_script,2016/09/03,ccc_priority_script,11,11,0:00:08,8,0:00:31,0,88
20160903-ccc_tax_script,2016/09/03,ccc_tax_script,0,0,0:00:00,0,0:00:00,0,0
20160903-ccc_waste_recycling_script,2016/09/03,ccc_waste_recycling_script,0,0,0:00:00,0,0:00:00,0,0
20160904-ccc_311_calgary_script,2016/09/04,ccc_311_calgary_script,943,916,0:00:18,18,0:06:31,27,16488
20160904-ccc_311_lobby_ph_script,2016/09/04,ccc_311_lobby_ph_script,0,0,0:00:00,0,0:00:00,0,0
20160904-ccc_aserv_info_script,2016/09/04,ccc_aserv_info_script,0,0,0:00:00,0,0:00:00,0,0
20160904-ccc_bylaw_script,2016/09/04,ccc_bylaw_script,0,0,0:00:00,0,0:00:00,0,0
20160904-ccc_city_script,2016/09/04,ccc_city_script,0,0,0:00:00,0,0:00:00,0,0
20160904-ccc_cty_online_script,2016/09/04,ccc_cty_online_script,0,0,0:00:00,0,0:00:00,0,0
20160904-ccc_feedback_script,2016/09/04,ccc_feedback_script,0,0,0:00:00,0,0:00:00,0,0
20160904-ccc_fpb_script,2016/09/04,ccc_fpb_script,0,0,0:00:00,0,0:00:00,0,0
20160904-ccc_help_script,2016/09/04,ccc_help_script,6,6,0:00:11,11,0:00:31,0,66
20160904-ccc_link_script,2016/09/04,ccc_link_script,0,0,0:00:00,0,0:00:00,0,0
20160904-ccc_media_line_script,2016/09/04,ccc_media_line_script,2,1,0:00:05,5,0:00:05,1,5
20160904-ccc_priority_script,2016/09/04,ccc_priority_script,16,16,0:00:16,16,0:02:23,0,256
20160904-ccc_tax_script,2016/09/04,ccc_tax_script,0,0,0:00:00,0,0:00:00,0,0
20160904-ccc_waste_recycling_script,2016/09/04,ccc_waste_recycling_script,0,0,0:00:00,0,0:00:00,0,0
20160905-ccc_311_calgary_script,2016/09/05,ccc_311_calgary_script,1188,1171,0:00:07,7,0:03:32,17,8197
20160905-ccc_311_lobby_ph_script,2016/09/05,ccc_311_lobby_ph_script,0,0,0:00:00,0,0:00:00,0,0
20160905-ccc_aserv_info_script,2016/09/05,ccc_aserv_info_script,0,0,0:00:00,0,0:00:00,0,0
20160905-ccc_bylaw_script,2016/09/05,ccc_bylaw_script,0,0,0:00:00,0,0:00:00,0,0
20160905-ccc_city_script,2016/09/05,ccc_city_script,0,0,0:00:00,0,0:00:00,0,0
20160905-ccc_cty_online_script,2016/09/05,ccc_cty_online_script,0,0,0:00:00,0,0:00:00,0,0
20160905-ccc_feedback_script,2016/09/05,ccc_feedback_script,0,0,0:00:00,0,0:00:00,0,0
20160905-ccc_fpb_script,2016/09/05,ccc_fpb_script,0,0,0:00:00,0,0:00:00,0,0
20160905-ccc_help_script,2016/09/05,ccc_help_script,4,3,0:00:04,4,0:00:05,1,12
20160905-ccc_link_script,2016/09/05,ccc_link_script,0,0,0:00:00,0,0:00:00,0,0
20160905-ccc_media_line_script,2016/09/05,ccc_media_line_script,3,3,0:00:09,9,0:00:19,0,27
20160905-ccc_priority_script,2016/09/05,ccc_priority_script,16,16,0:00:05,5,0:00:10,0,80
20160905-ccc_tax_script,2016/09/05,ccc_tax_script,0,0,0:00:00,0,0:00:00,0,0
20160905-ccc_waste_recycling_script,2016/09/05,ccc_waste_recycling_script,0,0,0:00:00,0,0:00:00,0,0
20160906-ccc_311_calgary_script,2016/09/06,ccc_311_calgary_script,4285,4026,0:00:48,48,0:05:26,259,193248
20160906-ccc_311_lobby_ph_script,2016/09/06,ccc_311_lobby_ph_script,3,2,0:00:03,3,0:00:05,1,6
20160906-ccc_aserv_info_script,2016/09/06,ccc_aserv_info_script,0,0,0:00:00,0,0:00:00,0,0
20160906-ccc_bylaw_script,2016/09/06,ccc_bylaw_script,0,0,0:00:00,0,0:00:00,0,0
20160906-ccc_city_script,2016/09/06,ccc_city_script,29,29,0:00:13,13,0:02:21,0,377
20160906-ccc_cty_online_script,2016/09/06,ccc_cty_online_script,0,0,0:00:00,0,0:00:00,0,0
20160906-ccc_feedback_script,2016/09/06,ccc_feedback_script,0,0,0:00:00,0,0:00:00,0,0
20160906-ccc_fpb_script,2016/09/06,ccc_fpb_script,4,4,0:00:59,59,0:01:31,0,236
20160906-ccc_help_script,2016/09/06,ccc_help_script,21,20,0:00:09,9,0:00:36,1,180
20160906-ccc_link_script,2016/09/06,ccc_link_script,0,0,0:00:00,0,0:00:00,0,0
20160906-ccc_media_line_script,2016/09/06,ccc_media_line_script,3,1,0:00:02,2,0:00:02,2,2
20160906-ccc_priority_script,2016/09/06,ccc_priority_script,35,35,0:00:11,11,0:00:41,0,385
20160906-ccc_tax_script,2016/09/06,ccc_tax_script,25,23,0:01:03,63,0:03:08,2,1449
20160906-ccc_waste_recycling_script,2016/09/06,ccc_waste_recycling_script,0,0,0:00:00,0,0:00:00,0,0
20160907-ccc_311_calgary_script,2016/09/07,ccc_311_calgary_script,3822,3378,0:01:40,100,0:07:47,444,337800
20160907-ccc_311_lobby_ph_script,2016/09/07,ccc_311_lobby_ph_script,1,1,0:00:04,4,0:00:04,0,4
20160907-ccc_aserv_info_script,2016/09/07,ccc_aserv_info_script,0,0,0:00:00,0,0:00:00,0,0
20160907-ccc_bylaw_script,2016/09/07,ccc_bylaw_script,0,0,0:00:00,0,0:00:00,0,0
20160907-ccc_city_script,2016/09/07,ccc_city_script,16,15,0:00:14,14,0:00:27,1,210
20160907-ccc_cty_online_script,2016/09/07,ccc_cty_online_script,0,0,0:00:00,0,0:00:00,0,0
20160907-ccc_feedback_script,2016/09/07,ccc_feedback_script,0,0,0:00:00,0,0:00:00,0,0
20160907-ccc_fpb_script,2016/09/07,ccc_fpb_script,0,0,0:00:00,0,0:00:00,0,0
20160907-ccc_help_script,2016/09/07,ccc_help_script,26,26,0:00:09,9,0:00:25,0,234
20160907-ccc_link_script,2016/09/07,ccc_link_script,0,0,0:00:00,0,0:00:00,0,0
20160907-ccc_media_line_script,2016/09/07,ccc_media_line_script,1,1,0:00:10,10,0:00:10,0,10
20160907-ccc_priority_script,2016/09/07,ccc_priority_script,48,42,0:00:10,10,0:01:03,2,420
20160907-ccc_tax_script,2016/09/07,ccc_tax_script,20,19,0:02:12,132,0:07:13,1,2508
20160907-ccc_waste_recycling_script,2016/09/07,ccc_waste_recycling_script,0,0,0:00:00,0,0:00:00,0,0
20160908-ccc_311_calgary_script,2016/09/08,ccc_311_calgary_script,3410,3216,0:00:46,46,0:06:22,194,147936
20160908-ccc_311_lobby_ph_script,2016/09/08,ccc_311_lobby_ph_script,2,2,0:00:02,2,0:00:03,0,4
20160908-ccc_aserv_info_script,2016/09/08,ccc_aserv_info_script,0,0,0:00:00,0,0:00:00,0,0
20160908-ccc_bylaw_script,2016/09/08,ccc_bylaw_script,0,0,0:00:00,0,0:00:00,0,0
20160908-ccc_city_script,2016/09/08,ccc_city_script,14,13,0:00:14,14,0:00:58,1,182
20160908-ccc_cty_online_script,2016/09/08,ccc_cty_online_script,0,0,0:00:00,0,0:00:00,0,0
20160908-ccc_feedback_script,2016/09/08,ccc_feedback_script,0,0,0:00:00,0,0:00:00,0,0
20160908-ccc_fpb_script,2016/09/08,ccc_fpb_script,1,1,0:00:03,3,0:00:03,0,3
20160908-ccc_help_script,2016/09/08,ccc_help_script,16,14,0:00:11,11,0:00:43,2,154
20160908-ccc_link_script,2016/09/08,ccc_link_script,0,0,0:00:00,0,0:00:00,0,0
20160908-ccc_media_line_script,2016/09/08,ccc_media_line_script,2,2,0:00:08,8,0:00:13,0,16
20160908-ccc_priority_script,2016/09/08,ccc_priority_script,23,23,0:00:07,7,0:00:25,0,161
20160908-ccc_tax_script,2016/09/08,ccc_tax_script,15,14,0:00:37,37,0:02:15,1,518
20160908-ccc_waste_recycling_script,2016/09/08,ccc_waste_recycling_script,0,0,0:00:00,0,0:00:00,0,0
20160909-ccc_311_calgary_script,2016/09/09,ccc_311_calgary_script,3148,3091,0:00:15,15,0:06:45,57,46365
20160909-ccc_311_lobby_ph_script,2016/09/09,ccc_311_lobby_ph_script,4,4,0:00:05,5,0:00:10,0,20
20160909-ccc_aserv_info_script,2016/09/09,ccc_aserv_info_script,0,0,0:00:00,0,0:00:00,0,0
20160909-ccc_bylaw_script,2016/09/09,ccc_bylaw_script,0,0,0:00:00,0,0:00:00,0,0
20160909-ccc_city_script,2016/09/09,ccc_city_script,19,18,0:00:12,12,0:00:43,1,216
20160909-ccc_cty_online_script,2016/09/09,ccc_cty_online_script,0,0,0:00:00,0,0:00:00,0,0
20160909-ccc_feedback_script,2016/09/09,ccc_feedback_script,0,0,0:00:00,0,0:00:00,0,0
20160909-ccc_fpb_script,2016/09/09,ccc_fpb_script,2,2,0:00:31,31,0:00:58,0,62
20160909-ccc_help_script,2016/09/09,ccc_help_script,22,22,0:00:06,6,0:00:12,0,132
20160909-ccc_link_script,2016/09/09,ccc_link_script,0,0,0:00:00,0,0:00:00,0,0
20160909-ccc_media_line_script,2016/09/09,ccc_media_line_script,0,0,0:00:00,0,0:00:00,0,0
20160909-ccc_priority_script,2016/09/09,ccc_priority_script,24,23,0:00:06,6,0:00:24,1,138
20160909-ccc_tax_script,2016/09/09,ccc_tax_script,20,20,0:00:14,14,0:01:20,0,280
20160909-ccc_waste_recycling_script,2016/09/09,ccc_waste_recycling_script,0,0,0:00:00,0,0:00:00,0,0
20160910-ccc_311_calgary_script,2016/09/10,ccc_311_calgary_script,1362,1253,0:00:55,55,0:21:52,108,68915
20160910-ccc_311_lobby_ph_script,2016/09/10,ccc_311_lobby_ph_script,0,0,0:00:00,0,0:00:00,0,0
20160910-ccc_aserv_info_script,2016/09/10,ccc_aserv_info_script,0,0,0:00:00,0,0:00:00,0,0
20160910-ccc_bylaw_script,2016/09/10,ccc_bylaw_script,0,0,0:00:00,0,0:00:00,0,0
20160910-ccc_city_script,2016/09/10,ccc_city_script,0,0,0:00:00,0,0:00:00,0,0
20160910-ccc_cty_online_script,2016/09/10,ccc_cty_online_script,0,0,0:00:00,0,0:00:00,0,0
20160910-ccc_feedback_script,2016/09/10,ccc_feedback_script,0,0,0:00:00,0,0:00:00,0,0
20160910-ccc_fpb_script,2016/09/10,ccc_fpb_script,0,0,0:00:00,0,0:00:00,0,0
20160910-ccc_help_script,2016/09/10,ccc_help_script,11,10,0:00:08,8,0:00:17,1,80
20160910-ccc_link_script,2016/09/10,ccc_link_script,0,0,0:00:00,0,0:00:00,0,0
20160910-ccc_media_line_script,2016/09/10,ccc_media_line_script,0,0,0:00:00,0,0:00:00,0,0
20160910-ccc_priority_script,2016/09/10,ccc_priority_script,32,32,0:00:35,35,0:03:45,0,1120
20160910-ccc_tax_script,2016/09/10,ccc_tax_script,0,0,0:00:00,0,0:00:00,0,0
20160910-ccc_waste_recycling_script,2016/09/10,ccc_waste_recycling_script,0,0,0:00:00,0,0:00:00,0,0
20160911-ccc_311_calgary_script,2016/09/11,ccc_311_calgary_script,901,885,0:00:11,11,0:05:22,16,9735
20160911-ccc_311_lobby_ph_script,2016/09/11,ccc_311_lobby_ph_script,0,0,0:00:00,0,0:00:00,0,0
20160911-ccc_aserv_info_script,2016/09/11,ccc_aserv_info_script,0,0,0:00:00,0,0:00:00,0,0
20160911-ccc_bylaw_script,2016/09/11,ccc_bylaw_script,0,0,0:00:00,0,0:00:00,0,0
20160911-ccc_city_script,2016/09/11,ccc_city_script,0,0,0:00:00,0,0:00:00,0,0
20160911-ccc_cty_online_script,2016/09/11,ccc_cty_online_script,0,0,0:00:00,0,0:00:00,0,0
20160911-ccc_feedback_script,2016/09/11,ccc_feedback_script,0,0,0:00:00,0,0:00:00,0,0
20160911-ccc_fpb_script,2016/09/11,ccc_fpb_script,0,0,0:00:00,0,0:00:00,0,0
20160911-ccc_help_script,2016/09/11,ccc_help_script,5,5,0:00:04,4,0:00:09,0,20
20160911-ccc_link_script,2016/09/11,ccc_link_script,0,0,0:00:00,0,0:00:00,0,0
20160911-ccc_media_line_script,2016/09/11,ccc_media_line_script,0,0,0:00:00,0,0:00:00,0,0
20160911-ccc_priority_script,2016/09/11,ccc_priority_script,15,15,0:00:13,13,0:02:12,0,195
20160911-ccc_tax_script,2016/09/11,ccc_tax_script,2,2,0:00:02,2,0:00:02,0,4
20160911-ccc_waste_recycling_script,2016/09/11,ccc_waste_recycling_script,0,0,0:00:00,0,0:00:00,0,0
20160912-ccc_311_calgary_script,2016/09/12,ccc_311_calgary_script,3642,3531,0:00:23,23,0:08:15,110,81213
20160912-ccc_311_lobby_ph_script,2016/09/12,ccc_311_lobby_ph_script,0,0,0:00:00,0,0:00:00,0,0
20160912-ccc_aserv_info_script,2016/09/12,ccc_aserv_info_script,0,0,0:00:00,0,0:00:00,0,0
20160912-ccc_bylaw_script,2016/09/12,ccc_bylaw_script,0,0,0:00:00,0,0:00:00,0,0
20160912-ccc_city_script,2016/09/12,ccc_city_script,25,25,0:00:08,8,0:00:39,0,200
20160912-ccc_cty_online_script,2016/09/12,ccc_cty_online_script,0,0,0:00:00,0,0:00:00,0,0
20160912-ccc_feedback_script,2016/09/12,ccc_feedback_script,0,0,0:00:00,0,0:00:00,0,0
20160912-ccc_fpb_script,2016/09/12,ccc_fpb_script,3,3,0:00:23,23,0:00:54,0,69
20160912-ccc_help_script,2016/09/12,ccc_help_script,23,22,0:00:10,10,0:01:06,1,220
20160912-ccc_link_script,2016/09/12,ccc_link_script,0,0,0:00:00,0,0:00:00,0,0
20160912-ccc_media_line_script,2016/09/12,ccc_media_line_script,1,1,0:00:06,6,0:00:06,0,6
20160912-ccc_priority_script,2016/09/12,ccc_priority_script,19,18,0:00:12,12,0:01:17,1,216
20160912-ccc_tax_script,2016/09/12,ccc_tax_script,16,16,0:00:22,22,0:01:16,0,352
20160912-ccc_waste_recycling_script,2016/09/12,ccc_waste_recycling_script,0,0,0:00:00,0,0:00:00,0,0
20160913-ccc_311_calgary_script,2016/09/13,ccc_311_calgary_script,3322,3246,0:00:15,15,0:06:18,77,48690
20160913-ccc_311_lobby_ph_script,2016/09/13,ccc_311_lobby_ph_script,2,1,0:00:02,2,0:00:02,1,2
20160913-ccc_aserv_info_script,2016/09/13,ccc_aserv_info_script,0,0,0:00:00,0,0:00:00,0,0
20160913-ccc_bylaw_script,2016/09/13,ccc_bylaw_script,0,0,0:00:00,0,0:00:00,0,0
20160913-ccc_city_script,2016/09/13,ccc_city_script,23,22,0:00:06,6,0:00:20,1,132
20160913-ccc_cty_online_script,2016/09/13,ccc_cty_online_script,0,0,0:00:00,0,0:00:00,0,0
20160913-ccc_feedback_script,2016/09/13,ccc_feedback_script,0,0,0:00:00,0,0:00:00,0,0
20160913-ccc_fpb_script,2016/09/13,ccc_fpb_script,0,0,0:00:00,0,0:00:00,0,0
20160913-ccc_help_script,2016/09/13,ccc_help_script,27,26,0:00:08,8,0:00:41,1,208
20160913-ccc_link_script,2016/09/13,ccc_link_script,0,0,0:00:00,0,0:00:00,0,0
20160913-ccc_media_line_script,2016/09/13,ccc_media_line_script,1,1,0:00:12,12,0:00:12,0,12
20160913-ccc_priority_script,2016/09/13,ccc_priority_script,24,23,0:00:06,6,0:00:21,1,138
20160913-ccc_tax_script,2016/09/13,ccc_tax_script,18,18,0:00:07,7,0:00:22,0,126
20160913-ccc_waste_recycling_script,2016/09/13,ccc_waste_recycling_script,0,0,0:00:00,0,0:00:00,0,0
20160914-ccc_311_calgary_script,2016/09/14,ccc_311_calgary_script,3383,3226,0:00:32,32,0:07:23,157,103232
20160914-ccc_311_lobby_ph_script,2016/09/14,ccc_311_lobby_ph_script,3,3,0:00:04,4,0:00:06,0,12
20160914-ccc_aserv_info_script,2016/09/14,ccc_aserv_info_script,0,0,0:00:00,0,0:00:00,0,0
20160914-ccc_bylaw_script,2016/09/14,ccc_bylaw_script,0,0,0:00:00,0,0:00:00,0,0
20160914-ccc_city_script,2016/09/14,ccc_city_script,25,25,0:00:07,7,0:00:21,0,175
20160914-ccc_cty_online_script,2016/09/14,ccc_cty_online_script,0,0,0:00:00,0,0:00:00,0,0
20160914-ccc_feedback_script,2016/09/14,ccc_feedback_script,0,0,0:00:00,0,0:00:00,0,0
20160914-ccc_fpb_script,2016/09/14,ccc_fpb_script,0,0,0:00:00,0,0:00:00,0,0
20160914-ccc_help_script,2016/09/14,ccc_help_script,43,39,0:00:06,6,0:00:28,4,234
20160914-ccc_link_script,2016/09/14,ccc_link_script,0,0,0:00:00,0,0:00:00,0,0
20160914-ccc_media_line_script,2016/09/14,ccc_media_line_script,1,1,0:00:07,7,0:00:07,0,7
20160914-ccc_priority_script,2016/09/14,ccc_priority_script,33,32,0:00:07,7,0:00:35,1,224
20160914-ccc_tax_script,2016/09/14,ccc_tax_script,11,11,0:00:09,9,0:00:48,0,99
20160914-ccc_waste_recycling_script,2016/09/14,ccc_waste_recycling_script,0,0,0:00:00,0,0:00:00,0,0
20160915-ccc_311_calgary_script,2016/09/15,ccc_311_calgary_script,3302,3219,0:00:14,14,0:08:10,82,45066
20160915-ccc_311_lobby_ph_script,2016/09/15,ccc_311_lobby_ph_script,4,3,0:00:04,4,0:00:07,1,12
20160915-ccc_aserv_info_script,2016/09/15,ccc_aserv_info_script,0,0,0:00:00,0,0:00:00,0,0
20160915-ccc_bylaw_script,2016/09/15,ccc_bylaw_script,0,0,0:00:00,0,0:00:00,0,0
20160915-ccc_city_script,2016/09/15,ccc_city_script,28,28,0:00:05,5,0:00:10,0,140
20160915-ccc_cty_online_script,2016/09/15,ccc_cty_online_script,0,0,0:00:00,0,0:00:00,0,0
20160915-ccc_feedback_script,2016/09/15,ccc_feedback_script,0,0,0:00:00,0,0:00:00,0,0
20160915-ccc_fpb_script,2016/09/15,ccc_fpb_script,1,1,0:00:03,3,0:00:03,0,3
20160915-ccc_help_script,2016/09/15,ccc_help_script,32,31,0:00:13,13,0:02:27,1,403
20160915-ccc_link_script,2016/09/15,ccc_link_script,0,0,0:00:00,0,0:00:00,0,0
20160915-ccc_media_line_script,2016/09/15,ccc_media_line_script,6,4,0:00:10,10,0:00:19,2,40
20160915-ccc_priority_script,2016/09/15,ccc_priority_script,32,32,0:00:06,6,0:00:21,0,192
20160915-ccc_tax_script,2016/09/15,ccc_tax_script,15,15,0:00:08,8,0:00:17,0,120
20160915-ccc_waste_recycling_script,2016/09/15,ccc_waste_recycling_script,0,0,0:00:00,0,0:00:00,0,0
20160916-ccc_311_calgary_script,2016/09/16,ccc_311_calgary_script,3083,2886,0:00:43,43,0:07:50,198,124098
20160916-ccc_311_lobby_ph_script,2016/09/16,ccc_311_lobby_ph_script,4,4,0:00:13,13,0:00:30,0,52
20160916-ccc_aserv_info_script,2016/09/16,ccc_aserv_info_script,0,0,0:00:00,0,0:00:00,0,0
20160916-ccc_bylaw_script,2016/09/16,ccc_bylaw_script,0,0,0:00:00,0,0:00:00,0,0
20160916-ccc_city_script,2016/09/16,ccc_city_script,33,30,0:00:19,19,0:02:59,3,570
20160916-ccc_cty_online_script,2016/09/16,ccc_cty_online_script,0,0,0:00:00,0,0:00:00,0,0
20160916-ccc_feedback_script,2016/09/16,ccc_feedback_script,0,0,0:00:00,0,0:00:00,0,0
20160916-ccc_fpb_script,2016/09/16,ccc_fpb_script,1,1,0:00:49,49,0:00:49,0,49
20160916-ccc_help_script,2016/09/16,ccc_help_script,22,21,0:00:06,6,0:00:30,1,126
20160916-ccc_link_script,2016/09/16,ccc_link_script,0,0,0:00:00,0,0:00:00,0,0
20160916-ccc_media_line_script,2016/09/16,ccc_media_line_script,2,2,0:00:09,9,0:00:12,0,18
20160916-ccc_priority_script,2016/09/16,ccc_priority_script,38,37,0:00:07,7,0:00:33,1,259
20160916-ccc_tax_script,2016/09/16,ccc_tax_script,4,4,0:02:00,120,0:05:48,0,480
20160916-ccc_waste_recycling_script,2016/09/16,ccc_waste_recycling_script,0,0,0:00:00,0,0:00:00,0,0
20160917-ccc_311_calgary_script,2016/09/17,ccc_311_calgary_script,1395,1302,0:00:33,33,0:09:04,93,42966
20160917-ccc_311_lobby_ph_script,2016/09/17,ccc_311_lobby_ph_script,0,0,0:00:00,0,0:00:00,0,0
20160917-ccc_aserv_info_script,2016/09/17,ccc_aserv_info_script,0,0,0:00:00,0,0:00:00,0,0
20160917-ccc_bylaw_script,2016/09/17,ccc_bylaw_script,0,0,0:00:00,0,0:00:00,0,0
20160917-ccc_city_script,2016/09/17,ccc_city_script,0,0,0:00:00,0,0:00:00,0,0
20160917-ccc_cty_online_script,2016/09/17,ccc_cty_online_script,0,0,0:00:00,0,0:00:00,0,0
20160917-ccc_feedback_script,2016/09/17,ccc_feedback_script,0,0,0:00:00,0,0:00:00,0,0
20160917-ccc_fpb_script,2016/09/17,ccc_fpb_script,0,0,0:00:00,0,0:00:00,0,0
20160917-ccc_help_script,2016/09/17,ccc_help_script,2,2,0:00:45,45,0:01:21,0,90
20160917-ccc_link_script,2016/09/17,ccc_link_script,0,0,0:00:00,0,0:00:00,0,0
20160917-ccc_media_line_script,2016/09/17,ccc_media_line_script,10,10,0:00:10,10,0:00:25,0,100
20160917-ccc_priority_script,2016/09/17,ccc_priority_script,25,24,0:00:13,13,0:01:49,1,312
20160917-ccc_tax_script,2016/09/17,ccc_tax_script,1,1,0:00:34,34,0:00:34,0,34
20160917-ccc_waste_recycling_script,2016/09/17,ccc_waste_recycling_script,0,0,0:00:00,0,0:00:00,0,0
20160918-ccc_311_calgary_script,2016/09/18,ccc_311_calgary_script,1110,1039,0:00:28,28,0:06:09,71,29092
20160918-ccc_311_lobby_ph_script,2016/09/18,ccc_311_lobby_ph_script,0,0,0:00:00,0,0:00:00,0,0
20160918-ccc_aserv_info_script,2016/09/18,ccc_aserv_info_script,0,0,0:00:00,0,0:00:00,0,0
20160918-ccc_bylaw_script,2016/09/18,ccc_bylaw_script,0,0,0:00:00,0,0:00:00,0,0
20160918-ccc_city_script,2016/09/18,ccc_city_script,0,0,0:00:00,0,0:00:00,0,0
20160918-ccc_cty_online_script,2016/09/18,ccc_cty_online_script,0,0,0:00:00,0,0:00:00,0,0
20160918-ccc_feedback_script,2016/09/18,ccc_feedback_script,0,0,0:00:00,0,0:00:00,0,0
20160918-ccc_fpb_script,2016/09/18,ccc_fpb_script,0,0,0:00:00,0,0:00:00,0,0
20160918-ccc_help_script,2016/09/18,ccc_help_script,4,3,0:00:19,19,0:00:47,1,57
20160918-ccc_link_script,2016/09/18,ccc_link_script,0,0,0:00:00,0,0:00:00,0,0
20160918-ccc_media_line_script,2016/09/18,ccc_media_line_script,4,3,0:00:04,4,0:00:07,1,12
20160918-ccc_priority_script,2016/09/18,ccc_priority_script,15,14,0:00:15,15,0:01:12,1,210
20160918-ccc_tax_script,2016/09/18,ccc_tax_script,1,1,0:00:04,4,0:00:04,0,4
20160918-ccc_waste_recycling_script,2016/09/18,ccc_waste_recycling_script,0,0,0:00:00,0,0:00:00,0,0
20160919-ccc_311_calgary_script,2016/09/19,ccc_311_calgary_script,3479,3301,0:00:38,38,0:07:23,178,125438
20160919-ccc_311_lobby_ph_script,2016/09/19,ccc_311_lobby_ph_script,6,5,0:00:10,10,0:00:19,1,50
20160919-ccc_aserv_info_script,2016/09/19,ccc_aserv_info_script,0,0,0:00:00,0,0:00:00,0,0
20160919-ccc_bylaw_script,2016/09/19,ccc_bylaw_script,0,0,0:00:00,0,0:00:00,0,0
20160919-ccc_city_script,2016/09/19,ccc_city_script,14,14,0:00:09,9,0:00:36,0,126
20160919-ccc_cty_online_script,2016/09/19,ccc_cty_online_script,0,0,0:00:00,0,0:00:00,0,0
20160919-ccc_feedback_script,2016/09/19,ccc_feedback_script,0,0,0:00:00,0,0:00:00,0,0
20160919-ccc_fpb_script,2016/09/19,ccc_fpb_script,0,0,0:00:00,0,0:00:00,0,0
20160919-ccc_help_script,2016/09/19,ccc_help_script,39,38,0:00:09,9,0:01:13,1,342
20160919-ccc_link_script,2016/09/19,ccc_link_script,0,0,0:00:00,0,0:00:00,0,0
20160919-ccc_media_line_script,2016/09/19,ccc_media_line_script,3,3,0:00:04,4,0:00:07,0,12
20160919-ccc_priority_script,2016/09/19,ccc_priority_script,24,23,0:00:12,12,0:00:47,1,276
20160919-ccc_tax_script,2016/09/19,ccc_tax_script,17,17,0:00:06,6,0:00:38,0,102
20160919-ccc_waste_recycling_script,2016/09/19,ccc_waste_recycling_script,0,0,0:00:00,0,0:00:00,0,0
20160920-ccc_311_calgary_script,2016/09/20,ccc_311_calgary_script,3078,2986,0:00:19,19,0:06:36,92,56734
20160920-ccc_311_lobby_ph_script,2016/09/20,ccc_311_lobby_ph_script,5,5,0:00:05,5,0:00:07,0,25
20160920-ccc_aserv_info_script,2016/09/20,ccc_aserv_info_script,0,0,0:00:00,0,0:00:00,0,0
20160920-ccc_bylaw_script,2016/09/20,ccc_bylaw_script,0,0,0:00:00,0,0:00:00,0,0
20160920-ccc_city_script,2016/09/20,ccc_city_script,18,18,0:00:07,7,0:00:17,0,126
20160920-ccc_cty_online_script,2016/09/20,ccc_cty_online_script,0,0,0:00:00,0,0:00:00,0,0
20160920-ccc_feedback_script,2016/09/20,ccc_feedback_script,0,0,0:00:00,0,0:00:00,0,0
20160920-ccc_fpb_script,2016/09/20,ccc_fpb_script,2,1,0:00:03,3,0:00:03,1,3
20160920-ccc_help_script,2016/09/20,ccc_help_script,16,16,0:00:12,12,0:01:13,0,192
20160920-ccc_link_script,2016/09/20,ccc_link_script,0,0,0:00:00,0,0:00:00,0,0
20160920-ccc_media_line_script,2016/09/20,ccc_media_line_script,5,4,0:00:08,8,0:00:14,1,32
20160920-ccc_priority_script,2016/09/20,ccc_priority_script,22,22,0:00:13,13,0:01:43,0,286
20160920-ccc_tax_script,2016/09/20,ccc_tax_script,28,27,0:00:20,20,0:01:31,1,540
20160920-ccc_waste_recycling_script,2016/09/20,ccc_waste_recycling_script,0,0,0:00:00,0,0:00:00,0,0
20160921-ccc_311_calgary_script,2016/09/21,ccc_311_calgary_script,3152,2979,0:00:34,34,0:07:13,173,101286
20160921-ccc_311_lobby_ph_script,2016/09/21,ccc_311_lobby_ph_script,0,0,0:00:00,0,0:00:00,0,0
20160921-ccc_aserv_info_script,2016/09/21,ccc_aserv_info_script,0,0,0:00:00,0,0:00:00,0,0
20160921-ccc_bylaw_script,2016/09/21,ccc_bylaw_script,0,0,0:00:00,0,0:00:00,0,0
20160921-ccc_city_script,2016/09/21,ccc_city_script,15,15,0:00:09,9,0:00:25,0,135
20160921-ccc_cty_online_script,2016/09/21,ccc_cty_online_script,0,0,0:00:00,0,0:00:00,0,0
20160921-ccc_feedback_script,2016/09/21,ccc_feedback_script,0,0,0:00:00,0,0:00:00,0,0
20160921-ccc_fpb_script,2016/09/21,ccc_fpb_script,2,2,0:00:03,3,0:00:03,0,6
20160921-ccc_help_script,2016/09/21,ccc_help_script,22,22,0:00:07,7,0:00:27,0,154
20160921-ccc_link_script,2016/09/21,ccc_link_script,0,0,0:00:00,0,0:00:00,0,0
20160921-ccc_media_line_script,2016/09/21,ccc_media_line_script,1,0,0:00:00,0,0:00:00,1,0
20160921-ccc_priority_script,2016/09/21,ccc_priority_script,29,28,0:00:18,18,0:02:52,1,504
20160921-ccc_tax_script,2016/09/21,ccc_tax_script,22,21,0:00:26,26,0:02:01,1,546
20160921-ccc_waste_recycling_script,2016/09/21,ccc_waste_recycling_script,0,0,0:00:00,0,0:00:00,0,0
20160922-ccc_311_calgary_script,2016/09/22,ccc_311_calgary_script,2852,2781,0:00:17,17,0:05:25,71,47277
20160922-ccc_311_lobby_ph_script,2016/09/22,ccc_311_lobby_ph_script,1,1,0:00:02,2,0:00:02,0,2
20160922-ccc_aserv_info_script,2016/09/22,ccc_aserv_info_script,0,0,0:00:00,0,0:00:00,0,0
20160922-ccc_bylaw_script,2016/09/22,ccc_bylaw_script,0,0,0:00:00,0,0:00:00,0,0
20160922-ccc_city_script,2016/09/22,ccc_city_script,11,11,0:00:05,5,0:00:08,0,55
20160922-ccc_cty_online_script,2016/09/22,ccc_cty_online_script,0,0,0:00:00,0,0:00:00,0,0
20160922-ccc_feedback_script,2016/09/22,ccc_feedback_script,0,0,0:00:00,0,0:00:00,0,0
20160922-ccc_fpb_script,2016/09/22,ccc_fpb_script,0,0,0:00:00,0,0:00:00,0,0
20160922-ccc_help_script,2016/09/22,ccc_help_script,17,17,0:00:06,6,0:00:29,0,102
20160922-ccc_link_script,2016/09/22,ccc_link_script,0,0,0:00:00,0,0:00:00,0,0
20160922-ccc_media_line_script,2016/09/22,ccc_media_line_script,0,0,0:00:00,0,0:00:00,0,0
20160922-ccc_priority_script,2016/09/22,ccc_priority_script,26,26,0:00:07,7,0:00:22,0,182
20160922-ccc_tax_script,2016/09/22,ccc_tax_script,15,14,0:00:11,11,0:00:57,1,154
20160922-ccc_waste_recycling_script,2016/09/22,ccc_waste_recycling_script,0,0,0:00:00,0,0:00:00,0,0
20160923-ccc_311_calgary_script,2016/09/23,ccc_311_calgary_script,2939,2800,0:00:33,33,0:05:21,138,92400
20160923-ccc_311_lobby_ph_script,2016/09/23,ccc_311_lobby_ph_script,5,5,0:00:10,10,0:00:31,0,50
20160923-ccc_aserv_info_script,2016/09/23,ccc_aserv_info_script,0,0,0:00:00,0,0:00:00,0,0
20160923-ccc_bylaw_script,2016/09/23,ccc_bylaw_script,0,0,0:00:00,0,0:00:00,0,0
20160923-ccc_city_script,2016/09/23,ccc_city_script,12,10,0:00:19,19,0:01:10,2,190
20160923-ccc_cty_online_script,2016/09/23,ccc_cty_online_script,0,0,0:00:00,0,0:00:00,0,0
20160923-ccc_feedback_script,2016/09/23,ccc_feedback_script,0,0,0:00:00,0,0:00:00,0,0
20160923-ccc_fpb_script,2016/09/23,ccc_fpb_script,0,0,0:00:00,0,0:00:00,0,0
20160923-ccc_help_script,2016/09/23,ccc_help_script,12,11,0:00:05,5,0:00:12,1,55
20160923-ccc_link_script,2016/09/23,ccc_link_script,0,0,0:00:00,0,0:00:00,0,0
20160923-ccc_media_line_script,2016/09/23,ccc_media_line_script,0,0,0:00:00,0,0:00:00,0,0
20160923-ccc_priority_script,2016/09/23,ccc_priority_script,15,14,0:00:05,5,0:00:10,1,70
20160923-ccc_tax_script,2016/09/23,ccc_tax_script,12,11,0:00:37,37,0:02:43,1,407
20160923-ccc_waste_recycling_script,2016/09/23,ccc_waste_recycling_script,0,0,0:00:00,0,0:00:00,0,0
20160924-ccc_311_calgary_script,2016/09/24,ccc_311_calgary_script,1186,1154,0:00:13,13,0:06:58,32,15002
20160924-ccc_311_lobby_ph_script,2016/09/24,ccc_311_lobby_ph_script,0,0,0:00:00,0,0:00:00,0,0
20160924-ccc_aserv_info_script,2016/09/24,ccc_aserv_info_script,0,0,0:00:00,0,0:00:00,0,0
20160924-ccc_bylaw_script,2016/09/24,ccc_bylaw_script,0,0,0:00:00,0,0:00:00,0,0
20160924-ccc_city_script,2016/09/24,ccc_city_script,0,0,0:00:00,0,0:00:00,0,0
20160924-ccc_cty_online_script,2016/09/24,ccc_cty_online_script,0,0,0:00:00,0,0:00:00,0,0
20160924-ccc_feedback_script,2016/09/24,ccc_feedback_script,0,0,0:00:00,0,0:00:00,0,0
20160924-ccc_fpb_script,2016/09/24,ccc_fpb_script,0,0,0:00:00,0,0:00:00,0,0
20160924-ccc_help_script,2016/09/24,ccc_help_script,8,5,0:00:04,4,0:00:06,3,20
20160924-ccc_link_script,2016/09/24,ccc_link_script,0,0,0:00:00,0,0:00:00,0,0
20160924-ccc_media_line_script,2016/09/24,ccc_media_line_script,3,3,0:00:04,4,0:00:07,0,12
20160924-ccc_priority_script,2016/09/24,ccc_priority_script,15,15,0:00:06,6,0:00:24,0,90
20160924-ccc_tax_script,2016/09/24,ccc_tax_script,0,0,0:00:00,0,0:00:00,0,0
20160924-ccc_waste_recycling_script,2016/09/24,ccc_waste_recycling_script,0,0,0:00:00,0,0:00:00,0,0
20160925-ccc_311_calgary_script,2016/09/25,ccc_311_calgary_script,914,874,0:00:18,18,0:05:50,41,15732
20160925-ccc_311_lobby_ph_script,2016/09/25,ccc_311_lobby_ph_script,0,0,0:00:00,0,0:00:00,0,0
20160925-ccc_aserv_info_script,2016/09/25,ccc_aserv_info_script,0,0,0:00:00,0,0:00:00,0,0
20160925-ccc_bylaw_script,2016/09/25,ccc_bylaw_script,0,0,0:00:00,0,0:00:00,0,0
20160925-ccc_city_script,2016/09/25,ccc_city_script,0,0,0:00:00,0,0:00:00,0,0
20160925-ccc_cty_online_script,2016/09/25,ccc_cty_online_script,0,0,0:00:00,0,0:00:00,0,0
20160925-ccc_feedback_script,2016/09/25,ccc_feedback_script,0,0,0:00:00,0,0:00:00,0,0
20160925-ccc_fpb_script,2016/09/25,ccc_fpb_script,0,0,0:00:00,0,0:00:00,0,0
20160925-ccc_help_script,2016/09/25,ccc_help_script,5,5,0:00:31,31,0:02:10,0,155
20160925-ccc_link_script,2016/09/25,ccc_link_script,0,0,0:00:00,0,0:00:00,0,0
20160925-ccc_media_line_script,2016/09/25,ccc_media_line_script,0,0,0:00:00,0,0:00:00,0,0
20160925-ccc_priority_script,2016/09/25,ccc_priority_script,18,17,0:00:12,12,0:01:41,1,204
20160925-ccc_tax_script,2016/09/25,ccc_tax_script,0,0,0:00:00,0,0:00:00,0,0
20160925-ccc_waste_recycling_script,2016/09/25,ccc_waste_recycling_script,0,0,0:00:00,0,0:00:00,0,0
20160926-ccc_311_calgary_script,2016/09/26,ccc_311_calgary_script,3317,3216,0:00:18,18,0:04:07,101,57888
20160926-ccc_311_lobby_ph_script,2016/09/26,ccc_311_lobby_ph_script,2,2,0:00:03,3,0:00:04,0,6
20160926-ccc_aserv_info_script,2016/09/26,ccc_aserv_info_script,0,0,0:00:00,0,0:00:00,0,0
20160926-ccc_bylaw_script,2016/09/26,ccc_bylaw_script,0,0,0:00:00,0,0:00:00,0,0
20160926-ccc_city_script,2016/09/26,ccc_city_script,38,34,0:00:12,12,0:02:46,4,408
20160926-ccc_cty_online_script,2016/09/26,ccc_cty_online_script,0,0,0:00:00,0,0:00:00,0,0
20160926-ccc_feedback_script,2016/09/26,ccc_feedback_script,0,0,0:00:00,0,0:00:00,0,0
20160926-ccc_fpb_script,2016/09/26,ccc_fpb_script,0,0,0:00:00,0,0:00:00,0,0
20160926-ccc_help_script,2016/09/26,ccc_help_script,12,12,0:00:09,9,0:00:20,0,108
20160926-ccc_link_script,2016/09/26,ccc_link_script,0,0,0:00:00,0,0:00:00,0,0
20160926-ccc_media_line_script,2016/09/26,ccc_media_line_script,0,0,0:00:00,0,0:00:00,0,0
20160926-ccc_priority_script,2016/09/26,ccc_priority_script,29,28,0:00:06,6,0:00:26,1,168
20160926-ccc_tax_script,2016/09/26,ccc_tax_script,14,14,0:00:37,37,0:02:31,0,518
20160926-ccc_waste_recycling_script,2016/09/26,ccc_waste_recycling_script,0,0,0:00:00,0,0:00:00,0,0
20160927-ccc_311_calgary_script,2016/09/27,ccc_311_calgary_script,3218,3080,0:00:24,24,0:05:30,138,73920
20160927-ccc_311_lobby_ph_script,2016/09/27,ccc_311_lobby_ph_script,1,1,0:00:12,12,0:00:12,0,12
20160927-ccc_aserv_info_script,2016/09/27,ccc_aserv_info_script,0,0,0:00:00,0,0:00:00,0,0
20160927-ccc_bylaw_script,2016/09/27,ccc_bylaw_script,0,0,0:00:00,0,0:00:00,0,0
20160927-ccc_city_script,2016/09/27,ccc_city_script,25,25,0:00:08,8,0:00:19,0,200
20160927-ccc_cty_online_script,2016/09/27,ccc_cty_online_script,0,0,0:00:00,0,0:00:00,0,0
20160927-ccc_feedback_script,2016/09/27,ccc_feedback_script,0,0,0:00:00,0,0:00:00,0,0
20160927-ccc_fpb_script,2016/09/27,ccc_fpb_script,0,0,0:00:00,0,0:00:00,0,0
20160927-ccc_help_script,2016/09/27,ccc_help_script,28,27,0:00:10,10,0:01:10,1,270
20160927-ccc_link_script,2016/09/27,ccc_link_script,0,0,0:00:00,0,0:00:00,0,0
20160927-ccc_media_line_script,2016/09/27,ccc_media_line_script,0,0,0:00:00,0,0:00:00,0,0
20160927-ccc_priority_script,2016/09/27,ccc_priority_script,29,29,0:00:09,9,0:00:18,0,261
20160927-ccc_tax_script,2016/09/27,ccc_tax_script,19,18,0:00:25,25,0:02:09,1,450
20160927-ccc_waste_recycling_script,2016/09/27,ccc_waste_recycling_script,0,0,0:00:00,0,0:00:00,0,0
20160928-ccc_311_calgary_script,2016/09/28,ccc_311_calgary_script,3155,2893,0:01:09,69,0:09:35,262,199617
20160928-ccc_311_lobby_ph_script,2016/09/28,ccc_311_lobby_ph_script,2,2,0:00:10,10,0:00:13,0,20
20160928-ccc_aserv_info_script,2016/09/28,ccc_aserv_info_script,0,0,0:00:00,0,0:00:00,0,0
20160928-ccc_bylaw_script,2016/09/28,ccc_bylaw_script,0,0,0:00:00,0,0:00:00,0,0
20160928-ccc_city_script,2016/09/28,ccc_city_script,25,25,0:00:14,14,0:01:01,0,350
20160928-ccc_cty_online_script,2016/09/28,ccc_cty_online_script,0,0,0:00:00,0,0:00:00,0,0
20160928-ccc_feedback_script,2016/09/28,ccc_feedback_script,0,0,0:00:00,0,0:00:00,0,0
20160928-ccc_fpb_script,2016/09/28,ccc_fpb_script,2,1,0:00:06,6,0:00:06,1,6
20160928-ccc_help_script,2016/09/28,ccc_help_script,17,16,0:00:08,8,0:00:22,1,128
20160928-ccc_link_script,2016/09/28,ccc_link_script,0,0,0:00:00,0,0:00:00,0,0
20160928-ccc_media_line_script,2016/09/28,ccc_media_line_script,0,0,0:00:00,0,0:00:00,0,0
20160928-ccc_priority_script,2016/09/28,ccc_priority_script,18,18,0:00:09,9,0:00:48,0,162
20160928-ccc_tax_script,2016/09/28,ccc_tax_script,16,16,0:00:55,55,0:04:28,0,880
20160928-ccc_waste_recycling_script,2016/09/28,ccc_waste_recycling_script,0,0,0:00:00,0,0:00:00,0,0
20160929-ccc_311_calgary_script,2016/09/29,ccc_311_calgary_script,3206,2939,0:01:05,65,0:11:09,267,191035
20160929-ccc_311_lobby_ph_script,2016/09/29,ccc_311_lobby_ph_script,3,2,0:00:13,13,0:00:18,1,26
20160929-ccc_aserv_info_script,2016/09/29,ccc_aserv_info_script,0,0,0:00:00,0,0:00:00,0,0
20160929-ccc_bylaw_script,2016/09/29,ccc_bylaw_script,0,0,0:00:00,0,0:00:00,0,0
20160929-ccc_city_script,2016/09/29,ccc_city_script,34,32,0:00:28,28,0:03:55,2,896
20160929-ccc_cty_online_script,2016/09/29,ccc_cty_online_script,0,0,0:00:00,0,0:00:00,0,0
20160929-ccc_feedback_script,2016/09/29,ccc_feedback_script,0,0,0:00:00,0,0:00:00,0,0
20160929-ccc_fpb_script,2016/09/29,ccc_fpb_script,1,1,0:00:03,3,0:00:03,0,3
20160929-ccc_help_script,2016/09/29,ccc_help_script,30,29,0:00:10,10,0:00:44,1,290
20160929-ccc_link_script,2016/09/29,ccc_link_script,0,0,0:00:00,0,0:00:00,0,0
20160929-ccc_media_line_script,2016/09/29,ccc_media_line_script,1,0,0:00:00,0,0:00:00,1,0
20160929-ccc_priority_script,2016/09/29,ccc_priority_script,36,35,0:00:15,15,0:01:19,1,525
20160929-ccc_tax_script,2016/09/29,ccc_tax_script,19,19,0:00:47,47,0:03:50,0,893
20160929-ccc_waste_recycling_script,2016/09/29,ccc_waste_recycling_script,0,0,0:00:00,0,0:00:00,0,0
20160930-ccc_311_calgary_script,2016/09/30,ccc_311_calgary_script,3101,2902,0:00:44,44,0:06:07,199,127688
20160930-ccc_311_lobby_ph_script,2016/09/30,ccc_311_lobby_ph_script,2,2,0:00:08,8,0:00:10,0,16
20160930-ccc_aserv_info_script,2016/09/30,ccc_aserv_info_script,0,0,0:00:00,0,0:00:00,0,0
20160930-ccc_bylaw_script,2016/09/30,ccc_bylaw_script,0,0,0:00:00,0,0:00:00,0,0
20160930-ccc_city_script,2016/09/30,ccc_city_script,22,21,0:00:10,10,0:00:35,1,210
20160930-ccc_cty_online_script,2016/09/30,ccc_cty_online_script,0,0,0:00:00,0,0:00:00,0,0
20160930-ccc_feedback_script,2016/09/30,ccc_feedback_script,0,0,0:00:00,0,0:00:00,0,0
20160930-ccc_fpb_script,2016/09/30,ccc_fpb_script,0,0,0:00:00,0,0:00:00,0,0
20160930-ccc_help_script,2016/09/30,ccc_help_script,21,21,0:00:10,10,0:00:28,0,210
20160930-ccc_link_script,2016/09/30,ccc_link_script,0,0,0:00:00,0,0:00:00,0,0
20160930-ccc_media_line_script,2016/09/30,ccc_media_line_script,1,1,0:00:03,3,0:00:03,0,3
20160930-ccc_priority_script,2016/09/30,ccc_priority_script,31,30,0:00:10,10,0:00:52,1,300
20160930-ccc_tax_script,2016/09/30,ccc_tax_script,25,24,0:00:51,51,0:04:00,1,1224
20160930-ccc_waste_recycling_script,2016/09/30,ccc_waste_recycling_script,0,0,0:00:00,0,0:00:00,0,0
20161001-ccc_311_calgary_script,2016/10/01,ccc_311_calgary_script,1101,1062,0:00:23,23,0:07:57,39,24426
20161001-ccc_311_lobby_ph_script,2016/10/01,ccc_311_lobby_ph_script,0,0,0:00:00,0,0:00:00,0,0
20161001-ccc_aserv_info_script,2016/10/01,ccc_aserv_info_script,0,0,0:00:00,0,0:00:00,0,0
20161001-ccc_bylaw_script,2016/10/01,ccc_bylaw_script,0,0,0:00:00,0,0:00:00,0,0
20161001-ccc_city_script,2016/10/01,ccc_city_script,0,0,0:00:00,0,0:00:00,0,0
20161001-ccc_cty_online_script,2016/10/01,ccc_cty_online_script,0,0,0:00:00,0,0:00:00,0,0
20161001-ccc_feedback_script,2016/10/01,ccc_feedback_script,0,0,0:00:00,0,0:00:00,0,0
20161001-ccc_fpb_script,2016/10/01,ccc_fpb_script,0,0,0:00:00,0,0:00:00,0,0
20161001-ccc_help_script,2016/10/01,ccc_help_script,16,16,0:00:16,16,0:01:17,0,256
20161001-ccc_link_script,2016/10/01,ccc_link_script,0,0,0:00:00,0,0:00:00,0,0
20161001-ccc_media_line_script,2016/10/01,ccc_media_line_script,0,0,0:00:00,0,0:00:00,0,0
20161001-ccc_priority_script,2016/10/01,ccc_priority_script,22,22,0:00:16,16,0:02:16,0,352
20161001-ccc_tax_script,2016/10/01,ccc_tax_script,0,0,0:00:00,0,0:00:00,0,0
20161001-ccc_waste_recycling_script,2016/10/01,ccc_waste_recycling_script,0,0,0:00:00,0,0:00:00,0,0
20161002-ccc_311_calgary_script,2016/10/02,ccc_311_calgary_script,1227,1117,0:00:44,44,0:10:13,110,49148
20161002-ccc_311_lobby_ph_script,2016/10/02,ccc_311_lobby_ph_script,0,0,0:00:00,0,0:00:00,0,0
20161002-ccc_aserv_info_script,2016/10/02,ccc_aserv_info_script,0,0,0:00:00,0,0:00:00,0,0
20161002-ccc_bylaw_script,2016/10/02,ccc_bylaw_script,0,0,0:00:00,0,0:00:00,0,0
20161002-ccc_city_script,2016/10/02,ccc_city_script,0,0,0:00:00,0,0:00:00,0,0
20161002-ccc_cty_online_script,2016/10/02,ccc_cty_online_script,0,0,0:00:00,0,0:00:00,0,0
20161002-ccc_feedback_script,2016/10/02,ccc_feedback_script,0,0,0:00:00,0,0:00:00,0,0
20161002-ccc_fpb_script,2016/10/02,ccc_fpb_script,0,0,0:00:00,0,0:00:00,0,0
20161002-ccc_help_script,2016/10/02,ccc_help_script,13,12,0:00:13,13,0:00:55,1,156
20161002-ccc_link_script,2016/10/02,ccc_link_script,0,0,0:00:00,0,0:00:00,0,0
20161002-ccc_media_line_script,2016/10/02,ccc_media_line_script,0,0,0:00:00,0,0:00:00,0,0
20161002-ccc_priority_script,2016/10/02,ccc_priority_script,26,26,0:00:09,9,0:01:28,0,234
20161002-ccc_tax_script,2016/10/02,ccc_tax_script,0,0,0:00:00,0,0:00:00,0,0
20161002-ccc_waste_recycling_script,2016/10/02,ccc_waste_recycling_script,0,0,0:00:00,0,0:00:00,0,0
20161003-ccc_311_calgary_script,2016/10/03,ccc_311_calgary_script,3471,3357,0:00:30,30,0:04:38,114,100710
20161003-ccc_311_lobby_ph_script,2016/10/03,ccc_311_lobby_ph_script,1,1,0:00:05,5,0:00:05,0,5
20161003-ccc_aserv_info_script,2016/10/03,ccc_aserv_info_script,0,0,0:00:00,0,0:00:00,0,0
20161003-ccc_bylaw_script,2016/10/03,ccc_bylaw_script,0,0,0:00:00,0,0:00:00,0,0
20161003-ccc_city_script,2016/10/03,ccc_city_script,25,25,0:00:11,11,0:00:42,0,275
20161003-ccc_cty_online_script,2016/10/03,ccc_cty_online_script,0,0,0:00:00,0,0:00:00,0,0
20161003-ccc_feedback_script,2016/10/03,ccc_feedback_script,0,0,0:00:00,0,0:00:00,0,0
20161003-ccc_fpb_script,2016/10/03,ccc_fpb_script,0,0,0:00:00,0,0:00:00,0,0
20161003-ccc_help_script,2016/10/03,ccc_help_script,31,30,0:00:08,8,0:00:27,1,240
20161003-ccc_link_script,2016/10/03,ccc_link_script,0,0,0:00:00,0,0:00:00,0,0
20161003-ccc_media_line_script,2016/10/03,ccc_media_line_script,1,1,0:00:06,6,0:00:06,0,6
20161003-ccc_priority_script,2016/10/03,ccc_priority_script,23,23,0:00:09,9,0:00:35,0,207
20161003-ccc_tax_script,2016/10/03,ccc_tax_script,22,22,0:00:47,47,0:03:01,0,1034
20161003-ccc_waste_recycling_script,2016/10/03,ccc_waste_recycling_script,0,0,0:00:00,0,0:00:00,0,0
20161004-ccc_311_calgary_script,2016/10/04,ccc_311_calgary_script,3225,2960,0:01:09,69,0:09:10,265,204240
20161004-ccc_311_lobby_ph_script,2016/10/04,ccc_311_lobby_ph_script,3,2,0:00:08,8,0:00:13,1,16
20161004-ccc_aserv_info_script,2016/10/04,ccc_aserv_info_script,0,0,0:00:00,0,0:00:00,0,0
20161004-ccc_bylaw_script,2016/10/04,ccc_bylaw_script,0,0,0:00:00,0,0:00:00,0,0
20161004-ccc_city_script,2016/10/04,ccc_city_script,20,19,0:00:28,28,0:03:43,1,532
20161004-ccc_cty_online_script,2016/10/04,ccc_cty_online_script,0,0,0:00:00,0,0:00:00,0,0
20161004-ccc_feedback_script,2016/10/04,ccc_feedback_script,0,0,0:00:00,0,0:00:00,0,0
20161004-ccc_fpb_script,2016/10/04,ccc_fpb_script,1,1,0:00:04,4,0:00:04,0,4
20161004-ccc_help_script,2016/10/04,ccc_help_script,16,15,0:00:12,12,0:00:34,1,180
20161004-ccc_link_script,2016/10/04,ccc_link_script,0,0,0:00:00,0,0:00:00,0,0
20161004-ccc_media_line_script,2016/10/04,ccc_media_line_script,1,1,0:00:12,12,0:00:12,0,12
20161004-ccc_priority_script,2016/10/04,ccc_priority_script,35,34,0:00:15,15,0:02:25,1,510
20161004-ccc_tax_script,2016/10/04,ccc_tax_script,20,19,0:01:55,115,0:07:01,1,2185
20161004-ccc_waste_recycling_script,2016/10/04,ccc_waste_recycling_script,0,0,0:00:00,0,0:00:00,0,0
20161005-ccc_311_calgary_script,2016/10/05,ccc_311_calgary_script,2901,2858,0:00:13,13,0:07:43,43,37154
20161005-ccc_311_lobby_ph_script,2016/10/05,ccc_311_lobby_ph_script,0,0,0:00:00,0,0:00:00,0,0
20161005-ccc_aserv_info_script,2016/10/05,ccc_aserv_info_script,0,0,0:00:00,0,0:00:00,0,0
20161005-ccc_bylaw_script,2016/10/05,ccc_bylaw_script,0,0,0:00:00,0,0:00:00,0,0
20161005-ccc_city_script,2016/10/05,ccc_city_script,12,12,0:00:07,7,0:00:25,0,84
20161005-ccc_cty_online_script,2016/10/05,ccc_cty_online_script,0,0,0:00:00,0,0:00:00,0,0
20161005-ccc_feedback_script,2016/10/05,ccc_feedback_script,0,0,0:00:00,0,0:00:00,0,0
20161005-ccc_fpb_script,2016/10/05,ccc_fpb_script,0,0,0:00:00,0,0:00:00,0,0
20161005-ccc_help_script,2016/10/05,ccc_help_script,19,18,0:00:07,7,0:00:27,1,126
20161005-ccc_link_script,2016/10/05,ccc_link_script,0,0,0:00:00,0,0:00:00,0,0
20161005-ccc_media_line_script,2016/10/05,ccc_media_line_script,0,0,0:00:00,0,0:00:00,0,0
20161005-ccc_priority_script,2016/10/05,ccc_priority_script,21,21,0:00:07,7,0:00:37,0,147
20161005-ccc_tax_script,2016/10/05,ccc_tax_script,24,23,0:00:09,9,0:01:11,1,207
20161005-ccc_waste_recycling_script,2016/10/05,ccc_waste_recycling_script,0,0,0:00:00,0,0:00:00,0,0
20161006-ccc_311_calgary_script,2016/10/06,ccc_311_calgary_script,2794,2729,0:00:13,13,0:09:11,65,35477
20161006-ccc_311_lobby_ph_script,2016/10/06,ccc_311_lobby_ph_script,4,4,0:00:06,6,0:00:12,0,24
20161006-ccc_aserv_info_script,2016/10/06,ccc_aserv_info_script,0,0,0:00:00,0,0:00:00,0,0
20161006-ccc_bylaw_script,2016/10/06,ccc_bylaw_script,0,0,0:00:00,0,0:00:00,0,0
20161006-ccc_city_script,2016/10/06,ccc_city_script,25,22,0:00:08,8,0:01:01,3,176
20161006-ccc_cty_online_script,2016/10/06,ccc_cty_online_script,0,0,0:00:00,0,0:00:00,0,0
20161006-ccc_feedback_script,2016/10/06,ccc_feedback_script,0,0,0:00:00,0,0:00:00,0,0
20161006-ccc_fpb_script,2016/10/06,ccc_fpb_script,1,1,0:00:01,1,0:00:01,0,1
20161006-ccc_help_script,2016/10/06,ccc_help_script,9,9,0:00:06,6,0:00:14,0,54
20161006-ccc_link_script,2016/10/06,ccc_link_script,0,0,0:00:00,0,0:00:00,0,0
20161006-ccc_media_line_script,2016/10/06,ccc_media_line_script,2,2,0:00:03,3,0:00:03,0,6
20161006-ccc_priority_script,2016/10/06,ccc_priority_script,32,32,0:00:07,7,0:01:18,0,224
20161006-ccc_tax_script,2016/10/06,ccc_tax_script,24,24,0:00:06,6,0:00:19,0,144
20161006-ccc_waste_recycling_script,2016/10/06,ccc_waste_recycling_script,0,0,0:00:00,0,0:00:00,0,0
20161007-ccc_311_calgary_script,2016/10/07,ccc_311_calgary_script,2363,2328,0:00:08,8,0:03:53,35,18624
20161007-ccc_311_lobby_ph_script,2016/10/07,ccc_311_lobby_ph_script,1,1,0:00:03,3,0:00:03,0,3
20161007-ccc_aserv_info_script,2016/10/07,ccc_aserv_info_script,0,0,0:00:00,0,0:00:00,0,0
20161007-ccc_bylaw_script,2016/10/07,ccc_bylaw_script,0,0,0:00:00,0,0:00:00,0,0
20161007-ccc_city_script,2016/10/07,ccc_city_script,13,13,0:00:06,6,0:00:21,0,78
20161007-ccc_cty_online_script,2016/10/07,ccc_cty_online_script,0,0,0:00:00,0,0:00:00,0,0
20161007-ccc_feedback_script,2016/10/07,ccc_feedback_script,2,0,0:00:00,0,0:00:00,0,0
20161007-ccc_fpb_script,2016/10/07,ccc_fpb_script,0,0,0:00:00,0,0:00:00,0,0
20161007-ccc_help_script,2016/10/07,ccc_help_script,6,6,0:00:07,7,0:00:09,0,42
20161007-ccc_link_script,2016/10/07,ccc_link_script,0,0,0:00:00,0,0:00:00,0,0
20161007-ccc_media_line_script,2016/10/07,ccc_media_line_script,2,2,0:00:06,6,0:00:06,0,12
20161007-ccc_priority_script,2016/10/07,ccc_priority_script,27,27,0:00:14,14,0:02:32,0,378
20161007-ccc_tax_script,2016/10/07,ccc_tax_script,19,19,0:00:07,7,0:00:15,0,133
20161007-ccc_waste_recycling_script,2016/10/07,ccc_waste_recycling_script,0,0,0:00:00,0,0:00:00,0,0
20161008-ccc_311_calgary_script,2016/10/08,ccc_311_calgary_script,829,808,0:00:14,14,0:12:05,21,11312
20161008-ccc_311_lobby_ph_script,2016/10/08,ccc_311_lobby_ph_script,0,0,0:00:00,0,0:00:00,0,0
20161008-ccc_aserv_info_script,2016/10/08,ccc_aserv_info_script,0,0,0:00:00,0,0:00:00,0,0
20161008-ccc_bylaw_script,2016/10/08,ccc_bylaw_script,0,0,0:00:00,0,0:00:00,0,0
20161008-ccc_city_script,2016/10/08,ccc_city_script,0,0,0:00:00,0,0:00:00,0,0
20161008-ccc_cty_online_script,2016/10/08,ccc_cty_online_script,0,0,0:00:00,0,0:00:00,0,0
20161008-ccc_feedback_script,2016/10/08,ccc_feedback_script,0,0,0:00:00,0,0:00:00,0,0
20161008-ccc_fpb_script,2016/10/08,ccc_fpb_script,0,0,0:00:00,0,0:00:00,0,0
20161008-ccc_help_script,2016/10/08,ccc_help_script,6,6,0:00:07,7,0:00:12,0,42
20161008-ccc_link_script,2016/10/08,ccc_link_script,0,0,0:00:00,0,0:00:00,0,0
20161008-ccc_media_line_script,2016/10/08,ccc_media_line_script,2,2,0:00:04,4,0:00:06,0,8
20161008-ccc_priority_script,2016/10/08,ccc_priority_script,31,31,0:00:09,9,0:00:58,0,279
20161008-ccc_tax_script,2016/10/08,ccc_tax_script,0,0,0:00:00,0,0:00:00,0,0
20161008-ccc_waste_recycling_script,2016/10/08,ccc_waste_recycling_script,0,0,0:00:00,0,0:00:00,0,0
20161009-ccc_311_calgary_script,2016/10/09,ccc_311_calgary_script,661,648,0:00:09,9,0:03:42,13,5832
20161009-ccc_311_lobby_ph_script,2016/10/09,ccc_311_lobby_ph_script,0,0,0:00:00,0,0:00:00,0,0
20161009-ccc_aserv_info_script,2016/10/09,ccc_aserv_info_script,0,0,0:00:00,0,0:00:00,0,0
20161009-ccc_bylaw_script,2016/10/09,ccc_bylaw_script,0,0,0:00:00,0,0:00:00,0,0
20161009-ccc_city_script,2016/10/09,ccc_city_script,0,0,0:00:00,0,0:00:00,0,0
20161009-ccc_cty_online_script,2016/10/09,ccc_cty_online_script,0,0,0:00:00,0,0:00:00,0,0
20161009-ccc_feedback_script,2016/10/09,ccc_feedback_script,0,0,0:00:00,0,0:00:00,0,0
20161009-ccc_fpb_script,2016/10/09,ccc_fpb_script,0,0,0:00:00,0,0:00:00,0,0
20161009-ccc_help_script,2016/10/09,ccc_help_script,6,6,0:00:05,5,0:00:13,0,30
20161009-ccc_link_script,2016/10/09,ccc_link_script,0,0,0:00:00,0,0:00:00,0,0
20161009-ccc_media_line_script,2016/10/09,ccc_media_line_script,2,2,0:00:08,8,0:00:08,0,16
20161009-ccc_priority_script,2016/10/09,ccc_priority_script,18,17,0:00:11,11,0:01:24,1,187
20161009-ccc_tax_script,2016/10/09,ccc_tax_script,0,0,0:00:00,0,0:00:00,0,0
20161009-ccc_waste_recycling_script,2016/10/09,ccc_waste_recycling_script,0,0,0:00:00,0,0:00:00,0,0
20161011-ccc_311_calgary_script,2016/10/11,ccc_311_calgary_script,2913,2880,0:00:09,9,0:04:16,33,25920
20161011-ccc_311_lobby_ph_script,2016/10/11,ccc_311_lobby_ph_script,6,6,0:00:05,5,0:00:08,0,30
20161011-ccc_aserv_info_script,2016/10/11,ccc_aserv_info_script,0,0,0:00:00,0,0:00:00,0,0
20161011-ccc_bylaw_script,2016/10/11,ccc_bylaw_script,0,0,0:00:00,0,0:00:00,0,0
20161011-ccc_city_script,2016/10/11,ccc_city_script,36,34,0:00:07,7,0:00:20,2,238
20161011-ccc_cty_online_script,2016/10/11,ccc_cty_online_script,0,0,0:00:00,0,0:00:00,0,0
20161011-ccc_feedback_script,2016/10/11,ccc_feedback_script,1,0,0:00:00,0,0:00:00,0,0
20161011-ccc_fpb_script,2016/10/11,ccc_fpb_script,1,1,0:00:04,4,0:00:04,0,4
20161011-ccc_help_script,2016/10/11,ccc_help_script,22,22,0:00:10,10,0:01:19,0,220
20161011-ccc_link_script,2016/10/11,ccc_link_script,0,0,0:00:00,0,0:00:00,0,0
20161011-ccc_media_line_script,2016/10/11,ccc_media_line_script,0,0,0:00:00,0,0:00:00,0,0
20161011-ccc_priority_script,2016/10/11,ccc_priority_script,27,27,0:00:07,7,0:00:33,0,189
20161011-ccc_tax_script,2016/10/11,ccc_tax_script,16,16,0:00:07,7,0:00:33,0,112
20161011-ccc_waste_recycling_script,2016/10/11,ccc_waste_recycling_script,0,0,0:00:00,0,0:00:00,0,0
20161012-ccc_311_calgary_script,2016/10/12,ccc_311_calgary_script,2855,2747,0:00:33,33,0:11:46,108,90651
20161012-ccc_311_lobby_ph_script,2016/10/12,ccc_311_lobby_ph_script,2,2,0:00:10,10,0:00:15,0,20
20161012-ccc_aserv_info_script,2016/10/12,ccc_aserv_info_script,0,0,0:00:00,0,0:00:00,0,0
20161012-ccc_bylaw_script,2016/10/12,ccc_bylaw_script,0,0,0:00:00,0,0:00:00,0,0
20161012-ccc_city_script,2016/10/12,ccc_city_script,32,30,0:00:10,10,0:01:16,2,300
20161012-ccc_cty_online_script,2016/10/12,ccc_cty_online_script,0,0,0:00:00,0,0:00:00,0,0
20161012-ccc_feedback_script,2016/10/12,ccc_feedback_script,0,0,0:00:00,0,0:00:00,0,0
20161012-ccc_fpb_script,2016/10/12,ccc_fpb_script,1,1,0:00:05,5,0:00:05,0,5
20161012-ccc_help_script,2016/10/12,ccc_help_script,23,22,0:00:09,9,0:01:04,1,198
20161012-ccc_link_script,2016/10/12,ccc_link_script,0,0,0:00:00,0,0:00:00,0,0
20161012-ccc_media_line_script,2016/10/12,ccc_media_line_script,0,0,0:00:00,0,0:00:00,0,0
20161012-ccc_priority_script,2016/10/12,ccc_priority_script,22,21,0:00:05,5,0:00:17,1,105
20161012-ccc_tax_script,2016/10/12,ccc_tax_script,14,14,0:00:22,22,0:02:13,0,308
20161012-ccc_waste_recycling_script,2016/10/12,ccc_waste_recycling_script,0,0,0:00:00,0,0:00:00,0,0
20161013-ccc_311_calgary_script,2016/10/13,ccc_311_calgary_script,2827,2596,0:01:05,65,0:10:53,231,168740
20161013-ccc_311_lobby_ph_script,2016/10/13,ccc_311_lobby_ph_script,4,4,0:00:11,11,0:00:15,0,44
20161013-ccc_aserv_info_script,2016/10/13,ccc_aserv_info_script,0,0,0:00:00,0,0:00:00,0,0
20161013-ccc_bylaw_script,2016/10/13,ccc_bylaw_script,0,0,0:00:00,0,0:00:00,0,0
20161013-ccc_city_script,2016/10/13,ccc_city_script,12,12,0:00:50,50,0:04:13,0,600
20161013-ccc_cty_online_script,2016/10/13,ccc_cty_online_script,0,0,0:00:00,0,0:00:00,0,0
20161013-ccc_feedback_script,2016/10/13,ccc_feedback_script,0,0,0:00:00,0,0:00:00,0,0
20161013-ccc_fpb_script,2016/10/13,ccc_fpb_script,1,1,0:02:41,161,0:02:41,0,161
20161013-ccc_help_script,2016/10/13,ccc_help_script,16,16,0:00:14,14,0:01:13,0,224
20161013-ccc_link_script,2016/10/13,ccc_link_script,0,0,0:00:00,0,0:00:00,0,0
20161013-ccc_media_line_script,2016/10/13,ccc_media_line_script,2,1,0:00:22,22,0:00:22,1,22
20161013-ccc_priority_script,2016/10/13,ccc_priority_script,25,24,0:00:10,10,0:01:23,1,240
20161013-ccc_tax_script,2016/10/13,ccc_tax_script,23,21,0:00:25,25,0:02:35,2,525
20161013-ccc_waste_recycling_script,2016/10/13,ccc_waste_recycling_script,1,1,0:00:05,5,0:00:05,0,5
20161014-ccc_311_calgary_script,2016/10/14,ccc_311_calgary_script,2656,2521,0:00:41,41,0:10:34,135,103361
20161014-ccc_311_lobby_ph_script,2016/10/14,ccc_311_lobby_ph_script,0,0,0:00:00,0,0:00:00,0,0
20161014-ccc_aserv_info_script,2016/10/14,ccc_aserv_info_script,0,0,0:00:00,0,0:00:00,0,0
20161014-ccc_bylaw_script,2016/10/14,ccc_bylaw_script,0,0,0:00:00,0,0:00:00,0,0
20161014-ccc_city_script,2016/10/14,ccc_city_script,31,31,0:00:07,7,0:00:21,0,217
20161014-ccc_cty_online_script,2016/10/14,ccc_cty_online_script,0,0,0:00:00,0,0:00:00,0,0
20161014-ccc_feedback_script,2016/10/14,ccc_feedback_script,0,0,0:00:00,0,0:00:00,0,0
20161014-ccc_fpb_script,2016/10/14,ccc_fpb_script,1,1,0:00:04,4,0:00:04,0,4
20161014-ccc_help_script,2016/10/14,ccc_help_script,26,25,0:00:09,9,0:00:30,1,225
20161014-ccc_link_script,2016/10/14,ccc_link_script,0,0,0:00:00,0,0:00:00,0,0
20161014-ccc_media_line_script,2016/10/14,ccc_media_line_script,1,1,0:00:05,5,0:00:05,0,5
20161014-ccc_priority_script,2016/10/14,ccc_priority_script,16,16,0:00:16,16,0:02:25,0,256
20161014-ccc_tax_script,2016/10/14,ccc_tax_script,11,11,0:00:27,27,0:02:31,0,297
20161014-ccc_waste_recycling_script,2016/10/14,ccc_waste_recycling_script,0,0,0:00:00,0,0:00:00,0,0
20161015-ccc_311_calgary_script,2016/10/15,ccc_311_calgary_script,1034,996,0:00:26,26,0:05:13,38,25896
20161015-ccc_311_lobby_ph_script,2016/10/15,ccc_311_lobby_ph_script,0,0,0:00:00,0,0:00:00,0,0
20161015-ccc_aserv_info_script,2016/10/15,ccc_aserv_info_script,0,0,0:00:00,0,0:00:00,0,0
20161015-ccc_bylaw_script,2016/10/15,ccc_bylaw_script,0,0,0:00:00,0,0:00:00,0,0
20161015-ccc_city_script,2016/10/15,ccc_city_script,0,0,0:00:00,0,0:00:00,0,0
20161015-ccc_cty_online_script,2016/10/15,ccc_cty_online_script,0,0,0:00:00,0,0:00:00,0,0
20161015-ccc_feedback_script,2016/10/15,ccc_feedback_script,0,0,0:00:00,0,0:00:00,0,0
20161015-ccc_fpb_script,2016/10/15,ccc_fpb_script,0,0,0:00:00,0,0:00:00,0,0
20161015-ccc_help_script,2016/10/15,ccc_help_script,6,5,0:00:10,10,0:00:22,1,50
20161015-ccc_link_script,2016/10/15,ccc_link_script,0,0,0:00:00,0,0:00:00,0,0
20161015-ccc_media_line_script,2016/10/15,ccc_media_line_script,2,2,0:00:42,42,0:01:16,0,84
20161015-ccc_priority_script,2016/10/15,ccc_priority_script,24,24,0:00:08,8,0:00:33,0,192
20161015-ccc_tax_script,2016/10/15,ccc_tax_script,5,5,0:00:23,23,0:01:22,0,115
20161015-ccc_waste_recycling_script,2016/10/15,ccc_waste_recycling_script,0,0,0:00:00,0,0:00:00,0,0
20161016-ccc_311_calgary_script,2016/10/16,ccc_311_calgary_script,831,823,0:00:10,10,0:03:29,8,8230
20161016-ccc_311_lobby_ph_script,2016/10/16,ccc_311_lobby_ph_script,0,0,0:00:00,0,0:00:00,0,0
20161016-ccc_aserv_info_script,2016/10/16,ccc_aserv_info_script,0,0,0:00:00,0,0:00:00,0,0
20161016-ccc_bylaw_script,2016/10/16,ccc_bylaw_script,0,0,0:00:00,0,0:00:00,0,0
20161016-ccc_city_script,2016/10/16,ccc_city_script,0,0,0:00:00,0,0:00:00,0,0
20161016-ccc_cty_online_script,2016/10/16,ccc_cty_online_script,0,0,0:00:00,0,0:00:00,0,0
20161016-ccc_feedback_script,2016/10/16,ccc_feedback_script,0,0,0:00:00,0,0:00:00,0,0
20161016-ccc_fpb_script,2016/10/16,ccc_fpb_script,0,0,0:00:00,0,0:00:00,0,0
20161016-ccc_help_script,2016/10/16,ccc_help_script,1,1,0:00:09,9,0:00:09,0,9
20161016-ccc_link_script,2016/10/16,ccc_link_script,0,0,0:00:00,0,0:00:00,0,0
20161016-ccc_media_line_script,2016/10/16,ccc_media_line_script,1,1,0:00:02,2,0:00:02,0,2
20161016-ccc_priority_script,2016/10/16,ccc_priority_script,13,13,0:00:08,8,0:00:18,0,104
20161016-ccc_tax_script,2016/10/16,ccc_tax_script,0,0,0:00:00,0,0:00:00,0,0
20161016-ccc_waste_recycling_script,2016/10/16,ccc_waste_recycling_script,0,0,0:00:00,0,0:00:00,0,0
20161017-ccc_311_calgary_script,2016/10/17,ccc_311_calgary_script,2955,2886,0:00:23,23,0:03:14,68,66378
20161017-ccc_311_lobby_ph_script,2016/10/17,ccc_311_lobby_ph_script,0,0,0:00:00,0,0:00:00,0,0
20161017-ccc_aserv_info_script,2016/10/17,ccc_aserv_info_script,0,0,0:00:00,0,0:00:00,0,0
20161017-ccc_bylaw_script,2016/10/17,ccc_bylaw_script,0,0,0:00:00,0,0:00:00,0,0
20161017-ccc_city_script,2016/10/17,ccc_city_script,31,31,0:00:10,10,0:00:50,0,310
20161017-ccc_cty_online_script,2016/10/17,ccc_cty_online_script,0,0,0:00:00,0,0:00:00,0,0
20161017-ccc_feedback_script,2016/10/17,ccc_feedback_script,0,0,0:00:00,0,0:00:00,0,0
20161017-ccc_fpb_script,2016/10/17,ccc_fpb_script,0,0,0:00:00,0,0:00:00,0,0
20161017-ccc_help_script,2016/10/17,ccc_help_script,6,6,0:00:05,5,0:00:09,0,30
20161017-ccc_link_script,2016/10/17,ccc_link_script,0,0,0:00:00,0,0:00:00,0,0
20161017-ccc_media_line_script,2016/10/17,ccc_media_line_script,1,1,0:00:02,2,0:00:02,0,2
20161017-ccc_priority_script,2016/10/17,ccc_priority_script,24,24,0:00:07,7,0:00:17,0,168
20161017-ccc_tax_script,2016/10/17,ccc_tax_script,14,14,0:00:18,18,0:02:11,0,252
20161017-ccc_waste_recycling_script,2016/10/17,ccc_waste_recycling_script,0,0,0:00:00,0,0:00:00,0,0
20161018-ccc_311_calgary_script,2016/10/18,ccc_311_calgary_script,2798,2580,0:01:10,70,0:06:52,219,180600
20161018-ccc_311_lobby_ph_script,2016/10/18,ccc_311_lobby_ph_script,1,1,0:00:19,19,0:00:19,0,19
20161018-ccc_aserv_info_script,2016/10/18,ccc_aserv_info_script,0,0,0:00:00,0,0:00:00,0,0
20161018-ccc_bylaw_script,2016/10/18,ccc_bylaw_script,0,0,0:00:00,0,0:00:00,0,0
20161018-ccc_city_script,2016/10/18,ccc_city_script,12,9,0:00:57,57,0:04:09,3,513
20161018-ccc_cty_online_script,2016/10/18,ccc_cty_online_script,0,0,0:00:00,0,0:00:00,0,0
20161018-ccc_feedback_script,2016/10/18,ccc_feedback_script,0,0,0:00:00,0,0:00:00,0,0
20161018-ccc_fpb_script,2016/10/18,ccc_fpb_script,1,0,0:00:00,0,0:00:00,1,0
20161018-ccc_help_script,2016/10/18,ccc_help_script,10,9,0:00:06,6,0:00:13,1,54
20161018-ccc_link_script,2016/10/18,ccc_link_script,1,0,0:00:00,0,0:00:00,0,0
20161018-ccc_media_line_script,2016/10/18,ccc_media_line_script,0,0,0:00:00,0,0:00:00,0,0
20161018-ccc_priority_script,2016/10/18,ccc_priority_script,21,21,0:00:12,12,0:01:45,0,252
20161018-ccc_tax_script,2016/10/18,ccc_tax_script,13,12,0:00:52,52,0:03:10,1,624
20161018-ccc_waste_recycling_script,2016/10/18,ccc_waste_recycling_script,0,0,0:00:00,0,0:00:00,0,0
20161019-ccc_311_calgary_script,2016/10/19,ccc_311_calgary_script,2741,2587,0:00:44,44,0:05:21,154,113828
20161019-ccc_311_lobby_ph_script,2016/10/19,ccc_311_lobby_ph_script,1,1,0:00:05,5,0:00:05,0,5
20161019-ccc_aserv_info_script,2016/10/19,ccc_aserv_info_script,0,0,0:00:00,0,0:00:00,0,0
20161019-ccc_bylaw_script,2016/10/19,ccc_bylaw_script,0,0,0:00:00,0,0:00:00,0,0
20161019-ccc_city_script,2016/10/19,ccc_city_script,14,13,0:00:08,8,0:00:48,1,104
20161019-ccc_cty_online_script,2016/10/19,ccc_cty_online_script,0,0,0:00:00,0,0:00:00,0,0
20161019-ccc_feedback_script,2016/10/19,ccc_feedback_script,0,0,0:00:00,0,0:00:00,0,0
20161019-ccc_fpb_script,2016/10/19,ccc_fpb_script,0,0,0:00:00,0,0:00:00,0,0
20161019-ccc_help_script,2016/10/19,ccc_help_script,14,14,0:00:05,5,0:00:12,0,70
20161019-ccc_link_script,2016/10/19,ccc_link_script,0,0,0:00:00,0,0:00:00,0,0
20161019-ccc_media_line_script,2016/10/19,ccc_media_line_script,0,0,0:00:00,0,0:00:00,0,0
20161019-ccc_priority_script,2016/10/19,ccc_priority_script,27,26,0:00:07,7,0:00:36,1,182
20161019-ccc_tax_script,2016/10/19,ccc_tax_script,15,15,0:01:07,67,0:03:23,0,1005
20161019-ccc_waste_recycling_script,2016/10/19,ccc_waste_recycling_script,0,0,0:00:00,0,0:00:00,0,0
20161020-ccc_311_calgary_script,2016/10/20,ccc_311_calgary_script,2825,2647,0:00:51,51,0:05:47,178,134997
20161020-ccc_311_lobby_ph_script,2016/10/20,ccc_311_lobby_ph_script,3,2,0:00:08,8,0:00:12,1,16
20161020-ccc_aserv_info_script,2016/10/20,ccc_aserv_info_script,0,0,0:00:00,0,0:00:00,0,0
20161020-ccc_bylaw_script,2016/10/20,ccc_bylaw_script,0,0,0:00:00,0,0:00:00,0,0
20161020-ccc_city_script,2016/10/20,ccc_city_script,10,10,0:00:07,7,0:00:18,0,70
20161020-ccc_cty_online_script,2016/10/20,ccc_cty_online_script,0,0,0:00:00,0,0:00:00,0,0
20161020-ccc_feedback_script,2016/10/20,ccc_feedback_script,1,0,0:00:00,0,0:00:00,0,0
20161020-ccc_fpb_script,2016/10/20,ccc_fpb_script,0,0,0:00:00,0,0:00:00,0,0
20161020-ccc_help_script,2016/10/20,ccc_help_script,10,7,0:00:07,7,0:00:18,3,49
20161020-ccc_link_script,2016/10/20,ccc_link_script,0,0,0:00:00,0,0:00:00,0,0
20161020-ccc_media_line_script,2016/10/20,ccc_media_line_script,0,0,0:00:00,0,0:00:00,0,0
20161020-ccc_priority_script,2016/10/20,ccc_priority_script,25,25,0:00:07,7,0:00:30,0,175
20161020-ccc_tax_script,2016/10/20,ccc_tax_script,26,25,0:01:24,84,0:05:00,1,2100
20161020-ccc_waste_recycling_script,2016/10/20,ccc_waste_recycling_script,0,0,0:00:00,0,0:00:00,0,0
20161021-ccc_311_calgary_script,2016/10/21,ccc_311_calgary_script,2730,2475,0:01:25,85,0:09:40,255,210375
20161021-ccc_311_lobby_ph_script,2016/10/21,ccc_311_lobby_ph_script,0,0,0:00:00,0,0:00:00,0,0
20161021-ccc_aserv_info_script,2016/10/21,ccc_aserv_info_script,0,0,0:00:00,0,0:00:00,0,0
20161021-ccc_bylaw_script,2016/10/21,ccc_bylaw_script,0,0,0:00:00,0,0:00:00,0,0
20161021-ccc_city_script,2016/10/21,ccc_city_script,19,18,0:00:28,28,0:04:21,1,504
20161021-ccc_cty_online_script,2016/10/21,ccc_cty_online_script,0,0,0:00:00,0,0:00:00,0,0
20161021-ccc_feedback_script,2016/10/21,ccc_feedback_script,0,0,0:00:00,0,0:00:00,0,0
20161021-ccc_fpb_script,2016/10/21,ccc_fpb_script,1,1,0:00:05,5,0:00:05,0,5
20161021-ccc_help_script,2016/10/21,ccc_help_script,11,10,0:00:10,10,0:00:40,1,100
20161021-ccc_link_script,2016/10/21,ccc_link_script,0,0,0:00:00,0,0:00:00,0,0
20161021-ccc_media_line_script,2016/10/21,ccc_media_line_script,2,2,0:00:07,7,0:00:07,0,14
20161021-ccc_priority_script,2016/10/21,ccc_priority_script,21,19,0:00:07,7,0:00:24,1,133
20161021-ccc_tax_script,2016/10/21,ccc_tax_script,17,16,0:01:49,109,0:05:04,1,1744
20161021-ccc_waste_recycling_script,2016/10/21,ccc_waste_recycling_script,0,0,0:00:00,0,0:00:00,0,0
20161022-ccc_311_calgary_script,2016/10/22,ccc_311_calgary_script,1154,1117,0:00:22,22,0:06:01,37,24574
20161022-ccc_311_lobby_ph_script,2016/10/22,ccc_311_lobby_ph_script,0,0,0:00:00,0,0:00:00,0,0
20161022-ccc_aserv_info_script,2016/10/22,ccc_aserv_info_script,0,0,0:00:00,0,0:00:00,0,0
20161022-ccc_bylaw_script,2016/10/22,ccc_bylaw_script,0,0,0:00:00,0,0:00:00,0,0
20161022-ccc_city_script,2016/10/22,ccc_city_script,0,0,0:00:00,0,0:00:00,0,0
20161022-ccc_cty_online_script,2016/10/22,ccc_cty_online_script,0,0,0:00:00,0,0:00:00,0,0
20161022-ccc_feedback_script,2016/10/22,ccc_feedback_script,0,0,0:00:00,0,0:00:00,0,0
20161022-ccc_fpb_script,2016/10/22,ccc_fpb_script,0,0,0:00:00,0,0:00:00,0,0
20161022-ccc_help_script,2016/10/22,ccc_help_script,6,6,0:00:12,12,0:00:33,0,72
20161022-ccc_link_script,2016/10/22,ccc_link_script,0,0,0:00:00,0,0:00:00,0,0
20161022-ccc_media_line_script,2016/10/22,ccc_media_line_script,2,2,0:00:09,9,0:00:13,0,18
20161022-ccc_priority_script,2016/10/22,ccc_priority_script,15,15,0:00:08,8,0:00:24,0,120
20161022-ccc_tax_script,2016/10/22,ccc_tax_script,1,1,0:00:03,3,0:00:03,0,3
20161022-ccc_waste_recycling_script,2016/10/22,ccc_waste_recycling_script,0,0,0:00:00,0,0:00:00,0,0
20161024-ccc_311_calgary_script,2016/10/24,ccc_311_calgary_script,3135,2803,0:01:44,104,0:09:30,332,291512
20161024-ccc_media_line_script,2016/10/24,ccc_media_line_script,0,0,0:00:00,0,0:00:00,0,0
20161024-ccc_priority_script,2016/10/24,ccc_priority_script,28,25,0:00:10,10,0:00:54,3,250
20161024-ccc_tax_script,2016/10/24,ccc_tax_script,22,21,0:02:56,176,0:07:05,1,3696
20161024-ccc_waste_recycling_script,2016/10/24,ccc_waste_recycling_script,0,0,0:00:00,0,0:00:00,0,0
20161025-ccc_311_calgary_script,2016/10/25,ccc_311_calgary_script,2882,2612,0:01:20,80,0:11:13,270,208960
20161025-ccc_311_lobby_ph_script,2016/10/25,ccc_311_lobby_ph_script,2,2,0:00:05,5,0:00:05,0,10
20161025-ccc_aserv_info_script,2016/10/25,ccc_aserv_info_script,0,0,0:00:00,0,0:00:00,0,0
20161025-ccc_bylaw_script,2016/10/25,ccc_bylaw_script,0,0,0:00:00,0,0:00:00,0,0
20161025-ccc_city_script,2016/10/25,ccc_city_script,18,16,0:00:55,55,0:03:53,2,880
20161025-ccc_cty_online_script,2016/10/25,ccc_cty_online_script,0,0,0:00:00,0,0:00:00,0,0
20161025-ccc_feedback_script,2016/10/25,ccc_feedback_script,0,0,0:00:00,0,0:00:00,0,0
20161025-ccc_fpb_script,2016/10/25,ccc_fpb_script,1,1,0:00:04,4,0:00:04,0,4
20161025-ccc_help_script,2016/10/25,ccc_help_script,10,9,0:00:11,11,0:00:24,1,99
20161025-ccc_link_script,2016/10/25,ccc_link_script,0,0,0:00:00,0,0:00:00,0,0
20161025-ccc_media_line_script,2016/10/25,ccc_media_line_script,0,0,0:00:00,0,0:00:00,0,0
20161025-ccc_priority_script,2016/10/25,ccc_priority_script,25,25,0:00:09,9,0:00:42,0,225
20161025-ccc_tax_script,2016/10/25,ccc_tax_script,15,15,0:01:31,91,0:04:48,0,1365
20161025-ccc_waste_recycling_script,2016/10/25,ccc_waste_recycling_script,0,0,0:00:00,0,0:00:00,0,0
20161026-ccc_media_line_script,2016/10/26,ccc_media_line_script,0,0,0:00:00,0,0:00:00,0,0
20161026-ccc_priority_script,2016/10/26,ccc_priority_script,35,35,0:00:09,9,0:00:39,0,315
20161026-ccc_tax_script,2016/10/26,ccc_tax_script,16,15,0:00:11,11,0:01:21,1,165
20161026-ccc_waste_recycling_script,2016/10/26,ccc_waste_recycling_script,0,0,0:00:00,0,0:00:00,0,0
20161027-ccc_311_calgary_script,2016/10/27,ccc_311_calgary_script,2810,2605,0:01:00,60,0:06:32,205,156300
20161027-ccc_311_lobby_ph_script,2016/10/27,ccc_311_lobby_ph_script,3,3,0:00:05,5,0:00:08,0,15
20161027-ccc_aserv_info_script,2016/10/27,ccc_aserv_info_script,0,0,0:00:00,0,0:00:00,0,0
20161027-ccc_bylaw_script,2016/10/27,ccc_bylaw_script,0,0,0:00:00,0,0:00:00,0,0
20161027-ccc_city_script,2016/10/27,ccc_city_script,30,29,0:00:16,16,0:01:38,1,464
20161027-ccc_cty_online_script,2016/10/27,ccc_cty_online_script,0,0,0:00:00,0,0:00:00,0,0
20161027-ccc_feedback_script,2016/10/27,ccc_feedback_script,0,0,0:00:00,0,0:00:00,0,0
20161027-ccc_fpb_script,2016/10/27,ccc_fpb_script,5,5,0:00:48,48,0:03:30,0,240
20161027-ccc_help_script,2016/10/27,ccc_help_script,27,24,0:00:17,17,0:01:21,3,408
20161027-ccc_link_script,2016/10/27,ccc_link_script,0,0,0:00:00,0,0:00:00,0,0
20161027-ccc_media_line_script,2016/10/27,ccc_media_line_script,2,1,0:00:19,19,0:00:19,1,19
20161027-ccc_priority_script,2016/10/27,ccc_priority_script,16,16,0:00:17,17,0:01:17,0,272
20161027-ccc_tax_script,2016/10/27,ccc_tax_script,30,30,0:01:07,67,0:04:33,0,2010
20161027-ccc_waste_recycling_script,2016/10/27,ccc_waste_recycling_script,0,0,0:00:00,0,0:00:00,0,0
20161028-ccc_311_calgary_script,2016/10/28,ccc_311_calgary_script,2435,2349,0:00:30,30,0:04:23,86,70470
20161028-ccc_311_lobby_ph_script,2016/10/28,ccc_311_lobby_ph_script,0,0,0:00:00,0,0:00:00,0,0
20161028-ccc_aserv_info_script,2016/10/28,ccc_aserv_info_script,0,0,0:00:00,0,0:00:00,0,0
20161028-ccc_bylaw_script,2016/10/28,ccc_bylaw_script,0,0,0:00:00,0,0:00:00,0,0
20161028-ccc_city_script,2016/10/28,ccc_city_script,24,24,0:00:12,12,0:00:48,0,288
20161028-ccc_cty_online_script,2016/10/28,ccc_cty_online_script,0,0,0:00:00,0,0:00:00,0,0
20161028-ccc_feedback_script,2016/10/28,ccc_feedback_script,1,0,0:00:00,0,0:00:00,0,0
20161028-ccc_fpb_script,2016/10/28,ccc_fpb_script,1,1,0:00:17,17,0:00:17,0,17
20161028-ccc_help_script,2016/10/28,ccc_help_script,24,23,0:00:06,6,0:00:15,1,138
20161028-ccc_link_script,2016/10/28,ccc_link_script,0,0,0:00:00,0,0:00:00,0,0
20161028-ccc_media_line_script,2016/10/28,ccc_media_line_script,0,0,0:00:00,0,0:00:00,0,0
20161028-ccc_priority_script,2016/10/28,ccc_priority_script,26,25,0:00:11,11,0:00:34,1,275
20161028-ccc_tax_script,2016/10/28,ccc_tax_script,14,12,0:00:40,40,0:01:58,2,480
20161028-ccc_waste_recycling_script,2016/10/28,ccc_waste_recycling_script,0,0,0:00:00,0,0:00:00,0,0
20161029-ccc_311_calgary_script,2016/10/29,ccc_311_calgary_script,925,898,0:00:25,25,0:06:22,27,22450
20161029-ccc_311_lobby_ph_script,2016/10/29,ccc_311_lobby_ph_script,0,0,0:00:00,0,0:00:00,0,0
20161029-ccc_aserv_info_script,2016/10/29,ccc_aserv_info_script,0,0,0:00:00,0,0:00:00,0,0
20161029-ccc_bylaw_script,2016/10/29,ccc_bylaw_script,0,0,0:00:00,0,0:00:00,0,0
20161029-ccc_city_script,2016/10/29,ccc_city_script,0,0,0:00:00,0,0:00:00,0,0
20161029-ccc_cty_online_script,2016/10/29,ccc_cty_online_script,0,0,0:00:00,0,0:00:00,0,0
20161029-ccc_feedback_script,2016/10/29,ccc_feedback_script,0,0,0:00:00,0,0:00:00,0,0
20161029-ccc_fpb_script,2016/10/29,ccc_fpb_script,0,0,0:00:00,0,0:00:00,0,0
20161029-ccc_help_script,2016/10/29,ccc_help_script,14,13,0:00:14,14,0:00:49,1,182
20161029-ccc_link_script,2016/10/29,ccc_link_script,0,0,0:00:00,0,0:00:00,0,0
20161029-ccc_media_line_script,2016/10/29,ccc_media_line_script,1,1,0:00:16,16,0:00:16,0,16
20161029-ccc_priority_script,2016/10/29,ccc_priority_script,14,14,0:00:07,7,0:00:15,0,98
20161029-ccc_tax_script,2016/10/29,ccc_tax_script,1,1,0:01:06,66,0:01:06,0,66
20161029-ccc_waste_recycling_script,2016/10/29,ccc_waste_recycling_script,0,0,0:00:00,0,0:00:00,0,0
20161030-ccc_311_calgary_script,2016/10/30,ccc_311_calgary_script,847,807,0:00:22,22,0:05:14,40,17754
20161030-ccc_311_lobby_ph_script,2016/10/30,ccc_311_lobby_ph_script,0,0,0:00:00,0,0:00:00,0,0
20161030-ccc_aserv_info_script,2016/10/30,ccc_aserv_info_script,0,0,0:00:00,0,0:00:00,0,0
20161030-ccc_bylaw_script,2016/10/30,ccc_bylaw_script,0,0,0:00:00,0,0:00:00,0,0
20161030-ccc_city_script,2016/10/30,ccc_city_script,0,0,0:00:00,0,0:00:00,0,0
20161030-ccc_cty_online_script,2016/10/30,ccc_cty_online_script,0,0,0:00:00,0,0:00:00,0,0
20161030-ccc_feedback_script,2016/10/30,ccc_feedback_script,0,0,0:00:00,0,0:00:00,0,0
20161030-ccc_fpb_script,2016/10/30,ccc_fpb_script,0,0,0:00:00,0,0:00:00,0,0
20161030-ccc_help_script,2016/10/30,ccc_help_script,3,3,0:00:12,12,0:00:18,0,36
20161030-ccc_link_script,2016/10/30,ccc_link_script,0,0,0:00:00,0,0:00:00,0,0
20161030-ccc_media_line_script,2016/10/30,ccc_media_line_script,2,2,0:00:04,4,0:00:04,0,8
20161030-ccc_priority_script,2016/10/30,ccc_priority_script,25,23,0:00:08,8,0:00:20,2,184
20161030-ccc_tax_script,2016/10/30,ccc_tax_script,0,0,0:00:00,0,0:00:00,0,0
20161030-ccc_waste_recycling_script,2016/10/30,ccc_waste_recycling_script,0,0,0:00:00,0,0:00:00,0,0
20161031-ccc_311_calgary_script,2016/10/31,ccc_311_calgary_script,3102,2809,0:01:35,95,0:11:03,293,266855
20161031-ccc_311_lobby_ph_script,2016/10/31,ccc_311_lobby_ph_script,6,6,0:00:10,10,0:00:16,0,60
20161031-ccc_aserv_info_script,2016/10/31,ccc_aserv_info_script,0,0,0:00:00,0,0:00:00,0,0
20161031-ccc_bylaw_script,2016/10/31,ccc_bylaw_script,0,0,0:00:00,0,0:00:00,0,0
20161031-ccc_city_script,2016/10/31,ccc_city_script,17,14,0:00:37,37,0:03:41,3,518
20161031-ccc_cty_online_script,2016/10/31,ccc_cty_online_script,0,0,0:00:00,0,0:00:00,0,0
20161031-ccc_feedback_script,2016/10/31,ccc_feedback_script,0,0,0:00:00,0,0:00:00,0,0
20161031-ccc_fpb_script,2016/10/31,ccc_fpb_script,1,1,0:02:18,138,0:02:18,0,138
20161031-ccc_help_script,2016/10/31,ccc_help_script,21,19,0:00:14,14,0:00:43,2,266
20161031-ccc_link_script,2016/10/31,ccc_link_script,0,0,0:00:00,0,0:00:00,0,0
20161031-ccc_media_line_script,2016/10/31,ccc_media_line_script,1,1,0:00:06,6,0:00:06,0,6
20161031-ccc_priority_script,2016/10/31,ccc_priority_script,22,21,0:00:16,16,0:01:11,1,336
20161031-ccc_tax_script,2016/10/31,ccc_tax_script,15,13,0:00:53,53,0:03:46,2,689
20161031-ccc_waste_recycling_script,2016/10/31,ccc_waste_recycling_script,0,0,0:00:00,0,0:00:00,0,0
20161101-ccc_311_calgary_script,2016/11/01,ccc_311_calgary_script,3076,2616,0:02:53,173,0:11:02,460,452568
20161101-ccc_311_lobby_ph_script,2016/11/01,ccc_311_lobby_ph_script,0,0,0:00:00,0,0:00:00,0,0
20161101-ccc_aserv_info_script,2016/11/01,ccc_aserv_info_script,0,0,0:00:00,0,0:00:00,0,0
20161101-ccc_bylaw_script,2016/11/01,ccc_bylaw_script,1,1,0:06:00,360,0:06:00,0,360
20161101-ccc_city_script,2016/11/01,ccc_city_script,8,7,0:01:27,87,0:04:50,1,609
20161101-ccc_cty_online_script,2016/11/01,ccc_cty_online_script,0,0,0:00:00,0,0:00:00,0,0
20161101-ccc_feedback_script,2016/11/01,ccc_feedback_script,0,0,0:00:00,0,0:00:00,0,0
20161101-ccc_fpb_script,2016/11/01,ccc_fpb_script,0,0,0:00:00,0,0:00:00,0,0
20161101-ccc_help_script,2016/11/01,ccc_help_script,33,26,0:00:16,16,0:01:07,7,416
20161101-ccc_link_script,2016/11/01,ccc_link_script,0,0,0:00:00,0,0:00:00,0,0
20161101-ccc_media_line_script,2016/11/01,ccc_media_line_script,0,0,0:00:00,0,0:00:00,0,0
20161101-ccc_priority_script,2016/11/01,ccc_priority_script,30,28,0:00:17,17,0:00:46,2,476
20161101-ccc_tax_script,2016/11/01,ccc_tax_script,22,19,0:03:57,237,0:09:04,3,4503
20161101-ccc_waste_recycling_script,2016/11/01,ccc_waste_recycling_script,0,0,0:00:00,0,0:00:00,0,0
20161102-ccc_311_calgary_script,2016/11/02,ccc_311_calgary_script,3107,2765,0:01:40,100,0:09:00,342,276500
20161102-ccc_311_lobby_ph_script,2016/11/02,ccc_311_lobby_ph_script,2,1,0:00:28,28,0:00:28,1,28
20161102-ccc_aserv_info_script,2016/11/02,ccc_aserv_info_script,0,0,0:00:00,0,0:00:00,0,0
20161102-ccc_bylaw_script,2016/11/02,ccc_bylaw_script,0,0,0:00:00,0,0:00:00,0,0
20161102-ccc_city_script,2016/11/02,ccc_city_script,17,15,0:00:08,8,0:00:26,2,120
20161102-ccc_cty_online_script,2016/11/02,ccc_cty_online_script,0,0,0:00:00,0,0:00:00,0,0
20161102-ccc_feedback_script,2016/11/02,ccc_feedback_script,0,0,0:00:00,0,0:00:00,0,0
20161102-ccc_fpb_script,2016/11/02,ccc_fpb_script,0,0,0:00:00,0,0:00:00,0,0
20161102-ccc_help_script,2016/11/02,ccc_help_script,10,10,0:00:24,24,0:02:56,0,240
20161102-ccc_link_script,2016/11/02,ccc_link_script,0,0,0:00:00,0,0:00:00,0,0
20161102-ccc_media_line_script,2016/11/02,ccc_media_line_script,1,1,0:00:05,5,0:00:05,0,5
20161102-ccc_priority_script,2016/11/02,ccc_priority_script,27,27,0:00:09,9,0:00:38,0,243
20161102-ccc_tax_script,2016/11/02,ccc_tax_script,26,22,0:01:50,110,0:05:24,4,2420
20161102-ccc_waste_recycling_script,2016/11/02,ccc_waste_recycling_script,0,0,0:00:00,0,0:00:00,0,0
20161103-ccc_311_calgary_script,2016/11/03,ccc_311_calgary_script,2974,2754,0:00:57,57,0:10:49,219,156978
20161103-ccc_311_lobby_ph_script,2016/11/03,ccc_311_lobby_ph_script,3,2,0:00:14,14,0:00:16,1,28
20161103-ccc_aserv_info_script,2016/11/03,ccc_aserv_info_script,0,0,0:00:00,0,0:00:00,0,0
20161103-ccc_bylaw_script,2016/11/03,ccc_bylaw_script,0,0,0:00:00,0,0:00:00,0,0
20161103-ccc_city_script,2016/11/03,ccc_city_script,16,16,0:00:07,7,0:00:31,0,112
20161103-ccc_cty_online_script,2016/11/03,ccc_cty_online_script,0,0,0:00:00,0,0:00:00,0,0
20161103-ccc_feedback_script,2016/11/03,ccc_feedback_script,0,0,0:00:00,0,0:00:00,0,0
20161103-ccc_fpb_script,2016/11/03,ccc_fpb_script,1,0,0:00:00,0,0:00:00,1,0
20161103-ccc_help_script,2016/11/03,ccc_help_script,24,23,0:00:11,11,0:00:46,1,253
20161103-ccc_link_script,2016/11/03,ccc_link_script,0,0,0:00:00,0,0:00:00,0,0
20161103-ccc_media_line_script,2016/11/03,ccc_media_line_script,0,0,0:00:00,0,0:00:00,0,0
20161103-ccc_priority_script,2016/11/03,ccc_priority_script,39,39,0:00:12,12,0:01:09,0,468
20161103-ccc_tax_script,2016/11/03,ccc_tax_script,16,15,0:00:52,52,0:03:36,1,780
20161103-ccc_waste_recycling_script,2016/11/03,ccc_waste_recycling_script,0,0,0:00:00,0,0:00:00,0,0
20161104-ccc_311_calgary_script,2016/11/04,ccc_311_calgary_script,2684,2510,0:01:04,64,0:06:46,175,160640
20161104-ccc_311_lobby_ph_script,2016/11/04,ccc_311_lobby_ph_script,5,5,0:00:06,6,0:00:13,0,30
20161104-ccc_aserv_info_script,2016/11/04,ccc_aserv_info_script,0,0,0:00:00,0,0:00:00,0,0
20161104-ccc_bylaw_script,2016/11/04,ccc_bylaw_script,1,1,0:00:11,11,0:00:11,0,11
20161104-ccc_city_script,2016/11/04,ccc_city_script,19,19,0:00:12,12,0:00:38,0,228
20161104-ccc_cty_online_script,2016/11/04,ccc_cty_online_script,0,0,0:00:00,0,0:00:00,0,0
20161104-ccc_feedback_script,2016/11/04,ccc_feedback_script,0,0,0:00:00,0,0:00:00,0,0
20161104-ccc_fpb_script,2016/11/04,ccc_fpb_script,0,0,0:00:00,0,0:00:00,0,0
20161104-ccc_help_script,2016/11/04,ccc_help_script,11,11,0:00:13,13,0:00:38,0,143
20161104-ccc_link_script,2016/11/04,ccc_link_script,0,0,0:00:00,0,0:00:00,0,0
20161104-ccc_media_line_script,2016/11/04,ccc_media_line_script,1,1,0:00:04,4,0:00:04,0,4
20161104-ccc_priority_script,2016/11/04,ccc_priority_script,35,34,0:00:08,8,0:00:51,1,272
20161104-ccc_tax_script,2016/11/04,ccc_tax_script,16,16,0:01:03,63,0:05:16,0,1008
20161104-ccc_waste_recycling_script,2016/11/04,ccc_waste_recycling_script,0,0,0:00:00,0,0:00:00,0,0
20161105-ccc_311_calgary_script,2016/11/05,ccc_311_calgary_script,1227,1103,0:01:21,81,0:08:27,124,89343
20161105-ccc_311_lobby_ph_script,2016/11/05,ccc_311_lobby_ph_script,0,0,0:00:00,0,0:00:00,0,0
20161105-ccc_aserv_info_script,2016/11/05,ccc_aserv_info_script,0,0,0:00:00,0,0:00:00,0,0
20161105-ccc_bylaw_script,2016/11/05,ccc_bylaw_script,0,0,0:00:00,0,0:00:00,0,0
20161105-ccc_city_script,2016/11/05,ccc_city_script,0,0,0:00:00,0,0:00:00,0,0
20161105-ccc_cty_online_script,2016/11/05,ccc_cty_online_script,0,0,0:00:00,0,0:00:00,0,0
20161105-ccc_feedback_script,2016/11/05,ccc_feedback_script,0,0,0:00:00,0,0:00:00,0,0
20161105-ccc_fpb_script,2016/11/05,ccc_fpb_script,1,1,0:00:02,2,0:00:02,0,2
20161105-ccc_help_script,2016/11/05,ccc_help_script,7,7,0:00:07,7,0:00:13,0,49
20161105-ccc_link_script,2016/11/05,ccc_link_script,0,0,0:00:00,0,0:00:00,0,0
20161105-ccc_media_line_script,2016/11/05,ccc_media_line_script,2,2,0:00:55,55,0:01:01,0,110
20161105-ccc_priority_script,2016/11/05,ccc_priority_script,24,24,0:00:17,17,0:01:43,0,408
20161105-ccc_tax_script,2016/11/05,ccc_tax_script,2,2,0:01:42,102,0:02:49,0,204
20161105-ccc_waste_recycling_script,2016/11/05,ccc_waste_recycling_script,0,0,0:00:00,0,0:00:00,0,0
20161106-ccc_311_calgary_script,2016/11/06,ccc_311_calgary_script,866,858,0:00:10,10,0:03:00,8,8580
20161106-ccc_311_lobby_ph_script,2016/11/06,ccc_311_lobby_ph_script,0,0,0:00:00,0,0:00:00,0,0
20161106-ccc_aserv_info_script,2016/11/06,ccc_aserv_info_script,0,0,0:00:00,0,0:00:00,0,0
20161106-ccc_bylaw_script,2016/11/06,ccc_bylaw_script,0,0,0:00:00,0,0:00:00,0,0
20161106-ccc_city_script,2016/11/06,ccc_city_script,0,0,0:00:00,0,0:00:00,0,0
20161106-ccc_cty_online_script,2016/11/06,ccc_cty_online_script,0,0,0:00:00,0,0:00:00,0,0
20161106-ccc_feedback_script,2016/11/06,ccc_feedback_script,0,0,0:00:00,0,0:00:00,0,0
20161106-ccc_fpb_script,2016/11/06,ccc_fpb_script,0,0,0:00:00,0,0:00:00,0,0
20161106-ccc_help_script,2016/11/06,ccc_help_script,4,3,0:00:03,3,0:00:04,1,9
20161106-ccc_link_script,2016/11/06,ccc_link_script,0,0,0:00:00,0,0:00:00,0,0
20161106-ccc_media_line_script,2016/11/06,ccc_media_line_script,0,0,0:00:00,0,0:00:00,0,0
20161106-ccc_priority_script,2016/11/06,ccc_priority_script,17,17,0:00:07,7,0:00:34,0,119
20161106-ccc_tax_script,2016/11/06,ccc_tax_script,1,1,0:00:02,2,0:00:02,0,2
20161106-ccc_waste_recycling_script,2016/11/06,ccc_waste_recycling_script,0,0,0:00:00,0,0:00:00,0,0
20161107-ccc_311_calgary_script,2016/11/07,ccc_311_calgary_script,3045,2837,0:01:04,64,0:08:05,208,181568
20161107-ccc_311_lobby_ph_script,2016/11/07,ccc_311_lobby_ph_script,8,6,0:00:04,4,0:00:09,2,24
20161107-ccc_aserv_info_script,2016/11/07,ccc_aserv_info_script,0,0,0:00:00,0,0:00:00,0,0
20161107-ccc_bylaw_script,2016/11/07,ccc_bylaw_script,0,0,0:00:00,0,0:00:00,0,0
20161107-ccc_city_script,2016/11/07,ccc_city_script,27,27,0:00:20,20,0:03:08,0,540
20161107-ccc_cty_online_script,2016/11/07,ccc_cty_online_script,0,0,0:00:00,0,0:00:00,0,0
20161107-ccc_feedback_script,2016/11/07,ccc_feedback_script,0,0,0:00:00,0,0:00:00,0,0
20161107-ccc_fpb_script,2016/11/07,ccc_fpb_script,0,0,0:00:00,0,0:00:00,0,0
20161107-ccc_help_script,2016/11/07,ccc_help_script,6,6,0:00:06,6,0:00:14,0,36
20161107-ccc_link_script,2016/11/07,ccc_link_script,0,0,0:00:00,0,0:00:00,0,0
20161107-ccc_media_line_script,2016/11/07,ccc_media_line_script,2,2,0:00:06,6,0:00:10,0,12
20161107-ccc_priority_script,2016/11/07,ccc_priority_script,27,27,0:00:09,9,0:00:53,0,243
20161107-ccc_tax_script,2016/11/07,ccc_tax_script,15,15,0:01:23,83,0:06:16,0,1245
20161107-ccc_waste_recycling_script,2016/11/07,ccc_waste_recycling_script,0,0,0:00:00,0,0:00:00,0,0
20161108-ccc_311_calgary_script,2016/11/08,ccc_311_calgary_script,2683,2550,0:00:47,47,0:09:04,133,119850
20161108-ccc_311_lobby_ph_script,2016/11/08,ccc_311_lobby_ph_script,0,0,0:00:00,0,0:00:00,0,0
20161108-ccc_aserv_info_script,2016/11/08,ccc_aserv_info_script,0,0,0:00:00,0,0:00:00,0,0
20161108-ccc_bylaw_script,2016/11/08,ccc_bylaw_script,0,0,0:00:00,0,0:00:00,0,0
20161108-ccc_city_script,2016/11/08,ccc_city_script,34,32,0:00:17,17,0:02:29,2,544
20161108-ccc_cty_online_script,2016/11/08,ccc_cty_online_script,0,0,0:00:00,0,0:00:00,0,0
20161108-ccc_feedback_script,2016/11/08,ccc_feedback_script,0,0,0:00:00,0,0:00:00,0,0
20161108-ccc_fpb_script,2016/11/08,ccc_fpb_script,1,0,0:00:00,0,0:00:00,1,0
20161108-ccc_help_script,2016/11/08,ccc_help_script,22,19,0:00:13,13,0:01:02,3,247
20161108-ccc_link_script,2016/11/08,ccc_link_script,0,0,0:00:00,0,0:00:00,0,0
20161108-ccc_media_line_script,2016/11/08,ccc_media_line_script,1,1,0:00:04,4,0:00:04,0,4
20161108-ccc_priority_script,2016/11/08,ccc_priority_script,33,31,0:00:09,9,0:00:26,2,279
20161108-ccc_tax_script,2016/11/08,ccc_tax_script,16,15,0:00:14,14,0:01:01,1,210
20161108-ccc_waste_recycling_script,2016/11/08,ccc_waste_recycling_script,0,0,0:00:00,0,0:00:00,0,0
20161109-ccc_311_calgary_script,2016/11/09,ccc_311_calgary_script,2589,2536,0:00:15,15,0:03:39,53,38040
20161109-ccc_311_lobby_ph_script,2016/11/09,ccc_311_lobby_ph_script,4,3,0:00:05,5,0:00:08,1,15
20161109-ccc_aserv_info_script,2016/11/09,ccc_aserv_info_script,0,0,0:00:00,0,0:00:00,0,0
20161109-ccc_bylaw_script,2016/11/09,ccc_bylaw_script,0,0,0:00:00,0,0:00:00,0,0
20161109-ccc_city_script,2016/11/09,ccc_city_script,21,21,0:00:09,9,0:00:33,0,189
20161109-ccc_cty_online_script,2016/11/09,ccc_cty_online_script,0,0,0:00:00,0,0:00:00,0,0
20161109-ccc_feedback_script,2016/11/09,ccc_feedback_script,0,0,0:00:00,0,0:00:00,0,0
20161109-ccc_fpb_script,2016/11/09,ccc_fpb_script,1,1,0:00:06,6,0:00:06,0,6
20161109-ccc_help_script,2016/11/09,ccc_help_script,13,12,0:00:08,8,0:00:26,1,96
20161109-ccc_link_script,2016/11/09,ccc_link_script,0,0,0:00:00,0,0:00:00,0,0
20161109-ccc_media_line_script,2016/11/09,ccc_media_line_script,1,1,0:00:09,9,0:00:09,0,9
20161109-ccc_priority_script,2016/11/09,ccc_priority_script,35,35,0:00:07,7,0:00:51,0,245
20161109-ccc_tax_script,2016/11/09,ccc_tax_script,14,14,0:00:09,9,0:00:38,0,126
20161109-ccc_waste_recycling_script,2016/11/09,ccc_waste_recycling_script,0,0,0:00:00,0,0:00:00,0,0
20161110-ccc_311_calgary_script,2016/11/10,ccc_311_calgary_script,2729,2672,0:00:18,18,0:04:24,57,48096
20161110-ccc_311_lobby_ph_script,2016/11/10,ccc_311_lobby_ph_script,2,2,0:00:23,23,0:00:43,0,46
20161110-ccc_aserv_info_script,2016/11/10,ccc_aserv_info_script,0,0,0:00:00,0,0:00:00,0,0
20161110-ccc_bylaw_script,2016/11/10,ccc_bylaw_script,0,0,0:00:00,0,0:00:00,0,0
20161110-ccc_city_script,2016/11/10,ccc_city_script,17,17,0:00:06,6,0:00:19,0,102
20161110-ccc_cty_online_script,2016/11/10,ccc_cty_online_script,0,0,0:00:00,0,0:00:00,0,0
20161110-ccc_feedback_script,2016/11/10,ccc_feedback_script,1,0,0:00:00,0,0:00:00,0,0
20161110-ccc_fpb_script,2016/11/10,ccc_fpb_script,0,0,0:00:00,0,0:00:00,0,0
20161110-ccc_help_script,2016/11/10,ccc_help_script,11,11,0:00:06,6,0:00:11,0,66
20161110-ccc_link_script,2016/11/10,ccc_link_script,0,0,0:00:00,0,0:00:00,0,0
20161110-ccc_media_line_script,2016/11/10,ccc_media_line_script,0,0,0:00:00,0,0:00:00,0,0
20161110-ccc_priority_script,2016/11/10,ccc_priority_script,18,18,0:00:05,5,0:00:10,0,90
20161110-ccc_tax_script,2016/11/10,ccc_tax_script,27,24,0:00:15,15,0:01:15,3,360
20161110-ccc_waste_recycling_script,2016/11/10,ccc_waste_recycling_script,0,0,0:00:00,0,0:00:00,0,0
20161111-ccc_311_calgary_script,2016/11/11,ccc_311_calgary_script,1384,1376,0:00:09,9,0:04:59,8,12384
20161111-ccc_311_lobby_ph_script,2016/11/11,ccc_311_lobby_ph_script,1,1,0:00:02,2,0:00:02,0,2
20161111-ccc_aserv_info_script,2016/11/11,ccc_aserv_info_script,0,0,0:00:00,0,0:00:00,0,0
20161111-ccc_bylaw_script,2016/11/11,ccc_bylaw_script,0,0,0:00:00,0,0:00:00,0,0
20161111-ccc_city_script,2016/11/11,ccc_city_script,0,0,0:00:00,0,0:00:00,0,0
20161111-ccc_cty_online_script,2016/11/11,ccc_cty_online_script,0,0,0:00:00,0,0:00:00,0,0
20161111-ccc_feedback_script,2016/11/11,ccc_feedback_script,0,0,0:00:00,0,0:00:00,0,0
20161111-ccc_fpb_script,2016/11/11,ccc_fpb_script,0,0,0:00:00,0,0:00:00,0,0
20161111-ccc_help_script,2016/11/11,ccc_help_script,6,6,0:00:06,6,0:00:07,0,36
20161111-ccc_link_script,2016/11/11,ccc_link_script,0,0,0:00:00,0,0:00:00,0,0
20161111-ccc_media_line_script,2016/11/11,ccc_media_line_script,2,2,0:00:07,7,0:00:09,0,14
20161111-ccc_priority_script,2016/11/11,ccc_priority_script,16,16,0:00:07,7,0:00:35,0,112
20161111-ccc_tax_script,2016/11/11,ccc_tax_script,1,1,0:00:02,2,0:00:02,0,2
20161111-ccc_waste_recycling_script,2016/11/11,ccc_waste_recycling_script,0,0,0:00:00,0,0:00:00,0,0
20161112-ccc_311_calgary_script,2016/11/12,ccc_311_calgary_script,988,963,0:00:16,16,0:05:19,25,15408
20161112-ccc_311_lobby_ph_script,2016/11/12,ccc_311_lobby_ph_script,0,0,0:00:00,0,0:00:00,0,0
20161112-ccc_aserv_info_script,2016/11/12,ccc_aserv_info_script,0,0,0:00:00,0,0:00:00,0,0
20161112-ccc_bylaw_script,2016/11/12,ccc_bylaw_script,0,0,0:00:00,0,0:00:00,0,0
20161112-ccc_city_script,2016/11/12,ccc_city_script,0,0,0:00:00,0,0:00:00,0,0
20161112-ccc_cty_online_script,2016/11/12,ccc_cty_online_script,0,0,0:00:00,0,0:00:00,0,0
20161112-ccc_feedback_script,2016/11/12,ccc_feedback_script,0,0,0:00:00,0,0:00:00,0,0
20161112-ccc_fpb_script,2016/11/12,ccc_fpb_script,0,0,0:00:00,0,0:00:00,0,0
20161112-ccc_help_script,2016/11/12,ccc_help_script,9,7,0:00:06,6,0:00:17,2,42
20161112-ccc_link_script,2016/11/12,ccc_link_script,0,0,0:00:00,0,0:00:00,0,0
20161112-ccc_media_line_script,2016/11/12,ccc_media_line_script,1,1,0:00:43,43,0:00:43,0,43
20161112-ccc_priority_script,2016/11/12,ccc_priority_script,14,14,0:00:07,7,0:00:16,0,98
20161112-ccc_tax_script,2016/11/12,ccc_tax_script,1,1,0:00:43,43,0:00:43,0,43
20161112-ccc_waste_recycling_script,2016/11/12,ccc_waste_recycling_script,0,0,0:00:00,0,0:00:00,0,0
20161113-ccc_311_calgary_script,2016/11/13,ccc_311_calgary_script,731,717,0:00:14,14,0:06:36,13,10038
20161113-ccc_311_lobby_ph_script,2016/11/13,ccc_311_lobby_ph_script,0,0,0:00:00,0,0:00:00,0,0
20161113-ccc_aserv_info_script,2016/11/13,ccc_aserv_info_script,0,0,0:00:00,0,0:00:00,0,0
20161113-ccc_bylaw_script,2016/11/13,ccc_bylaw_script,0,0,0:00:00,0,0:00:00,0,0
20161113-ccc_city_script,2016/11/13,ccc_city_script,0,0,0:00:00,0,0:00:00,0,0
20161113-ccc_cty_online_script,2016/11/13,ccc_cty_online_script,0,0,0:00:00,0,0:00:00,0,0
20161113-ccc_feedback_script,2016/11/13,ccc_feedback_script,0,0,0:00:00,0,0:00:00,0,0
20161113-ccc_fpb_script,2016/11/13,ccc_fpb_script,1,1,0:00:04,4,0:00:04,0,4
20161113-ccc_help_script,2016/11/13,ccc_help_script,3,3,0:00:06,6,0:00:08,0,18
20161113-ccc_link_script,2016/11/13,ccc_link_script,0,0,0:00:00,0,0:00:00,0,0
20161113-ccc_media_line_script,2016/11/13,ccc_media_line_script,2,2,0:00:13,13,0:00:19,0,26
20161113-ccc_priority_script,2016/11/13,ccc_priority_script,17,17,0:00:19,19,0:03:27,0,323
20161113-ccc_tax_script,2016/11/13,ccc_tax_script,0,0,0:00:00,0,0:00:00,0,0
20161113-ccc_waste_recycling_script,2016/11/13,ccc_waste_recycling_script,0,0,0:00:00,0,0:00:00,0,0
20161114-ccc_311_calgary_script,2016/11/14,ccc_311_calgary_script,3003,2936,0:00:26,26,0:05:33,67,76336
20161114-ccc_311_lobby_ph_script,2016/11/14,ccc_311_lobby_ph_script,1,1,0:00:21,21,0:00:21,0,21
20161114-ccc_aserv_info_script,2016/11/14,ccc_aserv_info_script,0,0,0:00:00,0,0:00:00,0,0
20161114-ccc_bylaw_script,2016/11/14,ccc_bylaw_script,0,0,0:00:00,0,0:00:00,0,0
20161114-ccc_city_script,2016/11/14,ccc_city_script,21,21,0:00:08,8,0:00:23,0,168
20161114-ccc_cty_online_script,2016/11/14,ccc_cty_online_script,0,0,0:00:00,0,0:00:00,0,0
20161114-ccc_feedback_script,2016/11/14,ccc_feedback_script,0,0,0:00:00,0,0:00:00,0,0
20161114-ccc_fpb_script,2016/11/14,ccc_fpb_script,0,0,0:00:00,0,0:00:00,0,0
20161114-ccc_help_script,2016/11/14,ccc_help_script,6,6,0:00:06,6,0:00:14,0,36
20161114-ccc_link_script,2016/11/14,ccc_link_script,0,0,0:00:00,0,0:00:00,0,0
20161114-ccc_media_line_script,2016/11/14,ccc_media_line_script,3,3,0:00:03,3,0:00:04,0,9
20161114-ccc_priority_script,2016/11/14,ccc_priority_script,26,25,0:00:07,7,0:00:40,1,175
20161114-ccc_tax_script,2016/11/14,ccc_tax_script,12,12,0:00:54,54,0:02:43,0,648
20161114-ccc_waste_recycling_script,2016/11/14,ccc_waste_recycling_script,0,0,0:00:00,0,0:00:00,0,0
20161115-ccc_311_calgary_script,2016/11/15,ccc_311_calgary_script,2561,2528,0:00:10,10,0:04:55,33,25280
20161115-ccc_311_lobby_ph_script,2016/11/15,ccc_311_lobby_ph_script,1,1,0:00:05,5,0:00:05,0,5
20161115-ccc_aserv_info_script,2016/11/15,ccc_aserv_info_script,0,0,0:00:00,0,0:00:00,0,0
20161115-ccc_bylaw_script,2016/11/15,ccc_bylaw_script,0,0,0:00:00,0,0:00:00,0,0
20161115-ccc_city_script,2016/11/15,ccc_city_script,14,14,0:00:06,6,0:00:20,0,84
20161115-ccc_cty_online_script,2016/11/15,ccc_cty_online_script,0,0,0:00:00,0,0:00:00,0,0
20161115-ccc_feedback_script,2016/11/15,ccc_feedback_script,0,0,0:00:00,0,0:00:00,0,0
20161115-ccc_fpb_script,2016/11/15,ccc_fpb_script,0,0,0:00:00,0,0:00:00,0,0
20161115-ccc_help_script,2016/11/15,ccc_help_script,11,11,0:00:08,8,0:00:18,0,88
20161115-ccc_link_script,2016/11/15,ccc_link_script,0,0,0:00:00,0,0:00:00,0,0
20161115-ccc_media_line_script,2016/11/15,ccc_media_line_script,0,0,0:00:00,0,0:00:00,0,0
20161115-ccc_priority_script,2016/11/15,ccc_priority_script,18,17,0:00:09,9,0:00:36,1,153
20161115-ccc_tax_script,2016/11/15,ccc_tax_script,14,14,0:00:14,14,0:01:35,0,196
20161115-ccc_waste_recycling_script,2016/11/15,ccc_waste_recycling_script,0,0,0:00:00,0,0:00:00,0,0
20161116-ccc_311_calgary_script,2016/11/16,ccc_311_calgary_script,2501,2450,0:00:13,13,0:04:10,51,31850
20161116-ccc_311_lobby_ph_script,2016/11/16,ccc_311_lobby_ph_script,0,0,0:00:00,0,0:00:00,0,0
20161116-ccc_aserv_info_script,2016/11/16,ccc_aserv_info_script,0,0,0:00:00,0,0:00:00,0,0
20161116-ccc_bylaw_script,2016/11/16,ccc_bylaw_script,0,0,0:00:00,0,0:00:00,0,0
20161116-ccc_city_script,2016/11/16,ccc_city_script,13,13,0:00:10,10,0:00:28,0,130
20161116-ccc_cty_online_script,2016/11/16,ccc_cty_online_script,0,0,0:00:00,0,0:00:00,0,0
20161116-ccc_feedback_script,2016/11/16,ccc_feedback_script,0,0,0:00:00,0,0:00:00,0,0
20161116-ccc_fpb_script,2016/11/16,ccc_fpb_script,0,0,0:00:00,0,0:00:00,0,0
20161116-ccc_help_script,2016/11/16,ccc_help_script,8,8,0:00:06,6,0:00:14,0,48
20161116-ccc_link_script,2016/11/16,ccc_link_script,1,0,0:00:00,0,0:00:00,1,0
20161116-ccc_media_line_script,2016/11/16,ccc_media_line_script,0,0,0:00:00,0,0:00:00,0,0
20161116-ccc_priority_script,2016/11/16,ccc_priority_script,22,22,0:00:07,7,0:00:16,0,154
20161116-ccc_tax_script,2016/11/16,ccc_tax_script,17,17,0:00:16,16,0:01:16,0,272
20161116-ccc_waste_recycling_script,2016/11/16,ccc_waste_recycling_script,0,0,0:00:00,0,0:00:00,0,0
20161117-ccc_311_calgary_script,2016/11/17,ccc_311_calgary_script,2407,2374,0:00:11,11,0:04:31,33,26114
20161117-ccc_311_lobby_ph_script,2016/11/17,ccc_311_lobby_ph_script,3,3,0:00:05,5,0:00:10,0,15
20161117-ccc_aserv_info_script,2016/11/17,ccc_aserv_info_script,0,0,0:00:00,0,0:00:00,0,0
20161117-ccc_bylaw_script,2016/11/17,ccc_bylaw_script,0,0,0:00:00,0,0:00:00,0,0
20161117-ccc_city_script,2016/11/17,ccc_city_script,22,22,0:00:12,12,0:00:42,0,264
20161117-ccc_cty_online_script,2016/11/17,ccc_cty_online_script,0,0,0:00:00,0,0:00:00,0,0
20161117-ccc_feedback_script,2016/11/17,ccc_feedback_script,0,0,0:00:00,0,0:00:00,0,0
20161117-ccc_fpb_script,2016/11/17,ccc_fpb_script,0,0,0:00:00,0,0:00:00,0,0
20161117-ccc_help_script,2016/11/17,ccc_help_script,8,8,0:00:12,12,0:00:48,0,96
20161117-ccc_link_script,2016/11/17,ccc_link_script,0,0,0:00:00,0,0:00:00,0,0
20161117-ccc_media_line_script,2016/11/17,ccc_media_line_script,0,0,0:00:00,0,0:00:00,0,0
20161117-ccc_priority_script,2016/11/17,ccc_priority_script,53,53,0:00:09,9,0:00:47,0,477
20161117-ccc_tax_script,2016/11/17,ccc_tax_script,16,16,0:00:13,13,0:00:43,0,208
20161117-ccc_waste_recycling_script,2016/11/17,ccc_waste_recycling_script,0,0,0:00:00,0,0:00:00,0,0
20161118-ccc_311_calgary_script,2016/11/18,ccc_311_calgary_script,2270,2221,0:00:18,18,0:04:02,49,39978
20161118-ccc_311_lobby_ph_script,2016/11/18,ccc_311_lobby_ph_script,1,1,0:00:05,5,0:00:05,0,5
20161118-ccc_aserv_info_script,2016/11/18,ccc_aserv_info_script,0,0,0:00:00,0,0:00:00,0,0
20161118-ccc_bylaw_script,2016/11/18,ccc_bylaw_script,0,0,0:00:00,0,0:00:00,0,0
20161118-ccc_city_script,2016/11/18,ccc_city_script,30,30,0:00:08,8,0:00:31,0,240
20161118-ccc_cty_online_script,2016/11/18,ccc_cty_online_script,0,0,0:00:00,0,0:00:00,0,0
20161118-ccc_feedback_script,2016/11/18,ccc_feedback_script,0,0,0:00:00,0,0:00:00,0,0
20161118-ccc_fpb_script,2016/11/18,ccc_fpb_script,2,2,0:00:03,3,0:00:03,0,6
20161118-ccc_help_script,2016/11/18,ccc_help_script,10,10,0:00:11,11,0:00:39,0,110
20161118-ccc_link_script,2016/11/18,ccc_link_script,0,0,0:00:00,0,0:00:00,0,0
20161118-ccc_media_line_script,2016/11/18,ccc_media_line_script,0,0,0:00:00,0,0:00:00,0,0
20161118-ccc_priority_script,2016/11/18,ccc_priority_script,19,17,0:00:15,15,0:01:51,2,255
20161119-ccc_city_script,2016/11/19,ccc_city_script,0,0,0:00:00,0,0:00:00,0,0
20161119-ccc_cty_online_script,2016/11/19,ccc_cty_online_script,0,0,0:00:00,0,0:00:00,0,0
20161010-ccc_311_calgary_script,2016/10/10,ccc_311_calgary_script,798,785,0:00:07,7,0:02:05,13,5495
20161010-ccc_311_lobby_ph_script,2016/10/10,ccc_311_lobby_ph_script,0,0,0:00:00,0,0:00:00,0,0
20161010-ccc_aserv_info_script,2016/10/10,ccc_aserv_info_script,0,0,0:00:00,0,0:00:00,0,0
20161010-ccc_bylaw_script,2016/10/10,ccc_bylaw_script,0,0,0:00:00,0,0:00:00,0,0
20161010-ccc_city_script,2016/10/10,ccc_city_script,0,0,0:00:00,0,0:00:00,0,0
20161010-ccc_cty_online_script,2016/10/10,ccc_cty_online_script,0,0,0:00:00,0,0:00:00,0,0
20161010-ccc_feedback_script,2016/10/10,ccc_feedback_script,0,0,0:00:00,0,0:00:00,0,0
20161010-ccc_fpb_script,2016/10/10,ccc_fpb_script,0,0,0:00:00,0,0:00:00,0,0
20161010-ccc_help_script,2016/10/10,ccc_help_script,7,7,0:00:06,6,0:00:14,0,42
20161010-ccc_link_script,2016/10/10,ccc_link_script,0,0,0:00:00,0,0:00:00,0,0
20161010-ccc_media_line_script,2016/10/10,ccc_media_line_script,2,2,0:00:05,5,0:00:05,0,10
20161010-ccc_priority_script,2016/10/10,ccc_priority_script,13,13,0:00:05,5,0:00:09,0,65
20161010-ccc_tax_script,2016/10/10,ccc_tax_script,0,0,0:00:00,0,0:00:00,0,0
20161010-ccc_waste_recycling_script,2016/10/10,ccc_waste_recycling_script,0,0,0:00:00,0,0:00:00,0,0
20161023-ccc_311_calgary_script,2016/10/23,ccc_311_calgary_script,855,836,0:00:16,16,0:06:38,19,13376
20161023-ccc_311_lobby_ph_script,2016/10/23,ccc_311_lobby_ph_script,0,0,0:00:00,0,0:00:00,0,0
20161023-ccc_aserv_info_script,2016/10/23,ccc_aserv_info_script,0,0,0:00:00,0,0:00:00,0,0
20161023-ccc_bylaw_script,2016/10/23,ccc_bylaw_script,0,0,0:00:00,0,0:00:00,0,0
20161023-ccc_city_script,2016/10/23,ccc_city_script,0,0,0:00:00,0,0:00:00,0,0
20161023-ccc_cty_online_script,2016/10/23,ccc_cty_online_script,0,0,0:00:00,0,0:00:00,0,0
20161023-ccc_feedback_script,2016/10/23,ccc_feedback_script,0,0,0:00:00,0,0:00:00,0,0
20161023-ccc_fpb_script,2016/10/23,ccc_fpb_script,0,0,0:00:00,0,0:00:00,0,0
20161023-ccc_help_script,2016/10/23,ccc_help_script,2,2,0:00:06,6,0:00:08,0,12
20161023-ccc_link_script,2016/10/23,ccc_link_script,0,0,0:00:00,0,0:00:00,0,0
20161023-ccc_media_line_script,2016/10/23,ccc_media_line_script,0,0,0:00:00,0,0:00:00,0,0
20161023-ccc_priority_script,2016/10/23,ccc_priority_script,25,25,0:00:07,7,0:00:30,0,175
20161023-ccc_tax_script,2016/10/23,ccc_tax_script,0,0,0:00:00,0,0:00:00,0,0
20161023-ccc_waste_recycling_script,2016/10/23,ccc_waste_recycling_script,0,0,0:00:00,0,0:00:00,0,0
20161121-ccc_311_calgary_script,2016/11/21,ccc_311_calgary_script,3002,2830,0:00:44,44,0:05:22,172,124520
20161121-ccc_311_lobby_ph_script,2016/11/21,ccc_311_lobby_ph_script,2,2,0:00:09,9,0:00:09,0,18
20161121-ccc_aserv_info_script,2016/11/21,ccc_aserv_info_script,0,0,0:00:00,0,0:00:00,0,0
20161121-ccc_bylaw_script,2016/11/21,ccc_bylaw_script,0,0,0:00:00,0,0:00:00,0,0
20161121-ccc_city_script,2016/11/21,ccc_city_script,19,19,0:00:14,14,0:01:41,0,266
20161121-ccc_cty_online_script,2016/11/21,ccc_cty_online_script,0,0,0:00:00,0,0:00:00,0,0
20161121-ccc_feedback_script,2016/11/21,ccc_feedback_script,0,0,0:00:00,0,0:00:00,0,0
20161121-ccc_fpb_script,2016/11/21,ccc_fpb_script,1,1,0:00:59,59,0:00:59,0,59
20161121-ccc_help_script,2016/11/21,ccc_help_script,12,12,0:00:11,11,0:00:29,0,132
20161121-ccc_link_script,2016/11/21,ccc_link_script,0,0,0:00:00,0,0:00:00,0,0
20161121-ccc_media_line_script,2016/11/21,ccc_media_line_script,1,1,0:00:08,8,0:00:08,0,8
20161121-ccc_priority_script,2016/11/21,ccc_priority_script,21,21,0:00:11,11,0:00:57,0,231
20161121-ccc_tax_script,2016/11/21,ccc_tax_script,11,10,0:00:34,34,0:02:33,1,340
20161121-ccc_waste_recycling_script,2016/11/21,ccc_waste_recycling_script,0,0,0:00:00,0,0:00:00,0,0
20161119-ccc_feedback_script,2016/11/19,ccc_feedback_script,0,0,0:00:00,0,0:00:00,0,0
20161119-ccc_fpb_script,2016/11/19,ccc_fpb_script,0,0,0:00:00,0,0:00:00,0,0
20161119-ccc_help_script,2016/11/19,ccc_help_script,5,5,0:00:05,5,0:00:09,0,25
20161119-ccc_link_script,2016/11/19,ccc_link_script,0,0,0:00:00,0,0:00:00,0,0
20161119-ccc_media_line_script,2016/11/19,ccc_media_line_script,2,2,0:00:12,12,0:00:16,0,24
20161119-ccc_priority_script,2016/11/19,ccc_priority_script,15,15,0:00:12,12,0:01:41,0,180
20161119-ccc_tax_script,2016/11/19,ccc_tax_script,1,1,0:00:04,4,0:00:04,0,4
20161119-ccc_waste_recycling_script,2016/11/19,ccc_waste_recycling_script,0,0,0:00:00,0,0:00:00,0,0
20161120-ccc_311_calgary_script,2016/11/20,ccc_311_calgary_script,695,688,0:00:09,9,0:04:14,7,6192
20161120-ccc_311_lobby_ph_script,2016/11/20,ccc_311_lobby_ph_script,0,0,0:00:00,0,0:00:00,0,0
20161120-ccc_aserv_info_script,2016/11/20,ccc_aserv_info_script,0,0,0:00:00,0,0:00:00,0,0
20161120-ccc_bylaw_script,2016/11/20,ccc_bylaw_script,0,0,0:00:00,0,0:00:00,0,0
20161120-ccc_city_script,2016/11/20,ccc_city_script,0,0,0:00:00,0,0:00:00,0,0
20161120-ccc_cty_online_script,2016/11/20,ccc_cty_online_script,0,0,0:00:00,0,0:00:00,0,0
20161120-ccc_feedback_script,2016/11/20,ccc_feedback_script,0,0,0:00:00,0,0:00:00,0,0
20161120-ccc_fpb_script,2016/11/20,ccc_fpb_script,0,0,0:00:00,0,0:00:00,0,0
20161120-ccc_help_script,2016/11/20,ccc_help_script,0,0,0:00:00,0,0:00:00,0,0
20161120-ccc_link_script,2016/11/20,ccc_link_script,0,0,0:00:00,0,0:00:00,0,0
20161120-ccc_media_line_script,2016/11/20,ccc_media_line_script,1,1,0:00:06,6,0:00:06,0,6
20161120-ccc_priority_script,2016/11/20,ccc_priority_script,9,9,0:00:05,5,0:00:09,0,45
20161120-ccc_tax_script,2016/11/20,ccc_tax_script,0,0,0:00:00,0,0:00:00,0,0
20161120-ccc_waste_recycling_script,2016/11/20,ccc_waste_recycling_script,0,0,0:00:00,0,0:00:00,0,0
20161123-ccc_311_calgary_script,2016/11/23,ccc_311_calgary_script,2682,2443,00:01:29,89,00:07:26,239,217427
20161123-ccc_311_lobby_ph_script,2016/11/23,ccc_311_lobby_ph_script,1,1,00:00:10,10,00:00:10,0,10
20161123-ccc_aserv_info_script,2016/11/23,ccc_aserv_info_script,0,0,00:00:00,0,00:00:00,0,0
20161123-ccc_bylaw_script,2016/11/23,ccc_bylaw_script,0,0,00:00:00,0,00:00:00,0,0
20161123-ccc_city_script,2016/11/23,ccc_city_script,21,20,00:00:15,15,00:01:06,1,300
20161123-ccc_cty_online_script,2016/11/23,ccc_cty_online_script,0,0,00:00:00,0,00:00:00,0,0
20161123-ccc_feedback_script,2016/11/23,ccc_feedback_script,0,0,00:00:00,0,00:00:00,0,0
20161123-ccc_fpb_script,2016/11/23,ccc_fpb_script,1,0,00:00:00,0,00:00:00,1,0
20161123-ccc_help_script,2016/11/23,ccc_help_script,5,4,00:00:24,24,00:00:50,1,96
20161123-ccc_link_script,2016/11/23,ccc_link_script,0,0,00:00:00,0,00:00:00,0,0
20161123-ccc_media_line_script,2016/11/23,ccc_media_line_script,1,0,00:00:00,0,00:00:00,1,0
20161123-ccc_priority_script,2016/11/23,ccc_priority_script,37,37,00:00:10,10,00:00:58,0,370
20161123-ccc_tax_script,2016/11/23,ccc_tax_script,22,17,00:02:02,122,00:06:23,5,2074
20161123-ccc_waste_recycling_script,2016/11/23,ccc_waste_recycling_script,0,0,00:00:00,0,00:00:00,0,0
20161124-ccc_311_calgary_script,2016/11/24,ccc_311_calgary_script,2534,2409,00:00:39,39,00:05:56,125,93951
20161124-ccc_311_lobby_ph_script,2016/11/24,ccc_311_lobby_ph_script,3,3,00:00:16,16,00:00:34,0,48
20161124-ccc_aserv_info_script,2016/11/24,ccc_aserv_info_script,0,0,00:00:00,0,00:00:00,0,0
20161124-ccc_bylaw_script,2016/11/24,ccc_bylaw_script,0,0,00:00:00,0,00:00:00,0,0
20161124-ccc_city_script,2016/11/24,ccc_city_script,20,20,00:00:08,8,00:00:23,0,160
20161124-ccc_cty_online_script,2016/11/24,ccc_cty_online_script,0,0,00:00:00,0,00:00:00,0,0
20161124-ccc_feedback_script,2016/11/24,ccc_feedback_script,0,0,00:00:00,0,00:00:00,0,0
20161124-ccc_fpb_script,2016/11/24,ccc_fpb_script,2,1,00:05:35,335,00:05:35,1,335
20161124-ccc_help_script,2016/11/24,ccc_help_script,11,11,00:00:09,9,00:00:19,0,99
20161124-ccc_link_script,2016/11/24,ccc_link_script,0,0,00:00:00,0,00:00:00,0,0
20161124-ccc_media_line_script,2016/11/24,ccc_media_line_script,0,0,00:00:00,0,00:00:00,0,0
20161124-ccc_priority_script,2016/11/24,ccc_priority_script,22,22,00:00:08,8,00:01:01,0,176
20161124-ccc_tax_script,2016/11/24,ccc_tax_script,24,24,00:00:46,46,00:02:17,0,1104
20161124-ccc_waste_recycling_script,2016/11/24,ccc_waste_recycling_script,0,0,00:00:00,0,00:00:00,0,0
20161125-ccc_311_calgary_script,2016/11/25,ccc_311_calgary_script,2301,2209,00:00:30,30,00:04:03,92,66270
20161125-ccc_311_lobby_ph_script,2016/11/25,ccc_311_lobby_ph_script,3,2,00:00:16,16,00:00:18,1,32
20161125-ccc_aserv_info_script,2016/11/25,ccc_aserv_info_script,0,0,00:00:00,0,00:00:00,0,0
20161125-ccc_bylaw_script,2016/11/25,ccc_bylaw_script,0,0,00:00:00,0,00:00:00,0,0
20161125-ccc_city_script,2016/11/25,ccc_city_script,20,20,00:00:20,20,00:01:22,0,400
20161125-ccc_cty_online_script,2016/11/25,ccc_cty_online_script,0,0,00:00:00,0,00:00:00,0,0
20161125-ccc_feedback_script,2016/11/25,ccc_feedback_script,0,0,00:00:00,0,00:00:00,0,0
20161125-ccc_fpb_script,2016/11/25,ccc_fpb_script,4,4,00:00:05,5,00:00:09,0,20
20161125-ccc_help_script,2016/11/25,ccc_help_script,3,3,00:00:06,6,00:00:12,0,18
20161125-ccc_link_script,2016/11/25,ccc_link_script,0,0,00:00:00,0,00:00:00,0,0
20161125-ccc_media_line_script,2016/11/25,ccc_media_line_script,2,2,00:00:06,6,00:00:07,0,12
20161125-ccc_priority_script,2016/11/25,ccc_priority_script,28,27,00:00:11,11,00:00:46,1,297
20161125-ccc_tax_script,2016/11/25,ccc_tax_script,25,22,00:01:02,62,00:03:11,3,1364
20161125-ccc_waste_recycling_script,2016/11/25,ccc_waste_recycling_script,0,0,00:00:00,0,00:00:00,0,0
20161126-ccc_311_calgary_script,2016/11/26,ccc_311_calgary_script,899,873,00:00:15,15,00:03:46,26,13095
20161126-ccc_311_lobby_ph_script,2016/11/26,ccc_311_lobby_ph_script,0,0,00:00:00,0,00:00:00,0,0
20161126-ccc_aserv_info_script,2016/11/26,ccc_aserv_info_script,0,0,00:00:00,0,00:00:00,0,0
20161126-ccc_bylaw_script,2016/11/26,ccc_bylaw_script,0,0,00:00:00,0,00:00:00,0,0
20161126-ccc_city_script,2016/11/26,ccc_city_script,0,0,00:00:00,0,00:00:00,0,0
20161126-ccc_cty_online_script,2016/11/26,ccc_cty_online_script,0,0,00:00:00,0,00:00:00,0,0
20161126-ccc_feedback_script,2016/11/26,ccc_feedback_script,0,0,00:00:00,0,00:00:00,0,0
20161126-ccc_fpb_script,2016/11/26,ccc_fpb_script,0,0,00:00:00,0,00:00:00,0,0
20161126-ccc_help_script,2016/11/26,ccc_help_script,5,5,00:00:13,13,00:00:37,0,65
20161126-ccc_link_script,2016/11/26,ccc_link_script,0,0,00:00:00,0,00:00:00,0,0
20161126-ccc_media_line_script,2016/11/26,ccc_media_line_script,0,0,00:00:00,0,00:00:00,0,0
20161126-ccc_priority_script,2016/11/26,ccc_priority_script,26,26,00:00:07,7,00:00:16,0,182
20161126-ccc_tax_script,2016/11/26,ccc_tax_script,0,0,00:00:00,0,00:00:00,0,0
20161126-ccc_waste_recycling_script,2016/11/26,ccc_waste_recycling_script,0,0,00:00:00,0,00:00:00,0,0
20161127-ccc_311_calgary_script,2016/11/27,ccc_311_calgary_script,651,639,00:00:11,11,00:05:21,12,7029
20161127-ccc_311_lobby_ph_script,2016/11/27,ccc_311_lobby_ph_script,0,0,00:00:00,0,00:00:00,0,0
20161127-ccc_aserv_info_script,2016/11/27,ccc_aserv_info_script,0,0,00:00:00,0,00:00:00,0,0
20161127-ccc_bylaw_script,2016/11/27,ccc_bylaw_script,0,0,00:00:00,0,00:00:00,0,0
20161127-ccc_city_script,2016/11/27,ccc_city_script,0,0,00:00:00,0,00:00:00,0,0
20161127-ccc_cty_online_script,2016/11/27,ccc_cty_online_script,0,0,00:00:00,0,00:00:00,0,0
20161127-ccc_feedback_script,2016/11/27,ccc_feedback_script,0,0,00:00:00,0,00:00:00,0,0
20161127-ccc_fpb_script,2016/11/27,ccc_fpb_script,1,1,00:00:03,3,00:00:03,0,3
20161127-ccc_help_script,2016/11/27,ccc_help_script,2,2,00:00:03,3,00:00:04,0,6
20161127-ccc_link_script,2016/11/27,ccc_link_script,0,0,00:00:00,0,00:00:00,0,0
20161127-ccc_media_line_script,2016/11/27,ccc_media_line_script,4,4,00:00:11,11,00:00:19,0,44
20161127-ccc_priority_script,2016/11/27,ccc_priority_script,22,20,00:00:10,10,00:01:14,2,200
20161127-ccc_tax_script,2016/11/27,ccc_tax_script,0,0,00:00:00,0,00:00:00,0,0
20161127-ccc_waste_recycling_script,2016/11/27,ccc_waste_recycling_script,0,0,00:00:00,0,00:00:00,0,0
20161128-ccc_311_calgary_script,2016/11/28,ccc_311_calgary_script,2964,2887,00:00:16,16,00:04:17,77,46192
20161128-ccc_311_lobby_ph_script,2016/11/28,ccc_311_lobby_ph_script,0,0,00:00:00,0,00:00:00,0,0
20161128-ccc_aserv_info_script,2016/11/28,ccc_aserv_info_script,0,0,00:00:00,0,00:00:00,0,0
20161128-ccc_bylaw_script,2016/11/28,ccc_bylaw_script,0,0,00:00:00,0,00:00:00,0,0
20161128-ccc_city_script,2016/11/28,ccc_city_script,19,18,00:00:09,9,00:00:28,1,162
20161128-ccc_cty_online_script,2016/11/28,ccc_cty_online_script,0,0,00:00:00,0,00:00:00,0,0
20161128-ccc_feedback_script,2016/11/28,ccc_feedback_script,0,0,00:00:00,0,00:00:00,0,0
20161128-ccc_fpb_script,2016/11/28,ccc_fpb_script,1,1,00:00:52,52,00:00:52,0,52
20161128-ccc_help_script,2016/11/28,ccc_help_script,6,6,00:00:16,16,00:01:04,0,96
20161128-ccc_link_script,2016/11/28,ccc_link_script,0,0,00:00:00,0,00:00:00,0,0
20161128-ccc_media_line_script,2016/11/28,ccc_media_line_script,0,0,00:00:00,0,00:00:00,0,0
20161128-ccc_priority_script,2016/11/28,ccc_priority_script,35,35,00:00:11,11,00:00:54,0,385
20161128-ccc_tax_script,2016/11/28,ccc_tax_script,17,17,00:00:08,8,00:00:22,0,136
20161128-ccc_waste_recycling_script,2016/11/28,ccc_waste_recycling_script,0,0,00:00:00,0,00:00:00,0,0
20161129-ccc_311_calgary_script,2016/11/29,ccc_311_calgary_script,2714,2562,00:00:56,56,00:06:02,152,143472
20161129-ccc_311_lobby_ph_script,2016/11/29,ccc_311_lobby_ph_script,2,2,00:00:40,40,00:00:42,0,80
20161129-ccc_aserv_info_script,2016/11/29,ccc_aserv_info_script,0,0,00:00:00,0,00:00:00,0,0
20161129-ccc_bylaw_script,2016/11/29,ccc_bylaw_script,0,0,00:00:00,0,00:00:00,0,0
20161129-ccc_city_script,2016/11/29,ccc_city_script,15,14,00:00:16,16,00:00:58,1,224
20161129-ccc_cty_online_script,2016/11/29,ccc_cty_online_script,0,0,00:00:00,0,00:00:00,0,0
20161129-ccc_feedback_script,2016/11/29,ccc_feedback_script,0,0,00:00:00,0,00:00:00,0,0
20161129-ccc_fpb_script,2016/11/29,ccc_fpb_script,0,0,00:00:00,0,00:00:00,0,0
20161129-ccc_help_script,2016/11/29,ccc_help_script,7,7,00:00:06,6,00:00:17,0,42
20161129-ccc_link_script,2016/11/29,ccc_link_script,0,0,00:00:00,0,00:00:00,0,0
20161129-ccc_media_line_script,2016/11/29,ccc_media_line_script,0,0,00:00:00,0,00:00:00,0,0
20161129-ccc_priority_script,2016/11/29,ccc_priority_script,21,20,00:00:07,7,00:00:16,1,140
20161129-ccc_tax_script,2016/11/29,ccc_tax_script,37,35,00:01:14,74,00:04:37,2,2590
20161129-ccc_waste_recycling_script,2016/11/29,ccc_waste_recycling_script,0,0,00:00:00,0,00:00:00,0,0
20161130-ccc_311_calgary_script,2016/11/30,ccc_311_calgary_script,2573,2496,00:00:25,25,00:11:23,77,62400
20161130-ccc_311_lobby_ph_script,2016/11/30,ccc_311_lobby_ph_script,2,2,00:00:05,5,00:00:05,0,10
20161130-ccc_aserv_info_script,2016/11/30,ccc_aserv_info_script,0,0,00:00:00,0,00:00:00,0,0
20161130-ccc_bylaw_script,2016/11/30,ccc_bylaw_script,0,0,00:00:00,0,00:00:00,0,0
20161130-ccc_city_script,2016/11/30,ccc_city_script,13,12,00:00:08,8,00:00:42,1,96
20161130-ccc_cty_online_script,2016/11/30,ccc_cty_online_script,0,0,00:00:00,0,00:00:00,0,0
20161130-ccc_feedback_script,2016/11/30,ccc_feedback_script,0,0,00:00:00,0,00:00:00,0,0
20161130-ccc_fpb_script,2016/11/30,ccc_fpb_script,1,1,00:00:09,9,00:00:09,0,9
20161130-ccc_help_script,2016/11/30,ccc_help_script,9,9,00:00:06,6,00:00:12,0,54
20161130-ccc_link_script,2016/11/30,ccc_link_script,0,0,00:00:00,0,00:00:00,0,0
20161130-ccc_media_line_script,2016/11/30,ccc_media_line_script,5,5,00:00:17,17,00:01:06,0,85
20161130-ccc_priority_script,2016/11/30,ccc_priority_script,29,29,00:00:11,11,00:01:37,0,319
20161130-ccc_tax_script,2016/11/30,ccc_tax_script,20,20,00:00:29,29,00:02:14,0,580
20161130-ccc_waste_recycling_script,2016/11/30,ccc_waste_recycling_script,0,0,00:00:00,0,00:00:00,0,0
20161201-ccc_311_calgary_script,2016/12/01,ccc_311_calgary_script,2692,2553,00:00:41,41,00:12:12,139,104673
20161201-ccc_311_lobby_ph_script,2016/12/01,ccc_311_lobby_ph_script,5,4,00:00:03,3,00:00:06,1,12
20161201-ccc_aserv_info_script,2016/12/01,ccc_aserv_info_script,0,0,00:00:00,0,00:00:00,0,0
20161201-ccc_bylaw_script,2016/12/01,ccc_bylaw_script,0,0,00:00:00,0,00:00:00,0,0
20161201-ccc_city_script,2016/12/01,ccc_city_script,8,8,00:00:11,11,00:00:26,0,88
20161201-ccc_cty_online_script,2016/12/01,ccc_cty_online_script,0,0,00:00:00,0,00:00:00,0,0
20161201-ccc_feedback_script,2016/12/01,ccc_feedback_script,0,0,00:00:00,0,00:00:00,0,0
20161201-ccc_fpb_script,2016/12/01,ccc_fpb_script,0,0,00:00:00,0,00:00:00,0,0
20161201-ccc_help_script,2016/12/01,ccc_help_script,9,9,00:00:11,11,00:00:21,0,99
20161201-ccc_link_script,2016/12/01,ccc_link_script,0,0,00:00:00,0,00:00:00,0,0
20161201-ccc_media_line_script,2016/12/01,ccc_media_line_script,1,1,00:00:08,8,00:00:08,0,8
20161201-ccc_priority_script,2016/12/01,ccc_priority_script,24,24,00:00:10,10,00:00:34,0,240
20161201-ccc_tax_script,2016/12/01,ccc_tax_script,22,21,00:00:31,31,00:03:12,1,651
20161201-ccc_waste_recycling_script,2016/12/01,ccc_waste_recycling_script,0,0,00:00:00,0,00:00:00,0,0
20161202-ccc_311_calgary_script,2016/12/02,ccc_311_calgary_script,2514,2394,00:00:37,37,00:06:00,120,88578
20161202-ccc_311_lobby_ph_script,2016/12/02,ccc_311_lobby_ph_script,1,1,00:00:02,2,00:00:02,0,2
20161202-ccc_aserv_info_script,2016/12/02,ccc_aserv_info_script,0,0,00:00:00,0,00:00:00,0,0
20161202-ccc_bylaw_script,2016/12/02,ccc_bylaw_script,0,0,00:00:00,0,00:00:00,0,0
20161202-ccc_city_script,2016/12/02,ccc_city_script,4,4,00:00:32,32,00:01:55,0,128
20161202-ccc_cty_online_script,2016/12/02,ccc_cty_online_script,0,0,00:00:00,0,00:00:00,0,0
20161202-ccc_feedback_script,2016/12/02,ccc_feedback_script,0,0,00:00:00,0,00:00:00,0,0
20161202-ccc_fpb_script,2016/12/02,ccc_fpb_script,0,0,00:00:00,0,00:00:00,0,0
20161202-ccc_help_script,2016/12/02,ccc_help_script,12,11,00:00:12,12,00:00:51,1,132
20161202-ccc_link_script,2016/12/02,ccc_link_script,0,0,00:00:00,0,00:00:00,0,0
20161202-ccc_media_line_script,2016/12/02,ccc_media_line_script,0,0,00:00:00,0,00:00:00,0,0
20161202-ccc_priority_script,2016/12/02,ccc_priority_script,32,30,00:00:08,8,00:00:40,2,240
20161202-ccc_tax_script,2016/12/02,ccc_tax_script,22,22,00:00:40,40,00:01:46,0,880
20161202-ccc_waste_recycling_script,2016/12/02,ccc_waste_recycling_script,0,0,00:00:00,0,00:00:00,0,0
20161203-ccc_311_calgary_script,2016/12/03,ccc_311_calgary_script,915,891,00:00:15,15,00:04:40,24,13365
20161203-ccc_311_lobby_ph_script,2016/12/03,ccc_311_lobby_ph_script,0,0,00:00:00,0,00:00:00,0,0
20161203-ccc_aserv_info_script,2016/12/03,ccc_aserv_info_script,0,0,00:00:00,0,00:00:00,0,0
20161203-ccc_bylaw_script,2016/12/03,ccc_bylaw_script,0,0,00:00:00,0,00:00:00,0,0
20161203-ccc_city_script,2016/12/03,ccc_city_script,0,0,00:00:00,0,00:00:00,0,0
20161203-ccc_cty_online_script,2016/12/03,ccc_cty_online_script,0,0,00:00:00,0,00:00:00,0,0
20161203-ccc_feedback_script,2016/12/03,ccc_feedback_script,0,0,00:00:00,0,00:00:00,0,0
20161203-ccc_fpb_script,2016/12/03,ccc_fpb_script,0,0,00:00:00,0,00:00:00,0,0
20161203-ccc_help_script,2016/12/03,ccc_help_script,13,13,00:00:08,8,00:00:25,0,104
20161203-ccc_link_script,2016/12/03,ccc_link_script,0,0,00:00:00,0,00:00:00,0,0
20161203-ccc_media_line_script,2016/12/03,ccc_media_line_script,2,2,00:00:08,8,00:00:10,0,16
20161203-ccc_priority_script,2016/12/03,ccc_priority_script,20,20,00:00:09,9,00:01:10,0,180
20161203-ccc_tax_script,2016/12/03,ccc_tax_script,0,0,00:00:00,0,00:00:00,0,0
20161203-ccc_waste_recycling_script,2016/12/03,ccc_waste_recycling_script,0,0,00:00:00,0,00:00:00,0,0
20161204-ccc_311_calgary_script,2016/12/04,ccc_311_calgary_script,697,693,00:00:09,9,00:02:49,4,6237
20161204-ccc_311_lobby_ph_script,2016/12/04,ccc_311_lobby_ph_script,0,0,00:00:00,0,00:00:00,0,0
20161204-ccc_aserv_info_script,2016/12/04,ccc_aserv_info_script,0,0,00:00:00,0,00:00:00,0,0
20161204-ccc_bylaw_script,2016/12/04,ccc_bylaw_script,0,0,00:00:00,0,00:00:00,0,0
20161204-ccc_city_script,2016/12/04,ccc_city_script,0,0,00:00:00,0,00:00:00,0,0
20161204-ccc_cty_online_script,2016/12/04,ccc_cty_online_script,0,0,00:00:00,0,00:00:00,0,0
20161204-ccc_feedback_script,2016/12/04,ccc_feedback_script,0,0,00:00:00,0,00:00:00,0,0
20161204-ccc_fpb_script,2016/12/04,ccc_fpb_script,0,0,00:00:00,0,00:00:00,0,0
20161204-ccc_help_script,2016/12/04,ccc_help_script,1,1,00:00:05,5,00:00:05,0,5
20161204-ccc_link_script,2016/12/04,ccc_link_script,0,0,00:00:00,0,00:00:00,0,0
20161204-ccc_media_line_script,2016/12/04,ccc_media_line_script,2,2,00:00:03,3,00:00:03,0,6
20161204-ccc_priority_script,2016/12/04,ccc_priority_script,27,26,00:00:06,6,00:00:17,1,156
20161204-ccc_tax_script,2016/12/04,ccc_tax_script,0,0,00:00:00,0,00:00:00,0,0
20161204-ccc_waste_recycling_script,2016/12/04,ccc_waste_recycling_script,0,0,00:00:00,0,00:00:00,0,0
20161205-ccc_311_calgary_script,2016/12/05,ccc_311_calgary_script,2675,2619,00:00:18,18,00:03:34,56,47142
20161205-ccc_311_lobby_ph_script,2016/12/05,ccc_311_lobby_ph_script,2,2,00:00:08,8,00:00:09,0,16
20161205-ccc_aserv_info_script,2016/12/05,ccc_aserv_info_script,0,0,00:00:00,0,00:00:00,0,0
20161205-ccc_bylaw_script,2016/12/05,ccc_bylaw_script,0,0,00:00:00,0,00:00:00,0,0
20161205-ccc_city_script,2016/12/05,ccc_city_script,13,13,00:00:10,10,00:00:35,0,130
20161205-ccc_cty_online_script,2016/12/05,ccc_cty_online_script,0,0,00:00:00,0,00:00:00,0,0
20161205-ccc_feedback_script,2016/12/05,ccc_feedback_script,0,0,00:00:00,0,00:00:00,0,0
20161205-ccc_fpb_script,2016/12/05,ccc_fpb_script,0,0,00:00:00,0,00:00:00,0,0
20161205-ccc_help_script,2016/12/05,ccc_help_script,16,15,00:00:07,7,00:00:12,1,105
20161205-ccc_link_script,2016/12/05,ccc_link_script,0,0,00:00:00,0,00:00:00,0,0
20161205-ccc_media_line_script,2016/12/05,ccc_media_line_script,1,1,00:00:07,7,00:00:07,0,7
20161205-ccc_priority_script,2016/12/05,ccc_priority_script,25,25,00:00:09,9,00:00:35,0,225
20161205-ccc_tax_script,2016/12/05,ccc_tax_script,16,16,00:00:14,14,00:01:23,0,224
20161205-ccc_waste_recycling_script,2016/12/05,ccc_waste_recycling_script,0,0,00:00:00,0,00:00:00,0,0
20161206-ccc_311_calgary_script,2016/12/06,ccc_311_calgary_script,2473,2403,00:00:19,19,00:07:13,70,45657
20161206-ccc_311_lobby_ph_script,2016/12/06,ccc_311_lobby_ph_script,3,3,00:00:10,10,00:00:15,0,30
20161206-ccc_aserv_info_script,2016/12/06,ccc_aserv_info_script,0,0,00:00:00,0,00:00:00,0,0
20161206-ccc_bylaw_script,2016/12/06,ccc_bylaw_script,0,0,00:00:00,0,00:00:00,0,0
20161206-ccc_city_script,2016/12/06,ccc_city_script,22,22,00:00:08,8,00:00:20,0,176
20161206-ccc_cty_online_script,2016/12/06,ccc_cty_online_script,0,0,00:00:00,0,00:00:00,0,0
20161206-ccc_feedback_script,2016/12/06,ccc_feedback_script,0,0,00:00:00,0,00:00:00,0,0
20161206-ccc_fpb_script,2016/12/06,ccc_fpb_script,0,0,00:00:00,0,00:00:00,0,0
20161206-ccc_help_script,2016/12/06,ccc_help_script,18,17,00:00:09,9,00:00:34,1,153
20161206-ccc_link_script,2016/12/06,ccc_link_script,0,0,00:00:00,0,00:00:00,0,0
20161206-ccc_media_line_script,2016/12/06,ccc_media_line_script,2,2,00:00:19,19,00:00:35,0,38
20161206-ccc_priority_script,2016/12/06,ccc_priority_script,32,32,00:00:11,11,00:00:47,0,352
20161206-ccc_tax_script,2016/12/06,ccc_tax_script,22,21,00:00:26,26,00:01:29,1,546
20161206-ccc_waste_recycling_script,2016/12/06,ccc_waste_recycling_script,0,0,00:00:00,0,00:00:00,0,0
20161207-ccc_311_calgary_script,2016/12/07,ccc_311_calgary_script,2511,2465,00:00:19,19,00:04:42,46,46835
20161207-ccc_311_lobby_ph_script,2016/12/07,ccc_311_lobby_ph_script,2,1,00:00:03,3,00:00:03,1,3
20161207-ccc_aserv_info_script,2016/12/07,ccc_aserv_info_script,0,0,00:00:00,0,00:00:00,0,0
20161207-ccc_bylaw_script,2016/12/07,ccc_bylaw_script,0,0,00:00:00,0,00:00:00,0,0
20161207-ccc_city_script,2016/12/07,ccc_city_script,25,23,00:00:09,9,00:00:44,2,207
20161207-ccc_cty_online_script,2016/12/07,ccc_cty_online_script,0,0,00:00:00,0,00:00:00,0,0
20161207-ccc_feedback_script,2016/12/07,ccc_feedback_script,0,0,00:00:00,0,00:00:00,0,0
20161207-ccc_fpb_script,2016/12/07,ccc_fpb_script,3,2,00:00:40,40,00:01:08,1,80
20161207-ccc_help_script,2016/12/07,ccc_help_script,28,28,00:00:07,7,00:00:19,0,196
20161207-ccc_link_script,2016/12/07,ccc_link_script,0,0,00:00:00,0,00:00:00,0,0
20161207-ccc_media_line_script,2016/12/07,ccc_media_line_script,1,1,00:00:06,6,00:00:06,0,6
20161207-ccc_priority_script,2016/12/07,ccc_priority_script,43,43,00:00:08,8,00:00:40,0,344
20161207-ccc_tax_script,2016/12/07,ccc_tax_script,21,21,00:00:20,20,00:03:18,0,420
20161207-ccc_waste_recycling_script,2016/12/07,ccc_waste_recycling_script,0,0,00:00:00,0,00:00:00,0,0
20161208-ccc_311_calgary_script,2016/12/08,ccc_311_calgary_script,2345,2286,00:00:20,20,00:05:59,59,45720
20161208-ccc_311_lobby_ph_script,2016/12/08,ccc_311_lobby_ph_script,1,1,00:00:07,7,00:00:07,0,7
20161208-ccc_aserv_info_script,2016/12/08,ccc_aserv_info_script,0,0,00:00:00,0,00:00:00,0,0
20161208-ccc_bylaw_script,2016/12/08,ccc_bylaw_script,0,0,00:00:00,0,00:00:00,0,0
20161208-ccc_city_script,2016/12/08,ccc_city_script,20,20,00:00:08,8,00:00:31,0,160
20161208-ccc_cty_online_script,2016/12/08,ccc_cty_online_script,0,0,00:00:00,0,00:00:00,0,0
20161208-ccc_feedback_script,2016/12/08,ccc_feedback_script,0,0,00:00:00,0,00:00:00,0,0
20161208-ccc_fpb_script,2016/12/08,ccc_fpb_script,0,0,00:00:00,0,00:00:00,0,0
20161208-ccc_help_script,2016/12/08,ccc_help_script,34,33,00:00:07,7,00:00:36,1,231
20161208-ccc_link_script,2016/12/08,ccc_link_script,0,0,00:00:00,0,00:00:00,0,0
20161208-ccc_media_line_script,2016/12/08,ccc_media_line_script,0,0,00:00:00,0,00:00:00,0,0
20161208-ccc_priority_script,2016/12/08,ccc_priority_script,37,37,00:00:07,7,00:00:38,0,259
20161208-ccc_tax_script,2016/12/08,ccc_tax_script,17,17,00:00:32,32,00:02:38,0,544
20161208-ccc_waste_recycling_script,2016/12/08,ccc_waste_recycling_script,0,0,00:00:00,0,00:00:00,0,0
20161209-ccc_311_calgary_script,2016/12/09,ccc_311_calgary_script,2109,2075,00:00:12,12,00:06:08,34,24900
20161209-ccc_311_lobby_ph_script,2016/12/09,ccc_311_lobby_ph_script,1,1,00:00:14,14,00:00:14,0,14
20161209-ccc_aserv_info_script,2016/12/09,ccc_aserv_info_script,0,0,00:00:00,0,00:00:00,0,0
20161209-ccc_bylaw_script,2016/12/09,ccc_bylaw_script,0,0,00:00:00,0,00:00:00,0,0
20161209-ccc_city_script,2016/12/09,ccc_city_script,14,14,00:00:05,5,00:00:12,0,70
20161209-ccc_cty_online_script,2016/12/09,ccc_cty_online_script,0,0,00:00:00,0,00:00:00,0,0
20161209-ccc_feedback_script,2016/12/09,ccc_feedback_script,0,0,00:00:00,0,00:00:00,0,0
20161209-ccc_fpb_script,2016/12/09,ccc_fpb_script,1,1,00:00:21,21,00:00:21,0,21
20161209-ccc_help_script,2016/12/09,ccc_help_script,23,22,00:00:08,8,00:00:37,1,176
20161209-ccc_link_script,2016/12/09,ccc_link_script,0,0,00:00:00,0,00:00:00,0,0
20161209-ccc_media_line_script,2016/12/09,ccc_media_line_script,1,1,00:00:09,9,00:00:09,0,9
20161209-ccc_priority_script,2016/12/09,ccc_priority_script,42,42,00:00:08,8,00:00:17,0,336
20161209-ccc_tax_script,2016/12/09,ccc_tax_script,15,14,00:00:06,6,00:00:09,1,84
20161209-ccc_waste_recycling_script,2016/12/09,ccc_waste_recycling_script,0,0,00:00:00,0,00:00:00,0,0
20161210-ccc_311_calgary_script,2016/12/10,ccc_311_calgary_script,927,912,00:00:13,13,00:08:03,11,11856
20161210-ccc_311_lobby_ph_script,2016/12/10,ccc_311_lobby_ph_script,0,0,00:00:00,0,00:00:00,0,0
20161210-ccc_aserv_info_script,2016/12/10,ccc_aserv_info_script,0,0,00:00:00,0,00:00:00,0,0
20161210-ccc_bylaw_script,2016/12/10,ccc_bylaw_script,0,0,00:00:00,0,00:00:00,0,0
20161210-ccc_city_script,2016/12/10,ccc_city_script,0,0,00:00:00,0,00:00:00,0,0
20161210-ccc_cty_online_script,2016/12/10,ccc_cty_online_script,0,0,00:00:00,0,00:00:00,0,0
20161210-ccc_feedback_script,2016/12/10,ccc_feedback_script,0,0,00:00:00,0,00:00:00,0,0
20161210-ccc_fpb_script,2016/12/10,ccc_fpb_script,0,0,00:00:00,0,00:00:00,0,0
20161210-ccc_help_script,2016/12/10,ccc_help_script,11,11,00:00:05,5,00:00:08,0,55
20161210-ccc_link_script,2016/12/10,ccc_link_script,0,0,00:00:00,0,00:00:00,0,0
20161210-ccc_media_line_script,2016/12/10,ccc_media_line_script,2,2,00:00:26,26,00:00:47,0,52
20161210-ccc_priority_script,2016/12/10,ccc_priority_script,39,37,00:00:25,25,00:03:24,2,925
20161210-ccc_tax_script,2016/12/10,ccc_tax_script,2,2,00:00:15,15,00:00:20,0,30
20161210-ccc_waste_recycling_script,2016/12/10,ccc_waste_recycling_script,0,0,00:00:00,0,00:00:00,0,0
20161211-ccc_311_calgary_script,2016/12/11,ccc_311_calgary_script,708,697,00:00:12,12,00:06:00,15,8364
20161211-ccc_311_lobby_ph_script,2016/12/11,ccc_311_lobby_ph_script,0,0,00:00:00,0,00:00:00,0,0
20161211-ccc_aserv_info_script,2016/12/11,ccc_aserv_info_script,0,0,00:00:00,0,00:00:00,0,0
20161211-ccc_bylaw_script,2016/12/11,ccc_bylaw_script,0,0,00:00:00,0,00:00:00,0,0
20161211-ccc_city_script,2016/12/11,ccc_city_script,0,0,00:00:00,0,00:00:00,0,0
20161211-ccc_cty_online_script,2016/12/11,ccc_cty_online_script,0,0,00:00:00,0,00:00:00,0,0
20161211-ccc_feedback_script,2016/12/11,ccc_feedback_script,0,0,00:00:00,0,00:00:00,0,0
20161211-ccc_fpb_script,2016/12/11,ccc_fpb_script,0,0,00:00:00,0,00:00:00,0,0
20161211-ccc_help_script,2016/12/11,ccc_help_script,6,6,00:00:47,47,00:04:14,0,282
20161211-ccc_link_script,2016/12/11,ccc_link_script,0,0,00:00:00,0,00:00:00,0,0
20161211-ccc_media_line_script,2016/12/11,ccc_media_line_script,1,1,00:00:06,6,00:00:06,0,6
20161211-ccc_priority_script,2016/12/11,ccc_priority_script,16,16,00:00:06,6,00:00:15,0,96
20161211-ccc_tax_script,2016/12/11,ccc_tax_script,2,2,00:00:07,7,00:00:07,0,14
20161211-ccc_waste_recycling_script,2016/12/11,ccc_waste_recycling_script,0,0,00:00:00,0,00:00:00,0,0
20161212-ccc_311_calgary_script,2016/12/12,ccc_311_calgary_script,2506,2446,00:00:19,19,00:04:27,59,46474
20161212-ccc_311_lobby_ph_script,2016/12/12,ccc_311_lobby_ph_script,1,1,00:00:07,7,00:00:07,0,7
20161212-ccc_aserv_info_script,2016/12/12,ccc_aserv_info_script,0,0,00:00:00,0,00:00:00,0,0
20161212-ccc_bylaw_script,2016/12/12,ccc_bylaw_script,0,0,00:00:00,0,00:00:00,0,0
20161212-ccc_city_script,2016/12/12,ccc_city_script,7,7,00:00:11,11,00:00:57,0,77
20161212-ccc_cty_online_script,2016/12/12,ccc_cty_online_script,0,0,00:00:00,0,00:00:00,0,0
20161212-ccc_feedback_script,2016/12/12,ccc_feedback_script,0,0,00:00:00,0,00:00:00,0,0
20161212-ccc_fpb_script,2016/12/12,ccc_fpb_script,0,0,00:00:00,0,00:00:00,0,0
20161212-ccc_help_script,2016/12/12,ccc_help_script,13,13,00:00:07,7,00:00:33,0,91
20161212-ccc_link_script,2016/12/12,ccc_link_script,0,0,00:00:00,0,00:00:00,0,0
20161212-ccc_media_line_script,2016/12/12,ccc_media_line_script,0,0,00:00:00,0,00:00:00,0,0
20161212-ccc_priority_script,2016/12/12,ccc_priority_script,28,28,00:00:10,10,00:00:35,0,280
20161212-ccc_tax_script,2016/12/12,ccc_tax_script,20,19,00:00:15,15,00:02:58,1,285
20161212-ccc_waste_recycling_script,2016/12/12,ccc_waste_recycling_script,0,0,00:00:00,0,00:00:00,0,0
20161213-ccc_311_calgary_script,2016/12/13,ccc_311_calgary_script,2311,2240,00:00:20,20,00:06:25,72,44800
20161213-ccc_311_lobby_ph_script,2016/12/13,ccc_311_lobby_ph_script,3,3,00:00:13,13,00:00:19,0,39
20161213-ccc_aserv_info_script,2016/12/13,ccc_aserv_info_script,0,0,00:00:00,0,00:00:00,0,0
20161213-ccc_bylaw_script,2016/12/13,ccc_bylaw_script,0,0,00:00:00,0,00:00:00,0,0
20161213-ccc_city_script,2016/12/13,ccc_city_script,11,11,00:00:07,7,00:00:23,0,77
20161213-ccc_cty_online_script,2016/12/13,ccc_cty_online_script,0,0,00:00:00,0,00:00:00,0,0
20161213-ccc_feedback_script,2016/12/13,ccc_feedback_script,1,0,00:00:00,0,00:00:00,0,0
20161213-ccc_fpb_script,2016/12/13,ccc_fpb_script,0,0,00:00:00,0,00:00:00,0,0
20161213-ccc_help_script,2016/12/13,ccc_help_script,10,10,00:00:12,12,00:00:44,0,120
20161213-ccc_link_script,2016/12/13,ccc_link_script,0,0,00:00:00,0,00:00:00,0,0
20161213-ccc_media_line_script,2016/12/13,ccc_media_line_script,0,0,00:00:00,0,00:00:00,0,0
20161213-ccc_priority_script,2016/12/13,ccc_priority_script,26,26,00:00:11,11,00:01:59,0,286
20161213-ccc_tax_script,2016/12/13,ccc_tax_script,13,13,00:00:19,19,00:02:42,0,247
20161213-ccc_waste_recycling_script,2016/12/13,ccc_waste_recycling_script,0,0,00:00:00,0,00:00:00,0,0
20161214-ccc_311_calgary_script,2016/12/14,ccc_311_calgary_script,2328,2226,00:00:34,34,00:03:34,102,75684
20161214-ccc_311_lobby_ph_script,2016/12/14,ccc_311_lobby_ph_script,4,2,00:00:08,8,00:00:13,2,16
20161214-ccc_aserv_info_script,2016/12/14,ccc_aserv_info_script,0,0,00:00:00,0,00:00:00,0,0
20161214-ccc_bylaw_script,2016/12/14,ccc_bylaw_script,0,0,00:00:00,0,00:00:00,0,0
20161214-ccc_city_script,2016/12/14,ccc_city_script,8,7,00:00:07,7,00:00:17,1,49
20161214-ccc_cty_online_script,2016/12/14,ccc_cty_online_script,0,0,00:00:00,0,00:00:00,0,0
20161214-ccc_feedback_script,2016/12/14,ccc_feedback_script,0,0,00:00:00,0,00:00:00,0,0
20161214-ccc_fpb_script,2016/12/14,ccc_fpb_script,0,0,00:00:00,0,00:00:00,0,0
20161214-ccc_help_script,2016/12/14,ccc_help_script,12,12,00:00:10,10,00:00:35,0,120
20161214-ccc_link_script,2016/12/14,ccc_link_script,0,0,00:00:00,0,00:00:00,0,0
20161214-ccc_media_line_script,2016/12/14,ccc_media_line_script,1,1,00:00:03,3,00:00:03,0,3
20161214-ccc_priority_script,2016/12/14,ccc_priority_script,27,26,00:00:07,7,00:00:17,1,182
20161214-ccc_tax_script,2016/12/14,ccc_tax_script,25,25,00:00:43,43,00:02:53,0,1075
20161214-ccc_waste_recycling_script,2016/12/14,ccc_waste_recycling_script,0,0,00:00:00,0,00:00:00,0,0
20161215-ccc_311_calgary_script,2016/12/15,ccc_311_calgary_script,2271,2104,00:00:58,58,00:07:24,167,122032
20161215-ccc_311_lobby_ph_script,2016/12/15,ccc_311_lobby_ph_script,4,4,00:00:21,21,00:01:02,0,84
20161215-ccc_aserv_info_script,2016/12/15,ccc_aserv_info_script,0,0,00:00:00,0,00:00:00,0,0
20161215-ccc_bylaw_script,2016/12/15,ccc_bylaw_script,0,0,00:00:00,0,00:00:00,0,0
20161215-ccc_city_script,2016/12/15,ccc_city_script,18,18,00:00:23,23,00:02:25,0,414
20161215-ccc_cty_online_script,2016/12/15,ccc_cty_online_script,0,0,00:00:00,0,00:00:00,0,0
20161215-ccc_feedback_script,2016/12/15,ccc_feedback_script,0,0,00:00:00,0,00:00:00,0,0
20161215-ccc_fpb_script,2016/12/15,ccc_fpb_script,0,0,00:00:00,0,00:00:00,0,0
20161215-ccc_help_script,2016/12/15,ccc_help_script,13,13,00:00:13,13,00:00:40,0,169
20161215-ccc_link_script,2016/12/15,ccc_link_script,0,0,00:00:00,0,00:00:00,0,0
20161215-ccc_media_line_script,2016/12/15,ccc_media_line_script,0,0,00:00:00,0,00:00:00,0,0
20161215-ccc_priority_script,2016/12/15,ccc_priority_script,31,30,00:00:13,13,00:01:33,1,390
20161215-ccc_tax_script,2016/12/15,ccc_tax_script,21,20,00:01:20,80,00:04:55,1,1600
20161215-ccc_waste_recycling_script,2016/12/15,ccc_waste_recycling_script,0,0,00:00:00,0,00:00:00,0,0
20161216-ccc_311_calgary_script,2016/12/16,ccc_311_calgary_script,2001,1937,00:00:27,27,00:05:28,64,52299
20161216-ccc_311_lobby_ph_script,2016/12/16,ccc_311_lobby_ph_script,2,1,00:00:02,2,00:00:02,1,2
20161216-ccc_aserv_info_script,2016/12/16,ccc_aserv_info_script,0,0,00:00:00,0,00:00:00,0,0
20161216-ccc_bylaw_script,2016/12/16,ccc_bylaw_script,0,0,00:00:00,0,00:00:00,0,0
20161216-ccc_city_script,2016/12/16,ccc_city_script,5,4,00:00:09,9,00:00:12,1,36
20161216-ccc_cty_online_script,2016/12/16,ccc_cty_online_script,0,0,00:00:00,0,00:00:00,0,0
20161216-ccc_feedback_script,2016/12/16,ccc_feedback_script,0,0,00:00:00,0,00:00:00,0,0
20161216-ccc_fpb_script,2016/12/16,ccc_fpb_script,1,1,00:00:02,2,00:00:02,0,2
20161216-ccc_help_script,2016/12/16,ccc_help_script,11,11,00:00:07,7,00:00:10,0,77
20161216-ccc_link_script,2016/12/16,ccc_link_script,0,0,00:00:00,0,00:00:00,0,0
20161216-ccc_media_line_script,2016/12/16,ccc_media_line_script,1,1,00:00:04,4,00:00:04,0,4
20161216-ccc_priority_script,2016/12/16,ccc_priority_script,41,39,00:00:10,10,00:01:12,2,390
20161216-ccc_tax_script,2016/12/16,ccc_tax_script,35,29,00:00:45,45,00:04:44,6,1305
20161216-ccc_waste_recycling_script,2016/12/16,ccc_waste_recycling_script,0,0,00:00:00,0,00:00:00,0,0
20161217-ccc_311_calgary_script,2016/12/17,ccc_311_calgary_script,781,766,00:00:14,14,00:11:47,15,10724
20161217-ccc_311_lobby_ph_script,2016/12/17,ccc_311_lobby_ph_script,0,0,00:00:00,0,00:00:00,0,0
20161217-ccc_aserv_info_script,2016/12/17,ccc_aserv_info_script,0,0,00:00:00,0,00:00:00,0,0
20161217-ccc_bylaw_script,2016/12/17,ccc_bylaw_script,0,0,00:00:00,0,00:00:00,0,0
20161217-ccc_city_script,2016/12/17,ccc_city_script,0,0,00:00:00,0,00:00:00,0,0
20161217-ccc_cty_online_script,2016/12/17,ccc_cty_online_script,0,0,00:00:00,0,00:00:00,0,0
20161217-ccc_feedback_script,2016/12/17,ccc_feedback_script,0,0,00:00:00,0,00:00:00,0,0
20161217-ccc_fpb_script,2016/12/17,ccc_fpb_script,0,0,00:00:00,0,00:00:00,0,0
20161217-ccc_help_script,2016/12/17,ccc_help_script,9,9,00:00:10,10,00:00:20,0,90
20161217-ccc_link_script,2016/12/17,ccc_link_script,0,0,00:00:00,0,00:00:00,0,0
20161217-ccc_media_line_script,2016/12/17,ccc_media_line_script,0,0,00:00:00,0,00:00:00,0,0
20161217-ccc_priority_script,2016/12/17,ccc_priority_script,9,9,00:00:09,9,00:00:40,0,81
20161217-ccc_tax_script,2016/12/17,ccc_tax_script,0,0,00:00:00,0,00:00:00,0,0
20161217-ccc_waste_recycling_script,2016/12/17,ccc_waste_recycling_script,0,0,00:00:00,0,00:00:00,0,0
20161218-ccc_311_calgary_script,2016/12/18,ccc_311_calgary_script,721,704,00:00:18,18,00:05:12,16,12672
20161218-ccc_311_lobby_ph_script,2016/12/18,ccc_311_lobby_ph_script,0,0,00:00:00,0,00:00:00,0,0
20161218-ccc_aserv_info_script,2016/12/18,ccc_aserv_info_script,0,0,00:00:00,0,00:00:00,0,0
20161218-ccc_bylaw_script,2016/12/18,ccc_bylaw_script,0,0,00:00:00,0,00:00:00,0,0
20161218-ccc_city_script,2016/12/18,ccc_city_script,0,0,00:00:00,0,00:00:00,0,0
20161218-ccc_cty_online_script,2016/12/18,ccc_cty_online_script,0,0,00:00:00,0,00:00:00,0,0
20161218-ccc_feedback_script,2016/12/18,ccc_feedback_script,0,0,00:00:00,0,00:00:00,0,0
20161218-ccc_fpb_script,2016/12/18,ccc_fpb_script,0,0,00:00:00,0,00:00:00,0,0
20161218-ccc_help_script,2016/12/18,ccc_help_script,7,7,00:00:14,14,00:00:59,0,98
20161218-ccc_link_script,2016/12/18,ccc_link_script,0,0,00:00:00,0,00:00:00,0,0
20161218-ccc_media_line_script,2016/12/18,ccc_media_line_script,0,0,00:00:00,0,00:00:00,0,0
20161218-ccc_priority_script,2016/12/18,ccc_priority_script,19,19,00:00:08,8,00:00:43,0,152
20161218-ccc_tax_script,2016/12/18,ccc_tax_script,2,2,00:00:07,7,00:00:07,0,14
20161218-ccc_waste_recycling_script,2016/12/18,ccc_waste_recycling_script,0,0,00:00:00,0,00:00:00,0,0
20161219-ccc_311_calgary_script,2016/12/19,ccc_311_calgary_script,2402,2372,00:00:11,11,00:03:57,30,26092
20161219-ccc_311_lobby_ph_script,2016/12/19,ccc_311_lobby_ph_script,1,1,00:00:02,2,00:00:02,0,2
20161219-ccc_aserv_info_script,2016/12/19,ccc_aserv_info_script,0,0,00:00:00,0,00:00:00,0,0
20161219-ccc_bylaw_script,2016/12/19,ccc_bylaw_script,0,0,00:00:00,0,00:00:00,0,0
20161219-ccc_city_script,2016/12/19,ccc_city_script,37,37,00:00:08,8,00:00:27,0,296
20161219-ccc_cty_online_script,2016/12/19,ccc_cty_online_script,0,0,00:00:00,0,00:00:00,0,0
20161219-ccc_feedback_script,2016/12/19,ccc_feedback_script,0,0,00:00:00,0,00:00:00,0,0
20161219-ccc_fpb_script,2016/12/19,ccc_fpb_script,1,1,00:00:02,2,00:00:02,0,2
20161219-ccc_help_script,2016/12/19,ccc_help_script,9,9,00:00:06,6,00:00:14,0,54
20161219-ccc_link_script,2016/12/19,ccc_link_script,0,0,00:00:00,0,00:00:00,0,0
20161219-ccc_media_line_script,2016/12/19,ccc_media_line_script,0,0,00:00:00,0,00:00:00,0,0
20161219-ccc_priority_script,2016/12/19,ccc_priority_script,25,25,00:00:06,6,00:00:19,0,150
20161219-ccc_tax_script,2016/12/19,ccc_tax_script,10,10,00:00:05,5,00:00:14,0,50
20161219-ccc_waste_recycling_script,2016/12/19,ccc_waste_recycling_script,0,0,00:00:00,0,00:00:00,0,0
20161220-ccc_311_calgary_script,2016/12/20,ccc_311_calgary_script,2410,2282,00:00:40,40,00:04:57,128,91280
20161220-ccc_311_lobby_ph_script,2016/12/20,ccc_311_lobby_ph_script,4,3,00:00:07,7,00:00:10,1,21
20161220-ccc_aserv_info_script,2016/12/20,ccc_aserv_info_script,0,0,00:00:00,0,00:00:00,0,0
20161220-ccc_bylaw_script,2016/12/20,ccc_bylaw_script,0,0,00:00:00,0,00:00:00,0,0
20161220-ccc_city_script,2016/12/20,ccc_city_script,22,22,00:00:22,22,00:01:37,0,484
20161220-ccc_cty_online_script,2016/12/20,ccc_cty_online_script,0,0,00:00:00,0,00:00:00,0,0
20161220-ccc_feedback_script,2016/12/20,ccc_feedback_script,0,0,00:00:00,0,00:00:00,0,0
20161220-ccc_fpb_script,2016/12/20,ccc_fpb_script,0,0,00:00:00,0,00:00:00,0,0
20161220-ccc_help_script,2016/12/20,ccc_help_script,16,14,00:00:10,10,00:00:17,2,140
20161220-ccc_link_script,2016/12/20,ccc_link_script,0,0,00:00:00,0,00:00:00,0,0
20161220-ccc_media_line_script,2016/12/20,ccc_media_line_script,2,2,00:00:42,42,00:01:06,0,84
20161220-ccc_priority_script,2016/12/20,ccc_priority_script,29,29,00:00:13,13,00:00:49,0,377
20161220-ccc_tax_script,2016/12/20,ccc_tax_script,23,23,00:00:36,36,00:02:41,0,828
20161220-ccc_waste_recycling_script,2016/12/20,ccc_waste_recycling_script,0,0,00:00:00,0,00:00:00,0,0
20161221-ccc_311_calgary_script,2016/12/21,ccc_311_calgary_script,2153,2043,00:00:44,44,00:06:45,110,89892
20161221-ccc_311_lobby_ph_script,2016/12/21,ccc_311_lobby_ph_script,4,4,00:00:04,4,00:00:05,0,16
20161221-ccc_aserv_info_script,2016/12/21,ccc_aserv_info_script,0,0,00:00:00,0,00:00:00,0,0
20161221-ccc_bylaw_script,2016/12/21,ccc_bylaw_script,0,0,00:00:00,0,00:00:00,0,0
20161221-ccc_city_script,2016/12/21,ccc_city_script,19,19,00:00:22,22,00:03:29,0,418
20161221-ccc_cty_online_script,2016/12/21,ccc_cty_online_script,0,0,00:00:00,0,00:00:00,0,0
20161221-ccc_feedback_script,2016/12/21,ccc_feedback_script,0,0,00:00:00,0,00:00:00,0,0
20161221-ccc_fpb_script,2016/12/21,ccc_fpb_script,0,0,00:00:00,0,00:00:00,0,0
20161221-ccc_help_script,2016/12/21,ccc_help_script,11,10,00:00:06,6,00:00:11,1,60
20161221-ccc_link_script,2016/12/21,ccc_link_script,0,0,00:00:00,0,00:00:00,0,0
20161221-ccc_media_line_script,2016/12/21,ccc_media_line_script,0,0,00:00:00,0,00:00:00,0,0
20161221-ccc_priority_script,2016/12/21,ccc_priority_script,15,14,00:00:08,8,00:00:18,1,112
20161221-ccc_tax_script,2016/12/21,ccc_tax_script,27,25,00:00:30,30,00:04:25,2,750
20161221-ccc_waste_recycling_script,2016/12/21,ccc_waste_recycling_script,0,0,00:00:00,0,00:00:00,0,0
20161222-ccc_311_calgary_script,2016/12/22,ccc_311_calgary_script,2018,1981,00:00:17,17,00:05:47,37,33677
20161222-ccc_311_lobby_ph_script,2016/12/22,ccc_311_lobby_ph_script,1,1,00:00:04,4,00:00:04,0,4
20161222-ccc_aserv_info_script,2016/12/22,ccc_aserv_info_script,0,0,00:00:00,0,00:00:00,0,0
20161222-ccc_bylaw_script,2016/12/22,ccc_bylaw_script,0,0,00:00:00,0,00:00:00,0,0
20161222-ccc_city_script,2016/12/22,ccc_city_script,16,16,00:00:10,10,00:00:38,0,160
20161222-ccc_cty_online_script,2016/12/22,ccc_cty_online_script,0,0,00:00:00,0,00:00:00,0,0
20161222-ccc_feedback_script,2016/12/22,ccc_feedback_script,0,0,00:00:00,0,00:00:00,0,0
20161222-ccc_fpb_script,2016/12/22,ccc_fpb_script,0,0,00:00:00,0,00:00:00,0,0
20161222-ccc_help_script,2016/12/22,ccc_help_script,5,5,00:00:27,27,00:01:51,0,135
20161222-ccc_link_script,2016/12/22,ccc_link_script,0,0,00:00:00,0,00:00:00,0,0
20161222-ccc_media_line_script,2016/12/22,ccc_media_line_script,0,0,00:00:00,0,00:00:00,0,0
20161222-ccc_priority_script,2016/12/22,ccc_priority_script,16,16,00:00:09,9,00:00:36,0,144
20161222-ccc_tax_script,2016/12/22,ccc_tax_script,16,15,00:00:10,10,00:00:32,1,150
20161222-ccc_waste_recycling_script,2016/12/22,ccc_waste_recycling_script,0,0,00:00:00,0,00:00:00,0,0
20161223-ccc_311_calgary_script,2016/12/23,ccc_311_calgary_script,1612,1568,00:00:16,16,00:04:41,44,25088
20161223-ccc_311_lobby_ph_script,2016/12/23,ccc_311_lobby_ph_script,1,1,00:00:08,8,00:00:08,0,8
20161223-ccc_aserv_info_script,2016/12/23,ccc_aserv_info_script,0,0,00:00:00,0,00:00:00,0,0
20161223-ccc_bylaw_script,2016/12/23,ccc_bylaw_script,0,0,00:00:00,0,00:00:00,0,0
20161223-ccc_city_script,2016/12/23,ccc_city_script,6,6,00:00:06,6,00:00:20,0,36
20161223-ccc_cty_online_script,2016/12/23,ccc_cty_online_script,0,0,00:00:00,0,00:00:00,0,0
20161223-ccc_feedback_script,2016/12/23,ccc_feedback_script,0,0,00:00:00,0,00:00:00,0,0
20161223-ccc_fpb_script,2016/12/23,ccc_fpb_script,0,0,00:00:00,0,00:00:00,0,0
20161223-ccc_help_script,2016/12/23,ccc_help_script,27,26,00:00:13,13,00:01:21,1,338
20161223-ccc_link_script,2016/12/23,ccc_link_script,0,0,00:00:00,0,00:00:00,0,0
20161223-ccc_media_line_script,2016/12/23,ccc_media_line_script,0,0,00:00:00,0,00:00:00,0,0
20161223-ccc_priority_script,2016/12/23,ccc_priority_script,36,36,00:00:06,6,00:00:15,0,216
20161223-ccc_tax_script,2016/12/23,ccc_tax_script,20,20,00:00:23,23,00:03:48,0,460
20161223-ccc_waste_recycling_script,2016/12/23,ccc_waste_recycling_script,0,0,00:00:00,0,00:00:00,0,0
20161224-ccc_311_calgary_script,2016/12/24,ccc_311_calgary_script,1016,950,00:00:36,36,00:12:46,66,34200
20161224-ccc_311_lobby_ph_script,2016/12/24,ccc_311_lobby_ph_script,0,0,00:00:00,0,00:00:00,0,0
20161224-ccc_aserv_info_script,2016/12/24,ccc_aserv_info_script,0,0,00:00:00,0,00:00:00,0,0
20161224-ccc_bylaw_script,2016/12/24,ccc_bylaw_script,0,0,00:00:00,0,00:00:00,0,0
20161224-ccc_city_script,2016/12/24,ccc_city_script,0,0,00:00:00,0,00:00:00,0,0
20161224-ccc_cty_online_script,2016/12/24,ccc_cty_online_script,0,0,00:00:00,0,00:00:00,0,0
20161224-ccc_feedback_script,2016/12/24,ccc_feedback_script,0,0,00:00:00,0,00:00:00,0,0
20161224-ccc_fpb_script,2016/12/24,ccc_fpb_script,0,0,00:00:00,0,00:00:00,0,0
20161224-ccc_help_script,2016/12/24,ccc_help_script,15,12,00:00:23,23,00:01:06,3,276
20161224-ccc_link_script,2016/12/24,ccc_link_script,0,0,00:00:00,0,00:00:00,0,0
20161224-ccc_media_line_script,2016/12/24,ccc_media_line_script,4,4,00:00:16,16,00:00:36,0,64
20161224-ccc_priority_script,2016/12/24,ccc_priority_script,32,30,00:00:10,10,00:01:02,2,300
20161224-ccc_tax_script,2016/12/24,ccc_tax_script,0,0,00:00:00,0,00:00:00,0,0
20161224-ccc_waste_recycling_script,2016/12/24,ccc_waste_recycling_script,0,0,00:00:00,0,00:00:00,0,0
20161225-ccc_311_calgary_script,2016/12/25,ccc_311_calgary_script,478,460,00:00:17,17,00:04:55,18,7820
20161225-ccc_311_lobby_ph_script,2016/12/25,ccc_311_lobby_ph_script,0,0,00:00:00,0,00:00:00,0,0
20161225-ccc_aserv_info_script,2016/12/25,ccc_aserv_info_script,0,0,00:00:00,0,00:00:00,0,0
20161225-ccc_bylaw_script,2016/12/25,ccc_bylaw_script,0,0,00:00:00,0,00:00:00,0,0
20161225-ccc_city_script,2016/12/25,ccc_city_script,0,0,00:00:00,0,00:00:00,0,0
20161225-ccc_cty_online_script,2016/12/25,ccc_cty_online_script,0,0,00:00:00,0,00:00:00,0,0
20161225-ccc_feedback_script,2016/12/25,ccc_feedback_script,0,0,00:00:00,0,00:00:00,0,0
20161225-ccc_fpb_script,2016/12/25,ccc_fpb_script,0,0,00:00:00,0,00:00:00,0,0
20161225-ccc_help_script,2016/12/25,ccc_help_script,2,0,00:00:00,0,00:00:00,2,0
20161225-ccc_link_script,2016/12/25,ccc_link_script,0,0,00:00:00,0,00:00:00,0,0
20161225-ccc_media_line_script,2016/12/25,ccc_media_line_script,1,1,00:00:22,22,00:00:22,0,22
20161225-ccc_priority_script,2016/12/25,ccc_priority_script,18,17,00:00:15,15,00:01:51,1,255
20161225-ccc_tax_script,2016/12/25,ccc_tax_script,0,0,00:00:00,0,00:00:00,0,0
20161225-ccc_waste_recycling_script,2016/12/25,ccc_waste_recycling_script,0,0,00:00:00,0,00:00:00,0,0
20161226-ccc_311_calgary_script,2016/12/26,ccc_311_calgary_script,962,954,00:00:08,8,00:05:12,8,7632
20161226-ccc_311_lobby_ph_script,2016/12/26,ccc_311_lobby_ph_script,0,0,00:00:00,0,00:00:00,0,0
20161226-ccc_aserv_info_script,2016/12/26,ccc_aserv_info_script,0,0,00:00:00,0,00:00:00,0,0
20161226-ccc_bylaw_script,2016/12/26,ccc_bylaw_script,0,0,00:00:00,0,00:00:00,0,0
20161226-ccc_city_script,2016/12/26,ccc_city_script,0,0,00:00:00,0,00:00:00,0,0
20161226-ccc_cty_online_script,2016/12/26,ccc_cty_online_script,0,0,00:00:00,0,00:00:00,0,0
20161226-ccc_feedback_script,2016/12/26,ccc_feedback_script,0,0,00:00:00,0,00:00:00,0,0
20161226-ccc_fpb_script,2016/12/26,ccc_fpb_script,0,0,00:00:00,0,00:00:00,0,0
20161226-ccc_help_script,2016/12/26,ccc_help_script,1,1,00:00:03,3,00:00:03,0,3
20161226-ccc_link_script,2016/12/26,ccc_link_script,0,0,00:00:00,0,00:00:00,0,0
20161226-ccc_media_line_script,2016/12/26,ccc_media_line_script,1,1,00:00:07,7,00:00:07,0,7
20161226-ccc_priority_script,2016/12/26,ccc_priority_script,30,29,00:00:06,6,00:00:12,1,174
20161226-ccc_tax_script,2016/12/26,ccc_tax_script,0,0,00:00:00,0,00:00:00,0,0
20161226-ccc_waste_recycling_script,2016/12/26,ccc_waste_recycling_script,0,0,00:00:00,0,00:00:00,0,0
20161227-ccc_311_calgary_script,2016/12/27,ccc_311_calgary_script,1887,1855,00:00:11,11,00:02:59,32,20405
20161227-ccc_311_lobby_ph_script,2016/12/27,ccc_311_lobby_ph_script,2,1,00:00:02,2,00:00:02,1,2
20161227-ccc_aserv_info_script,2016/12/27,ccc_aserv_info_script,0,0,00:00:00,0,00:00:00,0,0
20161227-ccc_bylaw_script,2016/12/27,ccc_bylaw_script,0,0,00:00:00,0,00:00:00,0,0
20161227-ccc_city_script,2016/12/27,ccc_city_script,9,9,00:00:05,5,00:00:09,0,45
20161227-ccc_cty_online_script,2016/12/27,ccc_cty_online_script,0,0,00:00:00,0,00:00:00,0,0
20161227-ccc_feedback_script,2016/12/27,ccc_feedback_script,0,0,00:00:00,0,00:00:00,0,0
20161227-ccc_fpb_script,2016/12/27,ccc_fpb_script,0,0,00:00:00,0,00:00:00,0,0
20161227-ccc_help_script,2016/12/27,ccc_help_script,6,6,00:00:12,12,00:00:41,0,72
20161227-ccc_link_script,2016/12/27,ccc_link_script,0,0,00:00:00,0,00:00:00,0,0
20161227-ccc_media_line_script,2016/12/27,ccc_media_line_script,0,0,00:00:00,0,00:00:00,0,0
20161227-ccc_priority_script,2016/12/27,ccc_priority_script,47,47,00:00:07,7,00:00:33,0,329
20161227-ccc_tax_script,2016/12/27,ccc_tax_script,1,0,00:00:00,0,00:00:00,1,0
20161227-ccc_waste_recycling_script,2016/12/27,ccc_waste_recycling_script,0,0,00:00:00,0,00:00:00,0,0
20161228-ccc_311_calgary_script,2016/12/28,ccc_311_calgary_script,2482,2079,00:02:20,140,00:11:03,403,291060
20161228-ccc_311_lobby_ph_script,2016/12/28,ccc_311_lobby_ph_script,1,1,00:00:01,1,00:00:01,0,1
20161228-ccc_aserv_info_script,2016/12/28,ccc_aserv_info_script,0,0,00:00:00,0,00:00:00,0,0
20161228-ccc_bylaw_script,2016/12/28,ccc_bylaw_script,1,0,00:00:00,0,00:00:00,1,0
20161228-ccc_city_script,2016/12/28,ccc_city_script,3,3,00:03:12,192,00:09:05,0,576
20161228-ccc_cty_online_script,2016/12/28,ccc_cty_online_script,0,0,00:00:00,0,00:00:00,0,0
20161228-ccc_feedback_script,2016/12/28,ccc_feedback_script,0,0,00:00:00,0,00:00:00,0,0
20161228-ccc_fpb_script,2016/12/28,ccc_fpb_script,0,0,00:00:00,0,00:00:00,0,0
20161228-ccc_help_script,2016/12/28,ccc_help_script,17,16,00:00:13,13,00:01:04,1,208
20161228-ccc_link_script,2016/12/28,ccc_link_script,0,0,00:00:00,0,00:00:00,0,0
20161228-ccc_media_line_script,2016/12/28,ccc_media_line_script,1,1,00:00:06,6,00:00:06,0,6
20161228-ccc_priority_script,2016/12/28,ccc_priority_script,34,31,00:00:21,21,00:03:03,3,651
20161228-ccc_tax_script,2016/12/28,ccc_tax_script,5,5,00:04:04,244,00:08:43,0,1220
20161228-ccc_waste_recycling_script,2016/12/28,ccc_waste_recycling_script,0,0,00:00:00,0,00:00:00,0,0
20161229-ccc_311_calgary_script,2016/12/29,ccc_311_calgary_script,2377,2273,00:00:36,36,00:06:27,104,81828
20161229-ccc_311_lobby_ph_script,2016/12/29,ccc_311_lobby_ph_script,1,1,00:00:19,19,00:00:19,0,19
20161229-ccc_aserv_info_script,2016/12/29,ccc_aserv_info_script,0,0,00:00:00,0,00:00:00,0,0
20161229-ccc_bylaw_script,2016/12/29,ccc_bylaw_script,0,0,00:00:00,0,00:00:00,0,0
20161229-ccc_city_script,2016/12/29,ccc_city_script,3,3,00:00:16,16,00:00:34,0,48
20161229-ccc_cty_online_script,2016/12/29,ccc_cty_online_script,0,0,00:00:00,0,00:00:00,0,0
20161229-ccc_feedback_script,2016/12/29,ccc_feedback_script,0,0,00:00:00,0,00:00:00,0,0
20161229-ccc_fpb_script,2016/12/29,ccc_fpb_script,0,0,00:00:00,0,00:00:00,0,0
20161229-ccc_help_script,2016/12/29,ccc_help_script,32,32,00:00:06,6,00:00:23,0,192
20161229-ccc_link_script,2016/12/29,ccc_link_script,0,0,00:00:00,0,00:00:00,0,0
20161229-ccc_media_line_script,2016/12/29,ccc_media_line_script,0,0,00:00:00,0,00:00:00,0,0
20161229-ccc_priority_script,2016/12/29,ccc_priority_script,27,27,00:00:06,6,00:00:29,0,162
20161229-ccc_tax_script,2016/12/29,ccc_tax_script,1,1,00:00:10,10,00:00:10,0,10
20161229-ccc_waste_recycling_script,2016/12/29,ccc_waste_recycling_script,0,0,00:00:00,0,00:00:00,0,0
20161230-ccc_311_calgary_script,2016/12/30,ccc_311_calgary_script,2297,2203,00:00:33,33,00:06:46,94,72699
20161230-ccc_311_lobby_ph_script,2016/12/30,ccc_311_lobby_ph_script,0,0,00:00:00,0,00:00:00,0,0
20161230-ccc_aserv_info_script,2016/12/30,ccc_aserv_info_script,0,0,00:00:00,0,00:00:00,0,0
20161230-ccc_bylaw_script,2016/12/30,ccc_bylaw_script,0,0,00:00:00,0,00:00:00,0,0
20161230-ccc_city_script,2016/12/30,ccc_city_script,9,9,00:00:13,13,00:00:36,0,117
20161230-ccc_cty_online_script,2016/12/30,ccc_cty_online_script,0,0,00:00:00,0,00:00:00,0,0
20161230-ccc_feedback_script,2016/12/30,ccc_feedback_script,0,0,00:00:00,0,00:00:00,0,0
20161230-ccc_fpb_script,2016/12/30,ccc_fpb_script,0,0,00:00:00,0,00:00:00,0,0
20161230-ccc_help_script,2016/12/30,ccc_help_script,11,11,00:00:14,14,00:00:30,0,154
20161230-ccc_link_script,2016/12/30,ccc_link_script,0,0,00:00:00,0,00:00:00,0,0
20161230-ccc_media_line_script,2016/12/30,ccc_media_line_script,1,1,00:00:04,4,00:00:04,0,4
20161230-ccc_priority_script,2016/12/30,ccc_priority_script,12,12,00:00:15,15,00:01:29,0,180
20161230-ccc_tax_script,2016/12/30,ccc_tax_script,6,6,00:00:36,36,00:01:56,0,216
20161230-ccc_waste_recycling_script,2016/12/30,ccc_waste_recycling_script,0,0,00:00:00,0,00:00:00,0,0
20161231-ccc_311_calgary_script,2016/12/31,ccc_311_calgary_script,1287,1151,00:01:08,68,00:14:36,136,78268
20161231-ccc_311_lobby_ph_script,2016/12/31,ccc_311_lobby_ph_script,0,0,00:00:00,0,00:00:00,0,0
20161231-ccc_aserv_info_script,2016/12/31,ccc_aserv_info_script,0,0,00:00:00,0,00:00:00,0,0
20161231-ccc_bylaw_script,2016/12/31,ccc_bylaw_script,0,0,00:00:00,0,00:00:00,0,0
20161231-ccc_city_script,2016/12/31,ccc_city_script,0,0,00:00:00,0,00:00:00,0,0
20161231-ccc_cty_online_script,2016/12/31,ccc_cty_online_script,0,0,00:00:00,0,00:00:00,0,0
20161231-ccc_feedback_script,2016/12/31,ccc_feedback_script,0,0,00:00:00,0,00:00:00,0,0
20161231-ccc_fpb_script,2016/12/31,ccc_fpb_script,0,0,00:00:00,0,00:00:00,0,0
20161231-ccc_help_script,2016/12/31,ccc_help_script,5,5,00:00:29,29,00:01:37,0,145
20161231-ccc_link_script,2016/12/31,ccc_link_script,0,0,00:00:00,0,00:00:00,0,0
20161231-ccc_media_line_script,2016/12/31,ccc_media_line_script,3,3,00:00:14,14,00:00:34,0,42
20161231-ccc_priority_script,2016/12/31,ccc_priority_script,11,10,00:00:10,10,00:00:51,1,100
20161231-ccc_tax_script,2016/12/31,ccc_tax_script,0,0,00:00:00,0,00:00:00,0,0
20161231-ccc_waste_recycling_script,2016/12/31,ccc_waste_recycling_script,0,0,00:00:00,0,00:00:00,0,0
20170101-ccc_311_calgary_script,2017/01/01,ccc_311_calgary_script,776,758,00:00:23,23,00:05:17,18,17434
20170101-ccc_311_lobby_ph_script,2017/01/01,ccc_311_lobby_ph_script,0,0,00:00:00,0,00:00:00,0,0
20170101-ccc_aserv_info_script,2017/01/01,ccc_aserv_info_script,0,0,00:00:00,0,00:00:00,0,0
20170101-ccc_bylaw_script,2017/01/01,ccc_bylaw_script,1,1,00:00:12,12,00:00:12,0,12
20170101-ccc_city_script,2017/01/01,ccc_city_script,0,0,00:00:00,0,00:00:00,0,0
20170101-ccc_cty_online_script,2017/01/01,ccc_cty_online_script,0,0,00:00:00,0,00:00:00,0,0
20170101-ccc_feedback_script,2017/01/01,ccc_feedback_script,0,0,00:00:00,0,00:00:00,0,0
20170101-ccc_fpb_script,2017/01/01,ccc_fpb_script,0,0,00:00:00,0,00:00:00,0,0
20170101-ccc_help_script,2017/01/01,ccc_help_script,8,8,00:00:12,12,00:00:33,0,96
20170101-ccc_link_script,2017/01/01,ccc_link_script,0,0,00:00:00,0,00:00:00,0,0
20170101-ccc_media_line_script,2017/01/01,ccc_media_line_script,4,3,00:00:13,13,00:00:22,1,39
20170101-ccc_priority_script,2017/01/01,ccc_priority_script,18,17,00:00:08,8,00:00:33,1,136
20170101-ccc_tax_script,2017/01/01,ccc_tax_script,0,0,00:00:00,0,00:00:00,0,0
20170101-ccc_waste_recycling_script,2017/01/01,ccc_waste_recycling_script,0,0,00:00:00,0,00:00:00,0,0
20170102-ccc_311_calgary_script,2017/01/02,ccc_311_calgary_script,2117,2100,00:00:09,9,00:03:33,17,18900
20170102-ccc_311_lobby_ph_script,2017/01/02,ccc_311_lobby_ph_script,1,1,00:00:08,8,00:00:08,0,8
20170102-ccc_aserv_info_script,2017/01/02,ccc_aserv_info_script,0,0,00:00:00,0,00:00:00,0,0
20170102-ccc_bylaw_script,2017/01/02,ccc_bylaw_script,0,0,00:00:00,0,00:00:00,0,0
20170102-ccc_city_script,2017/01/02,ccc_city_script,11,11,00:00:07,7,00:00:13,0,77
20170102-ccc_cty_online_script,2017/01/02,ccc_cty_online_script,0,0,00:00:00,0,00:00:00,0,0
20170102-ccc_feedback_script,2017/01/02,ccc_feedback_script,0,0,00:00:00,0,00:00:00,0,0
20170102-ccc_fpb_script,2017/01/02,ccc_fpb_script,0,0,00:00:00,0,00:00:00,0,0
20170102-ccc_help_script,2017/01/02,ccc_help_script,6,6,00:00:13,13,00:00:34,0,78
20170102-ccc_link_script,2017/01/02,ccc_link_script,0,0,00:00:00,0,00:00:00,0,0
20170102-ccc_media_line_script,2017/01/02,ccc_media_line_script,0,0,00:00:00,0,00:00:00,0,0
20170102-ccc_priority_script,2017/01/02,ccc_priority_script,29,28,00:00:07,7,00:00:19,1,196
20170102-ccc_tax_script,2017/01/02,ccc_tax_script,1,1,00:00:05,5,00:00:05,0,5
20170102-ccc_waste_recycling_script,2017/01/02,ccc_waste_recycling_script,0,0,00:00:00,0,00:00:00,0,0
20170103-ccc_311_calgary_script,2017/01/03,ccc_311_calgary_script,3346,3089,00:01:06,66,00:17:45,257,203874
20170103-ccc_311_lobby_ph_script,2017/01/03,ccc_311_lobby_ph_script,5,4,00:00:06,6,00:00:15,1,24
20170103-ccc_aserv_info_script,2017/01/03,ccc_aserv_info_script,0,0,00:00:00,0,00:00:00,0,0
20170103-ccc_bylaw_script,2017/01/03,ccc_bylaw_script,0,0,00:00:00,0,00:00:00,0,0
20170103-ccc_city_script,2017/01/03,ccc_city_script,39,36,00:00:24,24,00:02:20,3,864
20170103-ccc_cty_online_script,2017/01/03,ccc_cty_online_script,0,0,00:00:00,0,00:00:00,0,0
20170103-ccc_feedback_script,2017/01/03,ccc_feedback_script,0,0,00:00:00,0,00:00:00,0,0
20170103-ccc_fpb_script,2017/01/03,ccc_fpb_script,1,1,00:00:08,8,00:00:08,0,8
20170103-ccc_help_script,2017/01/03,ccc_help_script,30,28,00:00:10,10,00:00:27,2,280
20170103-ccc_link_script,2017/01/03,ccc_link_script,0,0,00:00:00,0,00:00:00,0,0
20170103-ccc_media_line_script,2017/01/03,ccc_media_line_script,4,4,00:00:13,13,00:00:18,0,52
20170103-ccc_priority_script,2017/01/03,ccc_priority_script,51,50,00:00:12,12,00:01:13,1,600
20170103-ccc_tax_script,2017/01/03,ccc_tax_script,25,21,00:01:37,97,00:04:15,4,2037
20170103-ccc_waste_recycling_script,2017/01/03,ccc_waste_recycling_script,0,0,00:00:00,0,00:00:00,0,0
20170104-ccc_311_calgary_script,2017/01/04,ccc_311_calgary_script,3214,2798,00:02:02,122,00:07:10,413,341356
20170104-ccc_311_lobby_ph_script,2017/01/04,ccc_311_lobby_ph_script,2,2,00:00:06,6,00:00:07,0,12
20170104-ccc_aserv_info_script,2017/01/04,ccc_aserv_info_script,0,0,00:00:00,0,00:00:00,0,0
20170104-ccc_bylaw_script,2017/01/04,ccc_bylaw_script,0,0,00:00:00,0,00:00:00,0,0
20170104-ccc_city_script,2017/01/04,ccc_city_script,35,33,00:00:44,44,00:03:54,2,1452
20170104-ccc_cty_online_script,2017/01/04,ccc_cty_online_script,0,0,00:00:00,0,00:00:00,0,0
20170104-ccc_feedback_script,2017/01/04,ccc_feedback_script,0,0,00:00:00,0,00:00:00,0,0
20170104-ccc_fpb_script,2017/01/04,ccc_fpb_script,0,0,00:00:00,0,00:00:00,0,0
20170104-ccc_help_script,2017/01/04,ccc_help_script,42,36,00:00:12,12,00:00:43,6,432
20170104-ccc_link_script,2017/01/04,ccc_link_script,0,0,00:00:00,0,00:00:00,0,0
20170104-ccc_media_line_script,2017/01/04,ccc_media_line_script,4,3,00:00:11,11,00:00:15,1,33
20170104-ccc_priority_script,2017/01/04,ccc_priority_script,53,53,00:00:09,9,00:00:39,0,477
20170104-ccc_tax_script,2017/01/04,ccc_tax_script,23,18,00:02:17,137,00:05:51,5,2466
20170104-ccc_waste_recycling_script,2017/01/04,ccc_waste_recycling_script,0,0,00:00:00,0,00:00:00,0,0
20170105-ccc_311_calgary_script,2017/01/05,ccc_311_calgary_script,2861,2699,00:00:48,48,00:04:39,162,129552
20170105-ccc_311_lobby_ph_script,2017/01/05,ccc_311_lobby_ph_script,1,1,00:00:03,3,00:00:03,0,3
20170105-ccc_aserv_info_script,2017/01/05,ccc_aserv_info_script,0,0,00:00:00,0,00:00:00,0,0
20170105-ccc_bylaw_script,2017/01/05,ccc_bylaw_script,0,0,00:00:00,0,00:00:00,0,0
20170105-ccc_city_script,2017/01/05,ccc_city_script,23,23,00:00:18,18,00:00:55,0,414
20170105-ccc_cty_online_script,2017/01/05,ccc_cty_online_script,0,0,00:00:00,0,00:00:00,0,0
20170105-ccc_feedback_script,2017/01/05,ccc_feedback_script,1,0,00:00:00,0,00:00:00,0,0
20170105-ccc_fpb_script,2017/01/05,ccc_fpb_script,1,0,00:00:00,0,00:00:00,1,0
20170105-ccc_help_script,2017/01/05,ccc_help_script,26,22,00:00:10,10,00:00:31,4,220
20170105-ccc_link_script,2017/01/05,ccc_link_script,0,0,00:00:00,0,00:00:00,0,0
20170105-ccc_media_line_script,2017/01/05,ccc_media_line_script,0,0,00:00:00,0,00:00:00,0,0
20170105-ccc_priority_script,2017/01/05,ccc_priority_script,35,30,00:00:07,7,00:00:16,0,210
20170105-ccc_tax_script,2017/01/05,ccc_tax_script,19,17,00:01:21,81,00:03:46,2,1377
20170105-ccc_waste_recycling_script,2017/01/05,ccc_waste_recycling_script,0,0,00:00:00,0,00:00:00,0,0
20170106-ccc_311_calgary_script,2017/01/06,ccc_311_calgary_script,2789,2541,00:01:20,80,00:05:34,248,203280
20170106-ccc_311_lobby_ph_script,2017/01/06,ccc_311_lobby_ph_script,1,1,00:00:28,28,00:00:28,0,28
20170106-ccc_aserv_info_script,2017/01/06,ccc_aserv_info_script,0,0,00:00:00,0,00:00:00,0,0
20170106-ccc_bylaw_script,2017/01/06,ccc_bylaw_script,0,0,00:00:00,0,00:00:00,0,0
20170106-ccc_city_script,2017/01/06,ccc_city_script,24,22,00:00:27,27,00:02:48,2,594
20170106-ccc_cty_online_script,2017/01/06,ccc_cty_online_script,0,0,00:00:00,0,00:00:00,0,0
20170106-ccc_feedback_script,2017/01/06,ccc_feedback_script,0,0,00:00:00,0,00:00:00,0,0
20170106-ccc_fpb_script,2017/01/06,ccc_fpb_script,0,0,00:00:00,0,00:00:00,0,0
20170106-ccc_help_script,2017/01/06,ccc_help_script,35,34,00:00:11,11,00:00:53,1,374
20170106-ccc_link_script,2017/01/06,ccc_link_script,0,0,00:00:00,0,00:00:00,0,0
20170106-ccc_media_line_script,2017/01/06,ccc_media_line_script,1,1,00:00:03,3,00:00:03,0,3
20170106-ccc_priority_script,2017/01/06,ccc_priority_script,25,23,00:00:08,8,00:00:32,2,184
20170106-ccc_tax_script,2017/01/06,ccc_tax_script,21,19,00:01:40,100,00:03:13,2,1900
20170106-ccc_waste_recycling_script,2017/01/06,ccc_waste_recycling_script,0,0,00:00:00,0,00:00:00,0,0
20170107-ccc_311_calgary_script,2017/01/07,ccc_311_calgary_script,1063,1051,00:00:09,9,00:03:29,12,9459
20170107-ccc_311_lobby_ph_script,2017/01/07,ccc_311_lobby_ph_script,0,0,00:00:00,0,00:00:00,0,0
20170107-ccc_aserv_info_script,2017/01/07,ccc_aserv_info_script,0,0,00:00:00,0,00:00:00,0,0
20170107-ccc_bylaw_script,2017/01/07,ccc_bylaw_script,0,0,00:00:00,0,00:00:00,0,0
20170107-ccc_city_script,2017/01/07,ccc_city_script,0,0,00:00:00,0,00:00:00,0,0
20170107-ccc_cty_online_script,2017/01/07,ccc_cty_online_script,0,0,00:00:00,0,00:00:00,0,0
20170107-ccc_feedback_script,2017/01/07,ccc_feedback_script,0,0,00:00:00,0,00:00:00,0,0
20170107-ccc_fpb_script,2017/01/07,ccc_fpb_script,0,0,00:00:00,0,00:00:00,0,0
20170107-ccc_help_script,2017/01/07,ccc_help_script,9,8,00:00:13,13,00:01:07,1,104
20170107-ccc_link_script,2017/01/07,ccc_link_script,0,0,00:00:00,0,00:00:00,0,0
20170107-ccc_media_line_script,2017/01/07,ccc_media_line_script,0,0,00:00:00,0,00:00:00,0,0
20170107-ccc_priority_script,2017/01/07,ccc_priority_script,30,30,00:00:08,8,00:00:30,0,240
20170107-ccc_tax_script,2017/01/07,ccc_tax_script,0,0,00:00:00,0,00:00:00,0,0
20170107-ccc_waste_recycling_script,2017/01/07,ccc_waste_recycling_script,0,0,00:00:00,0,00:00:00,0,0
20170108-ccc_311_calgary_script,2017/01/08,ccc_311_calgary_script,836,821,00:00:12,12,00:03:50,15,9852
20170108-ccc_311_lobby_ph_script,2017/01/08,ccc_311_lobby_ph_script,0,0,00:00:00,0,00:00:00,0,0
20170108-ccc_aserv_info_script,2017/01/08,ccc_aserv_info_script,0,0,00:00:00,0,00:00:00,0,0
20170108-ccc_bylaw_script,2017/01/08,ccc_bylaw_script,0,0,00:00:00,0,00:00:00,0,0
20170108-ccc_city_script,2017/01/08,ccc_city_script,0,0,00:00:00,0,00:00:00,0,0
20170108-ccc_cty_online_script,2017/01/08,ccc_cty_online_script,0,0,00:00:00,0,00:00:00,0,0
20170108-ccc_feedback_script,2017/01/08,ccc_feedback_script,0,0,00:00:00,0,00:00:00,0,0
20170108-ccc_fpb_script,2017/01/08,ccc_fpb_script,0,0,00:00:00,0,00:00:00,0,0
20170108-ccc_help_script,2017/01/08,ccc_help_script,1,1,00:00:03,3,00:00:03,0,3
20170108-ccc_link_script,2017/01/08,ccc_link_script,0,0,00:00:00,0,00:00:00,0,0
20170108-ccc_media_line_script,2017/01/08,ccc_media_line_script,0,0,00:00:00,0,00:00:00,0,0
20170108-ccc_priority_script,2017/01/08,ccc_priority_script,22,22,00:00:18,18,00:01:23,0,396
20170108-ccc_tax_script,2017/01/08,ccc_tax_script,0,0,00:00:00,0,00:00:00,0,0
20170108-ccc_waste_recycling_script,2017/01/08,ccc_waste_recycling_script,0,0,00:00:00,0,00:00:00,0,0
20170109-ccc_311_calgary_script,2017/01/09,ccc_311_calgary_script,3314,3208,00:00:23,23,00:05:43,106,73784
20170109-ccc_311_lobby_ph_script,2017/01/09,ccc_311_lobby_ph_script,1,1,00:00:05,5,00:00:05,0,5
20170109-ccc_aserv_info_script,2017/01/09,ccc_aserv_info_script,0,0,00:00:00,0,00:00:00,0,0
20170109-ccc_bylaw_script,2017/01/09,ccc_bylaw_script,0,0,00:00:00,0,00:00:00,0,0
20170109-ccc_city_script,2017/01/09,ccc_city_script,16,14,00:00:17,17,00:01:27,2,238
20170109-ccc_cty_online_script,2017/01/09,ccc_cty_online_script,0,0,00:00:00,0,00:00:00,0,0
20170109-ccc_feedback_script,2017/01/09,ccc_feedback_script,0,0,00:00:00,0,00:00:00,0,0
20170109-ccc_fpb_script,2017/01/09,ccc_fpb_script,0,0,00:00:00,0,00:00:00,0,0
20170109-ccc_help_script,2017/01/09,ccc_help_script,25,25,00:00:09,9,00:00:25,0,225
20170109-ccc_link_script,2017/01/09,ccc_link_script,0,0,00:00:00,0,00:00:00,0,0
20170109-ccc_media_line_script,2017/01/09,ccc_media_line_script,2,2,00:00:04,4,00:00:04,0,8
20170109-ccc_priority_script,2017/01/09,ccc_priority_script,31,30,00:00:07,7,00:00:28,1,210
20170109-ccc_tax_script,2017/01/09,ccc_tax_script,21,20,00:00:19,19,00:02:30,1,380
20170109-ccc_waste_recycling_script,2017/01/09,ccc_waste_recycling_script,0,0,00:00:00,0,00:00:00,0,0
20170110-ccc_311_calgary_script,2017/01/10,ccc_311_calgary_script,3033,2988,00:00:11,11,00:04:47,45,32868
20170110-ccc_311_lobby_ph_script,2017/01/10,ccc_311_lobby_ph_script,1,1,00:00:03,3,00:00:03,0,3
20170110-ccc_aserv_info_script,2017/01/10,ccc_aserv_info_script,0,0,00:00:00,0,00:00:00,0,0
20170110-ccc_bylaw_script,2017/01/10,ccc_bylaw_script,0,0,00:00:00,0,00:00:00,0,0
20170110-ccc_city_script,2017/01/10,ccc_city_script,12,12,00:00:05,5,00:00:09,0,60
20170110-ccc_cty_online_script,2017/01/10,ccc_cty_online_script,0,0,00:00:00,0,00:00:00,0,0
20170110-ccc_feedback_script,2017/01/10,ccc_feedback_script,0,0,00:00:00,0,00:00:00,0,0
20170110-ccc_fpb_script,2017/01/10,ccc_fpb_script,2,2,00:00:08,8,00:00:08,0,16
20170110-ccc_help_script,2017/01/10,ccc_help_script,22,22,00:00:06,6,00:00:15,0,132
20170110-ccc_link_script,2017/01/10,ccc_link_script,0,0,00:00:00,0,00:00:00,0,0
20170110-ccc_media_line_script,2017/01/10,ccc_media_line_script,1,1,00:00:13,13,00:00:13,0,13
20170110-ccc_priority_script,2017/01/10,ccc_priority_script,44,43,00:00:06,6,00:00:16,1,258
20170110-ccc_tax_script,2017/01/10,ccc_tax_script,24,23,00:00:09,9,00:00:27,1,207
20170110-ccc_waste_recycling_script,2017/01/10,ccc_waste_recycling_script,0,0,00:00:00,0,00:00:00,0,0
20170111-ccc_311_calgary_script,2017/01/11,ccc_311_calgary_script,2931,2851,00:00:17,17,00:06:55,80,48467
20170111-ccc_311_lobby_ph_script,2017/01/11,ccc_311_lobby_ph_script,3,3,00:00:04,4,00:00:08,0,12
20170111-ccc_aserv_info_script,2017/01/11,ccc_aserv_info_script,0,0,00:00:00,0,00:00:00,0,0
20170111-ccc_bylaw_script,2017/01/11,ccc_bylaw_script,0,0,00:00:00,0,00:00:00,0,0
20170111-ccc_city_script,2017/01/11,ccc_city_script,11,11,00:00:10,10,00:00:36,0,110
20170111-ccc_cty_online_script,2017/01/11,ccc_cty_online_script,0,0,00:00:00,0,00:00:00,0,0
20170111-ccc_feedback_script,2017/01/11,ccc_feedback_script,0,0,00:00:00,0,00:00:00,0,0
20170111-ccc_fpb_script,2017/01/11,ccc_fpb_script,0,0,00:00:00,0,00:00:00,0,0
20170111-ccc_help_script,2017/01/11,ccc_help_script,28,28,00:00:10,10,00:00:37,0,280
20170111-ccc_link_script,2017/01/11,ccc_link_script,0,0,00:00:00,0,00:00:00,0,0
20170111-ccc_media_line_script,2017/01/11,ccc_media_line_script,0,0,00:00:00,0,00:00:00,0,0
20170111-ccc_priority_script,2017/01/11,ccc_priority_script,33,32,00:00:09,9,00:00:53,1,288
20170111-ccc_tax_script,2017/01/11,ccc_tax_script,13,13,00:00:17,17,00:01:00,0,221
20170111-ccc_waste_recycling_script,2017/01/11,ccc_waste_recycling_script,0,0,00:00:00,0,00:00:00,0,0
20170112-ccc_311_calgary_script,2017/01/12,ccc_311_calgary_script,2960,2807,00:00:31,31,00:06:30,153,87017
20170112-ccc_311_lobby_ph_script,2017/01/12,ccc_311_lobby_ph_script,1,1,00:00:12,12,00:00:12,0,12
20170112-ccc_aserv_info_script,2017/01/12,ccc_aserv_info_script,0,0,00:00:00,0,00:00:00,0,0
20170112-ccc_bylaw_script,2017/01/12,ccc_bylaw_script,0,0,00:00:00,0,00:00:00,0,0
20170112-ccc_city_script,2017/01/12,ccc_city_script,15,15,00:00:07,7,00:00:37,0,105
20170112-ccc_cty_online_script,2017/01/12,ccc_cty_online_script,0,0,00:00:00,0,00:00:00,0,0
20170112-ccc_feedback_script,2017/01/12,ccc_feedback_script,0,0,00:00:00,0,00:00:00,0,0
20170112-ccc_fpb_script,2017/01/12,ccc_fpb_script,1,1,00:00:11,11,00:00:11,0,11
20170112-ccc_help_script,2017/01/12,ccc_help_script,24,22,00:00:09,9,00:00:45,2,198
20170112-ccc_link_script,2017/01/12,ccc_link_script,0,0,00:00:00,0,00:00:00,0,0
20170112-ccc_media_line_script,2017/01/12,ccc_media_line_script,2,2,00:00:06,6,00:00:06,0,12
20170112-ccc_priority_script,2017/01/12,ccc_priority_script,34,32,00:00:08,8,00:00:26,2,256
20170112-ccc_tax_script,2017/01/12,ccc_tax_script,11,10,00:01:20,80,00:03:27,1,800
20170112-ccc_waste_recycling_script,2017/01/12,ccc_waste_recycling_script,0,0,00:00:00,0,00:00:00,0,0
20170113-ccc_311_calgary_script,2017/01/13,ccc_311_calgary_script,2773,2649,00:00:26,26,00:03:58,124,68874
20170113-ccc_311_lobby_ph_script,2017/01/13,ccc_311_lobby_ph_script,3,3,00:00:04,4,00:00:05,0,12
20170113-ccc_aserv_info_script,2017/01/13,ccc_aserv_info_script,0,0,00:00:00,0,00:00:00,0,0
20170113-ccc_bylaw_script,2017/01/13,ccc_bylaw_script,0,0,00:00:00,0,00:00:00,0,0
20170113-ccc_city_script,2017/01/13,ccc_city_script,10,10,00:00:08,8,00:00:20,0,80
20170113-ccc_cty_online_script,2017/01/13,ccc_cty_online_script,0,0,00:00:00,0,00:00:00,0,0
20170113-ccc_feedback_script,2017/01/13,ccc_feedback_script,0,0,00:00:00,0,00:00:00,0,0
20170113-ccc_fpb_script,2017/01/13,ccc_fpb_script,0,0,00:00:00,0,00:00:00,0,0
20170113-ccc_help_script,2017/01/13,ccc_help_script,21,21,00:00:24,24,00:01:20,0,504
20170113-ccc_link_script,2017/01/13,ccc_link_script,0,0,00:00:00,0,00:00:00,0,0
20170113-ccc_media_line_script,2017/01/13,ccc_media_line_script,0,0,00:00:00,0,00:00:00,0,0
20170113-ccc_priority_script,2017/01/13,ccc_priority_script,38,36,00:00:10,10,00:01:39,2,360
20170113-ccc_tax_script,2017/01/13,ccc_tax_script,31,29,00:00:19,19,00:02:06,2,551
20170113-ccc_waste_recycling_script,2017/01/13,ccc_waste_recycling_script,0,0,00:00:00,0,00:00:00,0,0
20170114-ccc_311_calgary_script,2017/01/14,ccc_311_calgary_script,1075,1057,00:00:12,12,00:04:11,18,12684
20170114-ccc_311_lobby_ph_script,2017/01/14,ccc_311_lobby_ph_script,0,0,00:00:00,0,00:00:00,0,0
20170114-ccc_aserv_info_script,2017/01/14,ccc_aserv_info_script,0,0,00:00:00,0,00:00:00,0,0
20170114-ccc_bylaw_script,2017/01/14,ccc_bylaw_script,0,0,00:00:00,0,00:00:00,0,0
20170114-ccc_city_script,2017/01/14,ccc_city_script,0,0,00:00:00,0,00:00:00,0,0
20170114-ccc_cty_online_script,2017/01/14,ccc_cty_online_script,0,0,00:00:00,0,00:00:00,0,0
20170114-ccc_feedback_script,2017/01/14,ccc_feedback_script,0,0,00:00:00,0,00:00:00,0,0
20170114-ccc_fpb_script,2017/01/14,ccc_fpb_script,0,0,00:00:00,0,00:00:00,0,0
20170114-ccc_help_script,2017/01/14,ccc_help_script,9,8,00:00:06,6,00:00:10,1,48
20170114-ccc_link_script,2017/01/14,ccc_link_script,0,0,00:00:00,0,00:00:00,0,0
20170114-ccc_media_line_script,2017/01/14,ccc_media_line_script,3,3,00:00:04,4,00:00:06,0,12
20170114-ccc_priority_script,2017/01/14,ccc_priority_script,22,20,00:00:07,7,00:01:02,2,140
20170114-ccc_tax_script,2017/01/14,ccc_tax_script,0,0,00:00:00,0,00:00:00,0,0
20170114-ccc_waste_recycling_script,2017/01/14,ccc_waste_recycling_script,0,0,00:00:00,0,00:00:00,0,0
20170115-ccc_311_calgary_script,2017/01/15,ccc_311_calgary_script,997,949,00:00:15,15,00:05:54,48,14235
20170115-ccc_311_lobby_ph_script,2017/01/15,ccc_311_lobby_ph_script,0,0,00:00:00,0,00:00:00,0,0
20170115-ccc_aserv_info_script,2017/01/15,ccc_aserv_info_script,0,0,00:00:00,0,00:00:00,0,0
20170115-ccc_bylaw_script,2017/01/15,ccc_bylaw_script,0,0,00:00:00,0,00:00:00,0,0
20170115-ccc_city_script,2017/01/15,ccc_city_script,0,0,00:00:00,0,00:00:00,0,0
20170115-ccc_cty_online_script,2017/01/15,ccc_cty_online_script,0,0,00:00:00,0,00:00:00,0,0
20170115-ccc_feedback_script,2017/01/15,ccc_feedback_script,0,0,00:00:00,0,00:00:00,0,0
20170115-ccc_fpb_script,2017/01/15,ccc_fpb_script,0,0,00:00:00,0,00:00:00,0,0
20170115-ccc_help_script,2017/01/15,ccc_help_script,5,5,00:00:03,3,00:00:07,0,15
20170115-ccc_link_script,2017/01/15,ccc_link_script,0,0,00:00:00,0,00:00:00,0,0
20170115-ccc_media_line_script,2017/01/15,ccc_media_line_script,2,2,00:00:06,6,00:00:09,0,12
20170115-ccc_priority_script,2017/01/15,ccc_priority_script,20,20,00:00:09,9,00:01:11,0,180
20170115-ccc_tax_script,2017/01/15,ccc_tax_script,0,0,00:00:00,0,00:00:00,0,0
20170115-ccc_waste_recycling_script,2017/01/15,ccc_waste_recycling_script,0,0,00:00:00,0,00:00:00,0,0
20170116-ccc_311_calgary_script,2017/01/16,ccc_311_calgary_script,3152,3049,00:00:29,29,00:06:28,103,88421
20170116-ccc_311_lobby_ph_script,2017/01/16,ccc_311_lobby_ph_script,1,1,00:00:09,9,00:00:09,0,9
20170116-ccc_aserv_info_script,2017/01/16,ccc_aserv_info_script,0,0,00:00:00,0,00:00:00,0,0
20170116-ccc_bylaw_script,2017/01/16,ccc_bylaw_script,0,0,00:00:00,0,00:00:00,0,0
20170116-ccc_city_script,2017/01/16,ccc_city_script,23,23,00:00:10,10,00:00:34,0,230
20170116-ccc_cty_online_script,2017/01/16,ccc_cty_online_script,0,0,00:00:00,0,00:00:00,0,0
20170116-ccc_feedback_script,2017/01/16,ccc_feedback_script,0,0,00:00:00,0,00:00:00,0,0
20170116-ccc_fpb_script,2017/01/16,ccc_fpb_script,0,0,00:00:00,0,00:00:00,0,0
20170116-ccc_help_script,2017/01/16,ccc_help_script,15,15,00:00:10,10,00:00:36,0,150
20170116-ccc_link_script,2017/01/16,ccc_link_script,0,0,00:00:00,0,00:00:00,0,0
20170116-ccc_media_line_script,2017/01/16,ccc_media_line_script,1,1,00:00:02,2,00:00:02,0,2
20170116-ccc_priority_script,2017/01/16,ccc_priority_script,25,24,00:00:08,8,00:00:18,1,192
20170116-ccc_tax_script,2017/01/16,ccc_tax_script,25,25,00:00:28,28,00:02:49,0,700
20170116-ccc_waste_recycling_script,2017/01/16,ccc_waste_recycling_script,0,0,00:00:00,0,00:00:00,0,0
20170117-ccc_311_calgary_script,2017/01/17,ccc_311_calgary_script,3434,2993,00:01:49,109,00:06:51,441,326237
20170117-ccc_311_lobby_ph_script,2017/01/17,ccc_311_lobby_ph_script,0,0,00:00:00,0,00:00:00,0,0
20170117-ccc_aserv_info_script,2017/01/17,ccc_aserv_info_script,0,0,00:00:00,0,00:00:00,0,0
20170117-ccc_bylaw_script,2017/01/17,ccc_bylaw_script,0,0,00:00:00,0,00:00:00,0,0
20170117-ccc_city_script,2017/01/17,ccc_city_script,23,20,00:00:16,16,00:01:07,3,320
20170117-ccc_cty_online_script,2017/01/17,ccc_cty_online_script,0,0,00:00:00,0,00:00:00,0,0
20170117-ccc_feedback_script,2017/01/17,ccc_feedback_script,0,0,00:00:00,0,00:00:00,0,0
20170117-ccc_fpb_script,2017/01/17,ccc_fpb_script,2,2,00:00:11,11,00:00:17,0,22
20170117-ccc_help_script,2017/01/17,ccc_help_script,24,24,00:00:19,19,00:03:26,0,456
20170117-ccc_link_script,2017/01/17,ccc_link_script,0,0,00:00:00,0,00:00:00,0,0
20170117-ccc_media_line_script,2017/01/17,ccc_media_line_script,0,0,00:00:00,0,00:00:00,0,0
20170117-ccc_priority_script,2017/01/17,ccc_priority_script,23,22,00:00:06,6,00:00:27,1,132
20170117-ccc_tax_script,2017/01/17,ccc_tax_script,24,21,00:01:27,87,00:04:52,3,1827
20170117-ccc_waste_recycling_script,2017/01/17,ccc_waste_recycling_script,0,0,00:00:00,0,00:00:00,0,0
20170118-ccc_311_calgary_script,2017/01/18,ccc_311_calgary_script,3483,3118,00:01:25,85,00:08:37,365,265030
20170118-ccc_311_lobby_ph_script,2017/01/18,ccc_311_lobby_ph_script,6,6,00:00:14,14,00:00:30,0,84
20170118-ccc_aserv_info_script,2017/01/18,ccc_aserv_info_script,0,0,00:00:00,0,00:00:00,0,0
20170118-ccc_bylaw_script,2017/01/18,ccc_bylaw_script,0,0,00:00:00,0,00:00:00,0,0
20170118-ccc_city_script,2017/01/18,ccc_city_script,22,21,00:00:20,20,00:02:22,1,420
20170118-ccc_cty_online_script,2017/01/18,ccc_cty_online_script,0,0,00:00:00,0,00:00:00,0,0
20170118-ccc_feedback_script,2017/01/18,ccc_feedback_script,0,0,00:00:00,0,00:00:00,0,0
20170118-ccc_fpb_script,2017/01/18,ccc_fpb_script,0,0,00:00:00,0,00:00:00,0,0
20170118-ccc_help_script,2017/01/18,ccc_help_script,29,26,00:00:12,12,00:01:07,3,312
20170118-ccc_link_script,2017/01/18,ccc_link_script,0,0,00:00:00,0,00:00:00,0,0
20170118-ccc_media_line_script,2017/01/18,ccc_media_line_script,6,3,00:00:14,14,00:00:19,3,42
20170118-ccc_priority_script,2017/01/18,ccc_priority_script,31,30,00:00:11,11,00:01:19,1,330
20170118-ccc_tax_script,2017/01/18,ccc_tax_script,11,10,00:01:07,67,00:04:29,1,670
20170118-ccc_waste_recycling_script,2017/01/18,ccc_waste_recycling_script,0,0,00:00:00,0,00:00:00,0,0
20170119-ccc_311_calgary_script,2017/01/19,ccc_311_calgary_script,3666,2981,00:02:49,169,00:11:18,685,503789
20170119-ccc_311_lobby_ph_script,2017/01/19,ccc_311_lobby_ph_script,1,1,00:00:23,23,00:00:23,0,23
20170119-ccc_aserv_info_script,2017/01/19,ccc_aserv_info_script,0,0,00:00:00,0,00:00:00,0,0
20170119-ccc_bylaw_script,2017/01/19,ccc_bylaw_script,0,0,00:00:00,0,00:00:00,0,0
20170119-ccc_city_script,2017/01/19,ccc_city_script,23,22,00:01:03,63,00:04:27,1,1386
20170119-ccc_cty_online_script,2017/01/19,ccc_cty_online_script,0,0,00:00:00,0,00:00:00,0,0
20170119-ccc_feedback_script,2017/01/19,ccc_feedback_script,0,0,00:00:00,0,00:00:00,0,0
20170119-ccc_fpb_script,2017/01/19,ccc_fpb_script,0,0,00:00:00,0,00:00:00,0,0
20170119-ccc_help_script,2017/01/19,ccc_help_script,30,24,00:00:16,16,00:01:26,6,384
20170119-ccc_link_script,2017/01/19,ccc_link_script,0,0,00:00:00,0,00:00:00,0,0
20170119-ccc_media_line_script,2017/01/19,ccc_media_line_script,2,2,00:00:44,44,00:00:51,0,88
20170119-ccc_priority_script,2017/01/19,ccc_priority_script,26,26,00:00:18,18,00:01:53,0,468
20170119-ccc_tax_script,2017/01/19,ccc_tax_script,27,19,00:03:02,182,00:07:07,8,3458
20170119-ccc_waste_recycling_script,2017/01/19,ccc_waste_recycling_script,0,0,00:00:00,0,00:00:00,0,0
20170120-ccc_311_calgary_script,2017/01/20,ccc_311_calgary_script,2889,2781,00:00:29,29,00:04:51,108,80649
20170120-ccc_311_lobby_ph_script,2017/01/20,ccc_311_lobby_ph_script,2,2,00:00:09,9,00:00:15,0,18
20170120-ccc_aserv_info_script,2017/01/20,ccc_aserv_info_script,0,0,00:00:00,0,00:00:00,0,0
20170120-ccc_bylaw_script,2017/01/20,ccc_bylaw_script,0,0,00:00:00,0,00:00:00,0,0
20170120-ccc_city_script,2017/01/20,ccc_city_script,23,23,00:00:13,13,00:00:37,0,299
20170120-ccc_cty_online_script,2017/01/20,ccc_cty_online_script,0,0,00:00:00,0,00:00:00,0,0
20170120-ccc_feedback_script,2017/01/20,ccc_feedback_script,1,0,00:00:00,0,00:00:00,0,0
20170120-ccc_fpb_script,2017/01/20,ccc_fpb_script,0,0,00:00:00,0,00:00:00,0,0
20170120-ccc_help_script,2017/01/20,ccc_help_script,13,13,00:00:07,7,00:00:28,0,91
20170120-ccc_link_script,2017/01/20,ccc_link_script,0,0,00:00:00,0,00:00:00,0,0
20170120-ccc_media_line_script,2017/01/20,ccc_media_line_script,2,2,00:00:08,8,00:00:09,0,16
20170120-ccc_priority_script,2017/01/20,ccc_priority_script,28,28,00:00:08,8,00:00:24,0,224
20170120-ccc_tax_script,2017/01/20,ccc_tax_script,19,19,00:00:27,27,00:01:56,0,513
20170120-ccc_waste_recycling_script,2017/01/20,ccc_waste_recycling_script,0,0,00:00:00,0,00:00:00,0,0
20170121-ccc_311_calgary_script,2017/01/21,ccc_311_calgary_script,1218,1161,00:00:21,21,00:04:10,57,24381
20170121-ccc_311_lobby_ph_script,2017/01/21,ccc_311_lobby_ph_script,0,0,00:00:00,0,00:00:00,0,0
20170121-ccc_aserv_info_script,2017/01/21,ccc_aserv_info_script,0,0,00:00:00,0,00:00:00,0,0
20170121-ccc_bylaw_script,2017/01/21,ccc_bylaw_script,0,0,00:00:00,0,00:00:00,0,0
20170121-ccc_city_script,2017/01/21,ccc_city_script,0,0,00:00:00,0,00:00:00,0,0
20170121-ccc_cty_online_script,2017/01/21,ccc_cty_online_script,0,0,00:00:00,0,00:00:00,0,0
20170121-ccc_feedback_script,2017/01/21,ccc_feedback_script,0,0,00:00:00,0,00:00:00,0,0
20170121-ccc_fpb_script,2017/01/21,ccc_fpb_script,0,0,00:00:00,0,00:00:00,0,0
20170121-ccc_help_script,2017/01/21,ccc_help_script,2,2,00:00:08,8,00:00:11,0,16
20170121-ccc_link_script,2017/01/21,ccc_link_script,0,0,00:00:00,0,00:00:00,0,0
20170121-ccc_media_line_script,2017/01/21,ccc_media_line_script,1,1,00:00:02,2,00:00:02,0,2
20170121-ccc_priority_script,2017/01/21,ccc_priority_script,15,15,00:00:07,7,00:00:17,0,105
20170121-ccc_tax_script,2017/01/21,ccc_tax_script,1,1,00:00:08,8,00:00:08,0,8
20170121-ccc_waste_recycling_script,2017/01/21,ccc_waste_recycling_script,0,0,00:00:00,0,00:00:00,0,0
20170122-ccc_311_calgary_script,2017/01/22,ccc_311_calgary_script,853,818,00:00:24,24,00:09:05,35,19632
20170122-ccc_311_lobby_ph_script,2017/01/22,ccc_311_lobby_ph_script,0,0,00:00:00,0,00:00:00,0,0
20170122-ccc_aserv_info_script,2017/01/22,ccc_aserv_info_script,0,0,00:00:00,0,00:00:00,0,0
20170122-ccc_bylaw_script,2017/01/22,ccc_bylaw_script,0,0,00:00:00,0,00:00:00,0,0
20170122-ccc_city_script,2017/01/22,ccc_city_script,0,0,00:00:00,0,00:00:00,0,0
20170122-ccc_cty_online_script,2017/01/22,ccc_cty_online_script,0,0,00:00:00,0,00:00:00,0,0
20170122-ccc_feedback_script,2017/01/22,ccc_feedback_script,0,0,00:00:00,0,00:00:00,0,0
20170122-ccc_fpb_script,2017/01/22,ccc_fpb_script,0,0,00:00:00,0,00:00:00,0,0
20170122-ccc_help_script,2017/01/22,ccc_help_script,6,5,00:00:07,7,00:00:10,1,35
20170122-ccc_link_script,2017/01/22,ccc_link_script,0,0,00:00:00,0,00:00:00,0,0
20170122-ccc_media_line_script,2017/01/22,ccc_media_line_script,2,2,00:00:05,5,00:00:06,0,10
20170122-ccc_priority_script,2017/01/22,ccc_priority_script,8,8,00:00:22,22,00:01:50,0,176
20170122-ccc_tax_script,2017/01/22,ccc_tax_script,1,1,00:00:03,3,00:00:03,0,3
20170122-ccc_waste_recycling_script,2017/01/22,ccc_waste_recycling_script,0,0,00:00:00,0,00:00:00,0,0
20170123-ccc_311_calgary_script,2017/01/23,ccc_311_calgary_script,2775,2286,00:02:37,157,00:15:22,489,358902
20170123-ccc_311_lobby_ph_script,2017/01/23,ccc_311_lobby_ph_script,1,1,00:00:07,7,00:00:07,0,7
20170123-ccc_aserv_info_script,2017/01/23,ccc_aserv_info_script,0,0,00:00:00,0,00:00:00,0,0
20170123-ccc_bylaw_script,2017/01/23,ccc_bylaw_script,0,0,00:00:00,0,00:00:00,0,0
20170123-ccc_city_script,2017/01/23,ccc_city_script,15,14,00:00:47,47,00:03:49,1,658
20170123-ccc_cty_online_script,2017/01/23,ccc_cty_online_script,0,0,00:00:00,0,00:00:00,0,0
20170123-ccc_feedback_script,2017/01/23,ccc_feedback_script,0,0,00:00:00,0,00:00:00,0,0
20170123-ccc_fpb_script,2017/01/23,ccc_fpb_script,0,0,00:00:00,0,00:00:00,0,0
20170123-ccc_help_script,2017/01/23,ccc_help_script,99,99,00:00:08,8,00:01:03,0,792
20170123-ccc_link_script,2017/01/23,ccc_link_script,0,0,00:00:00,0,00:00:00,0,0
20170123-ccc_media_line_script,2017/01/23,ccc_media_line_script,2,2,00:00:26,26,00:00:29,0,52
20170123-ccc_priority_script,2017/01/23,ccc_priority_script,26,26,00:00:11,11,00:00:39,0,286
20170123-ccc_tax_script,2017/01/23,ccc_tax_script,15,13,00:04:06,246,00:13:27,2,3198
20170123-ccc_waste_recycling_script,2017/01/23,ccc_waste_recycling_script,0,0,00:00:00,0,00:00:00,0,0
20170124-ccc_311_calgary_script,2017/01/24,ccc_311_calgary_script,2754,2624,00:00:42,42,00:05:38,130,110208
20170124-ccc_311_lobby_ph_script,2017/01/24,ccc_311_lobby_ph_script,2,2,00:00:05,5,00:00:07,0,10
20170124-ccc_aserv_info_script,2017/01/24,ccc_aserv_info_script,0,0,00:00:00,0,00:00:00,0,0
20170124-ccc_bylaw_script,2017/01/24,ccc_bylaw_script,0,0,00:00:00,0,00:00:00,0,0
20170124-ccc_city_script,2017/01/24,ccc_city_script,16,16,00:00:24,24,00:03:41,0,384
20170124-ccc_cty_online_script,2017/01/24,ccc_cty_online_script,0,0,00:00:00,0,00:00:00,0,0
20170124-ccc_feedback_script,2017/01/24,ccc_feedback_script,0,0,00:00:00,0,00:00:00,0,0
20170124-ccc_fpb_script,2017/01/24,ccc_fpb_script,0,0,00:00:00,0,00:00:00,0,0
20170124-ccc_help_script,2017/01/24,ccc_help_script,66,66,00:00:05,5,00:00:21,0,330
20170124-ccc_link_script,2017/01/24,ccc_link_script,0,0,00:00:00,0,00:00:00,0,0
20170124-ccc_media_line_script,2017/01/24,ccc_media_line_script,1,1,00:00:03,3,00:00:03,0,3
20170124-ccc_priority_script,2017/01/24,ccc_priority_script,18,18,00:00:09,9,00:00:39,0,162
20170124-ccc_tax_script,2017/01/24,ccc_tax_script,20,19,00:01:41,101,00:03:55,1,1919
20170124-ccc_waste_recycling_script,2017/01/24,ccc_waste_recycling_script,0,0,00:00:00,0,00:00:00,0,0
20170125-ccc_311_calgary_script,2017/01/25,ccc_311_calgary_script,3063,2799,00:01:16,76,00:10:45,264,212724
20170125-ccc_311_lobby_ph_script,2017/01/25,ccc_311_lobby_ph_script,2,2,00:00:02,2,00:00:02,0,4
20170125-ccc_aserv_info_script,2017/01/25,ccc_aserv_info_script,0,0,00:00:00,0,00:00:00,0,0
20170125-ccc_bylaw_script,2017/01/25,ccc_bylaw_script,0,0,00:00:00,0,00:00:00,0,0
20170125-ccc_city_script,2017/01/25,ccc_city_script,14,12,00:00:20,20,00:00:59,2,240
20170125-ccc_cty_online_script,2017/01/25,ccc_cty_online_script,0,0,00:00:00,0,00:00:00,0,0
20170125-ccc_feedback_script,2017/01/25,ccc_feedback_script,0,0,00:00:00,0,00:00:00,0,0
20170125-ccc_fpb_script,2017/01/25,ccc_fpb_script,1,1,00:00:06,6,00:00:06,0,6
20170125-ccc_help_script,2017/01/25,ccc_help_script,57,56,00:00:06,6,00:00:35,1,336
20170125-ccc_link_script,2017/01/25,ccc_link_script,0,0,00:00:00,0,00:00:00,0,0
20170125-ccc_media_line_script,2017/01/25,ccc_media_line_script,3,3,00:00:30,30,00:01:09,0,90
20170125-ccc_priority_script,2017/01/25,ccc_priority_script,28,28,00:00:08,8,00:00:37,0,224
20170125-ccc_tax_script,2017/01/25,ccc_tax_script,22,21,00:01:15,75,00:06:15,1,1575
20170125-ccc_waste_recycling_script,2017/01/25,ccc_waste_recycling_script,0,0,00:00:00,0,00:00:00,0,0
20170126-ccc_311_calgary_script,2017/01/26,ccc_311_calgary_script,2655,2533,00:00:29,29,00:06:12,122,73457
20170126-ccc_311_lobby_ph_script,2017/01/26,ccc_311_lobby_ph_script,2,2,00:00:11,11,00:00:14,0,22
20170126-ccc_aserv_info_script,2017/01/26,ccc_aserv_info_script,0,0,00:00:00,0,00:00:00,0,0
20170126-ccc_bylaw_script,2017/01/26,ccc_bylaw_script,0,0,00:00:00,0,00:00:00,0,0
20170126-ccc_city_script,2017/01/26,ccc_city_script,12,12,00:00:11,11,00:00:34,0,132
20170126-ccc_cty_online_script,2017/01/26,ccc_cty_online_script,0,0,00:00:00,0,00:00:00,0,0
20170126-ccc_feedback_script,2017/01/26,ccc_feedback_script,0,0,00:00:00,0,00:00:00,0,0
20170126-ccc_fpb_script,2017/01/26,ccc_fpb_script,1,0,00:00:00,0,00:00:00,1,0
20170126-ccc_help_script,2017/01/26,ccc_help_script,20,20,00:00:05,5,00:00:11,0,100
20170126-ccc_link_script,2017/01/26,ccc_link_script,0,0,00:00:00,0,00:00:00,0,0
20170126-ccc_media_line_script,2017/01/26,ccc_media_line_script,0,0,00:00:00,0,00:00:00,0,0
20170126-ccc_priority_script,2017/01/26,ccc_priority_script,33,32,00:00:07,7,00:00:44,1,224
20170126-ccc_tax_script,2017/01/26,ccc_tax_script,24,23,00:00:16,16,00:01:28,1,368
20170126-ccc_waste_recycling_script,2017/01/26,ccc_waste_recycling_script,0,0,00:00:00,0,00:00:00,0,0
20170128-ccc_311_calgary_script,2017/01/28,ccc_311_calgary_script,1171,1056,00:00:57,57,00:06:18,115,60192
20170128-ccc_311_lobby_ph_script,2017/01/28,ccc_311_lobby_ph_script,0,0,00:00:00,0,00:00:00,0,0
20170128-ccc_aserv_info_script,2017/01/28,ccc_aserv_info_script,0,0,00:00:00,0,00:00:00,0,0
20170128-ccc_bylaw_script,2017/01/28,ccc_bylaw_script,0,0,00:00:00,0,00:00:00,0,0
20170128-ccc_city_script,2017/01/28,ccc_city_script,0,0,00:00:00,0,00:00:00,0,0
20170128-ccc_cty_online_script,2017/01/28,ccc_cty_online_script,0,0,00:00:00,0,00:00:00,0,0
20170128-ccc_feedback_script,2017/01/28,ccc_feedback_script,0,0,00:00:00,0,00:00:00,0,0
20170128-ccc_fpb_script,2017/01/28,ccc_fpb_script,0,0,00:00:00,0,00:00:00,0,0
20170128-ccc_help_script,2017/01/28,ccc_help_script,8,7,00:00:19,19,00:00:51,1,133
20170128-ccc_link_script,2017/01/28,ccc_link_script,0,0,00:00:00,0,00:00:00,0,0
20170128-ccc_media_line_script,2017/01/28,ccc_media_line_script,3,3,00:00:15,15,00:00:31,0,45
20170128-ccc_priority_script,2017/01/28,ccc_priority_script,16,15,00:00:07,7,00:00:14,1,105
20170128-ccc_tax_script,2017/01/28,ccc_tax_script,1,1,00:02:09,129,00:02:09,0,129
20170128-ccc_waste_recycling_script,2017/01/28,ccc_waste_recycling_script,0,0,00:00:00,0,00:00:00,0,0
20170129-ccc_311_calgary_script,2017/01/29,ccc_311_calgary_script,958,915,00:00:26,26,00:05:20,43,23790
20170129-ccc_311_lobby_ph_script,2017/01/29,ccc_311_lobby_ph_script,0,0,00:00:00,0,00:00:00,0,0
20170129-ccc_aserv_info_script,2017/01/29,ccc_aserv_info_script,0,0,00:00:00,0,00:00:00,0,0
20170129-ccc_bylaw_script,2017/01/29,ccc_bylaw_script,0,0,00:00:00,0,00:00:00,0,0
20170129-ccc_city_script,2017/01/29,ccc_city_script,0,0,00:00:00,0,00:00:00,0,0
20170129-ccc_cty_online_script,2017/01/29,ccc_cty_online_script,0,0,00:00:00,0,00:00:00,0,0
20170129-ccc_feedback_script,2017/01/29,ccc_feedback_script,0,0,00:00:00,0,00:00:00,0,0
20170129-ccc_fpb_script,2017/01/29,ccc_fpb_script,0,0,00:00:00,0,00:00:00,0,0
20170129-ccc_help_script,2017/01/29,ccc_help_script,0,0,00:00:00,0,00:00:00,0,0
20170129-ccc_link_script,2017/01/29,ccc_link_script,0,0,00:00:00,0,00:00:00,0,0
20170129-ccc_media_line_script,2017/01/29,ccc_media_line_script,0,0,00:00:00,0,00:00:00,0,0
20170129-ccc_priority_script,2017/01/29,ccc_priority_script,14,14,00:00:08,8,00:00:34,0,112
20170129-ccc_tax_script,2017/01/29,ccc_tax_script,2,2,00:00:17,17,00:00:30,0,34
20170129-ccc_waste_recycling_script,2017/01/29,ccc_waste_recycling_script,0,0,00:00:00,0,00:00:00,0,0
20170130-ccc_311_calgary_script,2017/01/30,ccc_311_calgary_script,3019,2944,00:00:25,25,00:03:08,74,73600
20170130-ccc_311_lobby_ph_script,2017/01/30,ccc_311_lobby_ph_script,3,2,00:00:08,8,00:00:11,1,16
20170130-ccc_aserv_info_script,2017/01/30,ccc_aserv_info_script,0,0,00:00:00,0,00:00:00,0,0
20170130-ccc_bylaw_script,2017/01/30,ccc_bylaw_script,0,0,00:00:00,0,00:00:00,0,0
20170130-ccc_city_script,2017/01/30,ccc_city_script,20,20,00:00:12,12,00:00:37,0,240
20170130-ccc_cty_online_script,2017/01/30,ccc_cty_online_script,0,0,00:00:00,0,00:00:00,0,0
20170130-ccc_feedback_script,2017/01/30,ccc_feedback_script,1,0,00:00:00,0,00:00:00,0,0
20170130-ccc_fpb_script,2017/01/30,ccc_fpb_script,2,2,00:00:08,8,00:00:13,0,16
20170130-ccc_help_script,2017/01/30,ccc_help_script,25,24,00:00:07,7,00:00:21,1,168
20170130-ccc_link_script,2017/01/30,ccc_link_script,0,0,00:00:00,0,00:00:00,0,0
20170130-ccc_media_line_script,2017/01/30,ccc_media_line_script,1,1,00:00:08,8,00:00:08,0,8
20170130-ccc_priority_script,2017/01/30,ccc_priority_script,15,15,00:00:14,14,00:01:28,0,210
20170130-ccc_tax_script,2017/01/30,ccc_tax_script,24,23,00:00:19,19,00:02:01,1,437
20170130-ccc_waste_recycling_script,2017/01/30,ccc_waste_recycling_script,0,0,00:00:00,0,00:00:00,0,0
20170131-ccc_311_calgary_script,2017/01/31,ccc_311_calgary_script,2924,2688,00:01:08,68,00:06:44,236,182784
20170131-ccc_311_lobby_ph_script,2017/01/31,ccc_311_lobby_ph_script,2,2,00:00:08,8,00:00:12,0,16
20170131-ccc_aserv_info_script,2017/01/31,ccc_aserv_info_script,0,0,00:00:00,0,00:00:00,0,0
20170131-ccc_bylaw_script,2017/01/31,ccc_bylaw_script,0,0,00:00:00,0,00:00:00,0,0
20170131-ccc_city_script,2017/01/31,ccc_city_script,24,24,00:00:23,23,00:03:26,0,552
20170131-ccc_cty_online_script,2017/01/31,ccc_cty_online_script,0,0,00:00:00,0,00:00:00,0,0
20170131-ccc_feedback_script,2017/01/31,ccc_feedback_script,0,0,00:00:00,0,00:00:00,0,0
20170131-ccc_fpb_script,2017/01/31,ccc_fpb_script,0,0,00:00:00,0,00:00:00,0,0
20170131-ccc_help_script,2017/01/31,ccc_help_script,23,22,00:00:14,14,00:00:50,1,308
20170131-ccc_link_script,2017/01/31,ccc_link_script,0,0,00:00:00,0,00:00:00,0,0
20170131-ccc_media_line_script,2017/01/31,ccc_media_line_script,0,0,00:00:00,0,00:00:00,0,0
20170131-ccc_priority_script,2017/01/31,ccc_priority_script,19,19,00:00:07,7,00:00:19,0,133
20170131-ccc_tax_script,2017/01/31,ccc_tax_script,24,24,00:01:25,85,00:05:13,0,2040
20170131-ccc_waste_recycling_script,2017/01/31,ccc_waste_recycling_script,0,0,00:00:00,0,00:00:00,0,0
20170201-ccc_311_calgary_script,2017/02/01,ccc_311_calgary_script,2732,2625,00:00:34,34,00:09:39,107,89250
20170201-ccc_311_lobby_ph_script,2017/02/01,ccc_311_lobby_ph_script,2,2,00:00:06,6,00:00:08,0,12
20170201-ccc_aserv_info_script,2017/02/01,ccc_aserv_info_script,0,0,00:00:00,0,00:00:00,0,0
20170201-ccc_bylaw_script,2017/02/01,ccc_bylaw_script,0,0,00:00:00,0,00:00:00,0,0
20170201-ccc_city_script,2017/02/01,ccc_city_script,18,18,00:00:10,10,00:00:42,0,180
20170201-ccc_cty_online_script,2017/02/01,ccc_cty_online_script,0,0,00:00:00,0,00:00:00,0,0
20170201-ccc_feedback_script,2017/02/01,ccc_feedback_script,0,0,00:00:00,0,00:00:00,0,0
20170201-ccc_fpb_script,2017/02/01,ccc_fpb_script,0,0,00:00:00,0,00:00:00,0,0
20170201-ccc_help_script,2017/02/01,ccc_help_script,20,18,00:00:11,11,00:01:25,2,198
20170201-ccc_link_script,2017/02/01,ccc_link_script,0,0,00:00:00,0,00:00:00,0,0
20170201-ccc_media_line_script,2017/02/01,ccc_media_line_script,2,2,00:00:04,4,00:00:04,0,8
20170201-ccc_priority_script,2017/02/01,ccc_priority_script,28,28,00:00:07,7,00:00:32,0,196
20170201-ccc_tax_script,2017/02/01,ccc_tax_script,23,23,00:00:40,40,00:04:39,0,920
20170201-ccc_waste_recycling_script,2017/02/01,ccc_waste_recycling_script,0,0,00:00:00,0,00:00:00,0,0
20170202-ccc_311_calgary_script,2017/02/02,ccc_311_calgary_script,2649,2563,00:00:27,27,00:04:39,86,69201
20170202-ccc_311_lobby_ph_script,2017/02/02,ccc_311_lobby_ph_script,1,1,00:00:04,4,00:00:04,0,4
20170202-ccc_aserv_info_script,2017/02/02,ccc_aserv_info_script,0,0,00:00:00,0,00:00:00,0,0
20170202-ccc_bylaw_script,2017/02/02,ccc_bylaw_script,0,0,00:00:00,0,00:00:00,0,0
20170202-ccc_city_script,2017/02/02,ccc_city_script,24,24,00:00:10,10,00:00:35,0,240
20170202-ccc_cty_online_script,2017/02/02,ccc_cty_online_script,0,0,00:00:00,0,00:00:00,0,0
20170202-ccc_feedback_script,2017/02/02,ccc_feedback_script,0,0,00:00:00,0,00:00:00,0,0
20170202-ccc_fpb_script,2017/02/02,ccc_fpb_script,0,0,00:00:00,0,00:00:00,0,0
20170202-ccc_help_script,2017/02/02,ccc_help_script,15,15,00:00:09,9,00:00:26,0,135
20170202-ccc_link_script,2017/02/02,ccc_link_script,0,0,00:00:00,0,00:00:00,0,0
20170202-ccc_media_line_script,2017/02/02,ccc_media_line_script,0,0,00:00:00,0,00:00:00,0,0
20170202-ccc_priority_script,2017/02/02,ccc_priority_script,28,28,00:00:07,7,00:00:18,0,196
20170202-ccc_tax_script,2017/02/02,ccc_tax_script,29,28,00:00:29,29,00:02:56,1,812
20170202-ccc_waste_recycling_script,2017/02/02,ccc_waste_recycling_script,0,0,00:00:00,0,00:00:00,0,0
20170203-ccc_311_calgary_script,2017/02/03,ccc_311_calgary_script,2337,2308,00:00:14,14,00:03:41,29,32312
20170203-ccc_311_lobby_ph_script,2017/02/03,ccc_311_lobby_ph_script,2,2,00:00:06,6,00:00:06,0,12
20170203-ccc_aserv_info_script,2017/02/03,ccc_aserv_info_script,0,0,00:00:00,0,00:00:00,0,0
20170203-ccc_bylaw_script,2017/02/03,ccc_bylaw_script,0,0,00:00:00,0,00:00:00,0,0
20170203-ccc_city_script,2017/02/03,ccc_city_script,19,19,00:00:09,9,00:00:29,0,171
20170203-ccc_cty_online_script,2017/02/03,ccc_cty_online_script,0,0,00:00:00,0,00:00:00,0,0
20170203-ccc_feedback_script,2017/02/03,ccc_feedback_script,0,0,00:00:00,0,00:00:00,0,0
20170203-ccc_fpb_script,2017/02/03,ccc_fpb_script,0,0,00:00:00,0,00:00:00,0,0
20170203-ccc_help_script,2017/02/03,ccc_help_script,21,20,00:00:06,6,00:00:21,1,120
20170203-ccc_link_script,2017/02/03,ccc_link_script,0,0,00:00:00,0,00:00:00,0,0
20170203-ccc_media_line_script,2017/02/03,ccc_media_line_script,0,0,00:00:00,0,00:00:00,0,0
20170203-ccc_priority_script,2017/02/03,ccc_priority_script,20,20,00:00:08,8,00:00:19,0,160
20170203-ccc_tax_script,2017/02/03,ccc_tax_script,16,14,00:00:20,20,00:01:18,2,280
20170203-ccc_waste_recycling_script,2017/02/03,ccc_waste_recycling_script,0,0,00:00:00,0,00:00:00,0,0
20170204-ccc_311_calgary_script,2017/02/04,ccc_311_calgary_script,1024,1001,00:00:16,16,00:05:59,23,16016
20170204-ccc_311_lobby_ph_script,2017/02/04,ccc_311_lobby_ph_script,0,0,00:00:00,0,00:00:00,0,0
20170204-ccc_aserv_info_script,2017/02/04,ccc_aserv_info_script,0,0,00:00:00,0,00:00:00,0,0
20170204-ccc_bylaw_script,2017/02/04,ccc_bylaw_script,0,0,00:00:00,0,00:00:00,0,0
20170204-ccc_city_script,2017/02/04,ccc_city_script,0,0,00:00:00,0,00:00:00,0,0
20170204-ccc_cty_online_script,2017/02/04,ccc_cty_online_script,0,0,00:00:00,0,00:00:00,0,0
20170204-ccc_feedback_script,2017/02/04,ccc_feedback_script,0,0,00:00:00,0,00:00:00,0,0
20170204-ccc_fpb_script,2017/02/04,ccc_fpb_script,1,0,00:00:00,0,00:00:00,1,0
20170204-ccc_help_script,2017/02/04,ccc_help_script,12,12,00:00:08,8,00:00:15,0,96
20170204-ccc_link_script,2017/02/04,ccc_link_script,0,0,00:00:00,0,00:00:00,0,0
20170204-ccc_media_line_script,2017/02/04,ccc_media_line_script,2,1,00:00:04,4,00:00:04,1,4
20170204-ccc_priority_script,2017/02/04,ccc_priority_script,38,37,00:00:07,7,00:01:04,1,259
20170204-ccc_tax_script,2017/02/04,ccc_tax_script,0,0,00:00:00,0,00:00:00,0,0
20170204-ccc_waste_recycling_script,2017/02/04,ccc_waste_recycling_script,0,0,00:00:00,0,00:00:00,0,0
20170205-ccc_311_calgary_script,2017/02/05,ccc_311_calgary_script,854,829,00:00:13,13,00:05:00,25,10777
20170205-ccc_311_lobby_ph_script,2017/02/05,ccc_311_lobby_ph_script,0,0,00:00:00,0,00:00:00,0,0
20170205-ccc_aserv_info_script,2017/02/05,ccc_aserv_info_script,0,0,00:00:00,0,00:00:00,0,0
20170205-ccc_bylaw_script,2017/02/05,ccc_bylaw_script,0,0,00:00:00,0,00:00:00,0,0
20170205-ccc_city_script,2017/02/05,ccc_city_script,0,0,00:00:00,0,00:00:00,0,0
20170205-ccc_cty_online_script,2017/02/05,ccc_cty_online_script,0,0,00:00:00,0,00:00:00,0,0
20170205-ccc_feedback_script,2017/02/05,ccc_feedback_script,0,0,00:00:00,0,00:00:00,0,0
20170205-ccc_fpb_script,2017/02/05,ccc_fpb_script,0,0,00:00:00,0,00:00:00,0,0
20170205-ccc_help_script,2017/02/05,ccc_help_script,9,8,00:00:04,4,00:00:08,1,32
20170205-ccc_link_script,2017/02/05,ccc_link_script,0,0,00:00:00,0,00:00:00,0,0
20170205-ccc_media_line_script,2017/02/05,ccc_media_line_script,3,2,00:00:10,10,00:00:11,1,20
20170205-ccc_priority_script,2017/02/05,ccc_priority_script,30,30,00:00:09,9,00:01:15,0,270
20170205-ccc_tax_script,2017/02/05,ccc_tax_script,0,0,00:00:00,0,00:00:00,0,0
20170205-ccc_waste_recycling_script,2017/02/05,ccc_waste_recycling_script,0,0,00:00:00,0,00:00:00,0,0
20170206-ccc_311_calgary_script,2017/02/06,ccc_311_calgary_script,4020,3035,00:02:29,149,00:18:29,985,452215
20170206-ccc_311_lobby_ph_script,2017/02/06,ccc_311_lobby_ph_script,0,0,00:00:00,0,00:00:00,0,0
20170206-ccc_aserv_info_script,2017/02/06,ccc_aserv_info_script,0,0,00:00:00,0,00:00:00,0,0
20170206-ccc_bylaw_script,2017/02/06,ccc_bylaw_script,0,0,00:00:00,0,00:00:00,0,0
20170206-ccc_city_script,2017/02/06,ccc_city_script,12,12,00:00:41,41,00:03:08,0,492
20170206-ccc_cty_online_script,2017/02/06,ccc_cty_online_script,0,0,00:00:00,0,00:00:00,0,0
20170206-ccc_feedback_script,2017/02/06,ccc_feedback_script,0,0,00:00:00,0,00:00:00,0,0
20170206-ccc_fpb_script,2017/02/06,ccc_fpb_script,2,1,00:00:09,9,00:00:09,1,9
20170206-ccc_help_script,2017/02/06,ccc_help_script,27,20,00:00:22,22,00:01:02,7,440
20170206-ccc_link_script,2017/02/06,ccc_link_script,0,0,00:00:00,0,00:00:00,0,0
20170206-ccc_media_line_script,2017/02/06,ccc_media_line_script,3,3,00:00:38,38,00:01:38,0,114
20170206-ccc_priority_script,2017/02/06,ccc_priority_script,95,92,00:00:15,15,00:02:44,3,1380
20170206-ccc_tax_script,2017/02/06,ccc_tax_script,31,29,00:01:11,71,00:06:04,2,2059
20170206-ccc_waste_recycling_script,2017/02/06,ccc_waste_recycling_script,0,0,00:00:00,0,00:00:00,0,0
20170207-ccc_311_calgary_script,2017/02/07,ccc_311_calgary_script,3714,3091,00:02:19,139,00:14:41,623,429649
20170207-ccc_311_lobby_ph_script,2017/02/07,ccc_311_lobby_ph_script,3,3,00:00:17,17,00:00:30,0,51
20170207-ccc_aserv_info_script,2017/02/07,ccc_aserv_info_script,0,0,00:00:00,0,00:00:00,0,0
20170207-ccc_bylaw_script,2017/02/07,ccc_bylaw_script,0,0,00:00:00,0,00:00:00,0,0
20170207-ccc_city_script,2017/02/07,ccc_city_script,9,9,00:00:27,27,00:02:00,0,243
20170207-ccc_cty_online_script,2017/02/07,ccc_cty_online_script,0,0,00:00:00,0,00:00:00,0,0
20170207-ccc_feedback_script,2017/02/07,ccc_feedback_script,0,0,00:00:00,0,00:00:00,0,0
20170207-ccc_fpb_script,2017/02/07,ccc_fpb_script,0,0,00:00:00,0,00:00:00,0,0
20170207-ccc_help_script,2017/02/07,ccc_help_script,51,48,00:00:14,14,00:01:25,3,672
20170207-ccc_link_script,2017/02/07,ccc_link_script,0,0,00:00:00,0,00:00:00,0,0
20170207-ccc_media_line_script,2017/02/07,ccc_media_line_script,4,3,00:00:09,9,00:00:15,1,27
20170207-ccc_priority_script,2017/02/07,ccc_priority_script,55,54,00:00:11,11,00:00:55,1,594
20170207-ccc_tax_script,2017/02/07,ccc_tax_script,16,16,00:02:49,169,00:07:43,0,2704
20170207-ccc_waste_recycling_script,2017/02/07,ccc_waste_recycling_script,0,0,00:00:00,0,00:00:00,0,0
20170208-ccc_311_calgary_script,2017/02/08,ccc_311_calgary_script,3539,3171,00:01:22,82,00:09:20,368,260022
20170208-ccc_311_lobby_ph_script,2017/02/08,ccc_311_lobby_ph_script,4,2,00:00:07,7,00:00:10,2,14
20170208-ccc_aserv_info_script,2017/02/08,ccc_aserv_info_script,0,0,00:00:00,0,00:00:00,0,0
20170208-ccc_bylaw_script,2017/02/08,ccc_bylaw_script,0,0,00:00:00,0,00:00:00,0,0
20170208-ccc_city_script,2017/02/08,ccc_city_script,15,14,00:00:46,46,00:03:36,1,644
20170208-ccc_cty_online_script,2017/02/08,ccc_cty_online_script,0,0,00:00:00,0,00:00:00,0,0
20170208-ccc_feedback_script,2017/02/08,ccc_feedback_script,0,0,00:00:00,0,00:00:00,0,0
20170208-ccc_fpb_script,2017/02/08,ccc_fpb_script,1,0,00:00:00,0,00:00:00,1,0
20170208-ccc_help_script,2017/02/08,ccc_help_script,23,22,00:00:18,18,00:01:44,1,396
20170208-ccc_link_script,2017/02/08,ccc_link_script,0,0,00:00:00,0,00:00:00,0,0
20170208-ccc_media_line_script,2017/02/08,ccc_media_line_script,1,1,00:00:06,6,00:00:06,0,6
20170208-ccc_priority_script,2017/02/08,ccc_priority_script,53,51,00:00:10,10,00:01:08,2,510
20170208-ccc_tax_script,2017/02/08,ccc_tax_script,14,14,00:01:00,60,00:03:15,0,840
20170208-ccc_waste_recycling_script,2017/02/08,ccc_waste_recycling_script,0,0,00:00:00,0,00:00:00,0,0
20170209-ccc_311_calgary_script,2017/02/09,ccc_311_calgary_script,3181,2940,00:00:55,55,00:08:24,241,161700
20170209-ccc_311_lobby_ph_script,2017/02/09,ccc_311_lobby_ph_script,5,4,00:00:10,10,00:00:23,1,40
20170209-ccc_aserv_info_script,2017/02/09,ccc_aserv_info_script,0,0,00:00:00,0,00:00:00,0,0
20170209-ccc_bylaw_script,2017/02/09,ccc_bylaw_script,0,0,00:00:00,0,00:00:00,0,0
20170209-ccc_city_script,2017/02/09,ccc_city_script,13,13,00:00:11,11,00:00:27,0,143
20170209-ccc_cty_online_script,2017/02/09,ccc_cty_online_script,0,0,00:00:00,0,00:00:00,0,0
20170209-ccc_feedback_script,2017/02/09,ccc_feedback_script,0,0,00:00:00,0,00:00:00,0,0
20170209-ccc_fpb_script,2017/02/09,ccc_fpb_script,0,0,00:00:00,0,00:00:00,0,0
20170209-ccc_help_script,2017/02/09,ccc_help_script,26,23,00:00:14,14,00:00:48,3,322
20170209-ccc_link_script,2017/02/09,ccc_link_script,0,0,00:00:00,0,00:00:00,0,0
20170209-ccc_media_line_script,2017/02/09,ccc_media_line_script,1,0,00:00:00,0,00:00:00,1,0
20170209-ccc_priority_script,2017/02/09,ccc_priority_script,36,36,00:00:14,14,00:01:15,0,504
20170209-ccc_tax_script,2017/02/09,ccc_tax_script,20,20,00:00:49,49,00:03:25,0,980
20170209-ccc_waste_recycling_script,2017/02/09,ccc_waste_recycling_script,0,0,00:00:00,0,00:00:00,0,0
20170210-ccc_311_calgary_script,2017/02/10,ccc_311_calgary_script,2540,2505,00:00:14,14,00:07:15,35,35070
20170210-ccc_311_lobby_ph_script,2017/02/10,ccc_311_lobby_ph_script,2,2,00:00:02,2,00:00:02,0,4
20170210-ccc_aserv_info_script,2017/02/10,ccc_aserv_info_script,0,0,00:00:00,0,00:00:00,0,0
20170210-ccc_bylaw_script,2017/02/10,ccc_bylaw_script,0,0,00:00:00,0,00:00:00,0,0
20170210-ccc_city_script,2017/02/10,ccc_city_script,13,12,00:00:08,8,00:00:17,1,96
20170210-ccc_cty_online_script,2017/02/10,ccc_cty_online_script,0,0,00:00:00,0,00:00:00,0,0
20170210-ccc_feedback_script,2017/02/10,ccc_feedback_script,0,0,00:00:00,0,00:00:00,0,0
20170210-ccc_fpb_script,2017/02/10,ccc_fpb_script,0,0,00:00:00,0,00:00:00,0,0
20170210-ccc_help_script,2017/02/10,ccc_help_script,7,7,00:00:11,11,00:00:39,0,77
20170210-ccc_link_script,2017/02/10,ccc_link_script,0,0,00:00:00,0,00:00:00,0,0
20170210-ccc_media_line_script,2017/02/10,ccc_media_line_script,1,1,00:00:04,4,00:00:04,0,4
20170210-ccc_priority_script,2017/02/10,ccc_priority_script,23,23,00:00:07,7,00:00:19,0,161
20170210-ccc_tax_script,2017/02/10,ccc_tax_script,13,13,00:00:07,7,00:00:23,0,91
20170210-ccc_waste_recycling_script,2017/02/10,ccc_waste_recycling_script,0,0,00:00:00,0,00:00:00,0,0
20170211-ccc_311_calgary_script,2017/02/11,ccc_311_calgary_script,1150,1121,00:00:19,19,00:03:20,29,21299
20170211-ccc_311_lobby_ph_script,2017/02/11,ccc_311_lobby_ph_script,0,0,00:00:00,0,00:00:00,0,0
20170211-ccc_aserv_info_script,2017/02/11,ccc_aserv_info_script,0,0,00:00:00,0,00:00:00,0,0
20170211-ccc_bylaw_script,2017/02/11,ccc_bylaw_script,0,0,00:00:00,0,00:00:00,0,0
20170211-ccc_city_script,2017/02/11,ccc_city_script,0,0,00:00:00,0,00:00:00,0,0
20170211-ccc_cty_online_script,2017/02/11,ccc_cty_online_script,0,0,00:00:00,0,00:00:00,0,0
20170211-ccc_feedback_script,2017/02/11,ccc_feedback_script,0,0,00:00:00,0,00:00:00,0,0
20170211-ccc_fpb_script,2017/02/11,ccc_fpb_script,0,0,00:00:00,0,00:00:00,0,0
20170211-ccc_help_script,2017/02/11,ccc_help_script,8,7,00:00:18,18,00:00:38,1,126
20170211-ccc_link_script,2017/02/11,ccc_link_script,0,0,00:00:00,0,00:00:00,0,0
20170211-ccc_media_line_script,2017/02/11,ccc_media_line_script,1,1,00:00:02,2,00:00:02,0,2
20170211-ccc_priority_script,2017/02/11,ccc_priority_script,34,32,00:00:10,10,00:01:08,2,320
20170211-ccc_tax_script,2017/02/11,ccc_tax_script,0,0,00:00:00,0,00:00:00,0,0
20170211-ccc_waste_recycling_script,2017/02/11,ccc_waste_recycling_script,0,0,00:00:00,0,00:00:00,0,0
20170212-ccc_311_calgary_script,2017/02/12,ccc_311_calgary_script,925,911,00:00:15,15,00:04:27,14,13665
20170212-ccc_311_lobby_ph_script,2017/02/12,ccc_311_lobby_ph_script,0,0,00:00:00,0,00:00:00,0,0
20170212-ccc_aserv_info_script,2017/02/12,ccc_aserv_info_script,0,0,00:00:00,0,00:00:00,0,0
20170212-ccc_bylaw_script,2017/02/12,ccc_bylaw_script,0,0,00:00:00,0,00:00:00,0,0
20170212-ccc_city_script,2017/02/12,ccc_city_script,0,0,00:00:00,0,00:00:00,0,0
20170212-ccc_cty_online_script,2017/02/12,ccc_cty_online_script,0,0,00:00:00,0,00:00:00,0,0
20170212-ccc_feedback_script,2017/02/12,ccc_feedback_script,0,0,00:00:00,0,00:00:00,0,0
20170212-ccc_fpb_script,2017/02/12,ccc_fpb_script,0,0,00:00:00,0,00:00:00,0,0
20170212-ccc_help_script,2017/02/12,ccc_help_script,12,12,00:00:12,12,00:00:55,0,144
20170212-ccc_link_script,2017/02/12,ccc_link_script,0,0,00:00:00,0,00:00:00,0,0
20170212-ccc_media_line_script,2017/02/12,ccc_media_line_script,3,3,00:00:08,8,00:00:15,0,24
20170212-ccc_priority_script,2017/02/12,ccc_priority_script,28,27,00:00:09,9,00:00:36,1,243
20170212-ccc_tax_script,2017/02/12,ccc_tax_script,0,0,00:00:00,0,00:00:00,0,0
20170212-ccc_waste_recycling_script,2017/02/12,ccc_waste_recycling_script,0,0,00:00:00,0,00:00:00,0,0
20170213-ccc_311_calgary_script,2017/02/13,ccc_311_calgary_script,3135,2814,00:01:41,101,00:10:34,321,284214
20170213-ccc_311_lobby_ph_script,2017/02/13,ccc_311_lobby_ph_script,1,1,00:00:11,11,00:00:11,0,11
20170213-ccc_aserv_info_script,2017/02/13,ccc_aserv_info_script,0,0,00:00:00,0,00:00:00,0,0
20170213-ccc_bylaw_script,2017/02/13,ccc_bylaw_script,0,0,00:00:00,0,00:00:00,0,0
20170213-ccc_city_script,2017/02/13,ccc_city_script,30,30,00:00:32,32,00:04:16,0,960
20170213-ccc_cty_online_script,2017/02/13,ccc_cty_online_script,0,0,00:00:00,0,00:00:00,0,0
20170213-ccc_feedback_script,2017/02/13,ccc_feedback_script,0,0,00:00:00,0,00:00:00,0,0
20170213-ccc_fpb_script,2017/02/13,ccc_fpb_script,2,1,00:03:16,196,00:03:16,1,196
20170213-ccc_help_script,2017/02/13,ccc_help_script,21,19,00:00:15,15,00:01:14,2,285
20170213-ccc_link_script,2017/02/13,ccc_link_script,0,0,00:00:00,0,00:00:00,0,0
20170213-ccc_media_line_script,2017/02/13,ccc_media_line_script,1,1,00:00:25,25,00:00:25,0,25
20170213-ccc_priority_script,2017/02/13,ccc_priority_script,37,36,00:00:09,9,00:00:46,1,324
20170213-ccc_tax_script,2017/02/13,ccc_tax_script,20,15,00:01:32,92,00:05:48,5,1380
20170213-ccc_waste_recycling_script,2017/02/13,ccc_waste_recycling_script,0,0,00:00:00,0,00:00:00,0,0
20170214-ccc_311_calgary_script,2017/02/14,ccc_311_calgary_script,2797,2606,00:00:52,52,00:12:16,191,135512
20170214-ccc_311_lobby_ph_script,2017/02/14,ccc_311_lobby_ph_script,0,0,00:00:00,0,00:00:00,0,0
20170214-ccc_aserv_info_script,2017/02/14,ccc_aserv_info_script,0,0,00:00:00,0,00:00:00,0,0
20170214-ccc_bylaw_script,2017/02/14,ccc_bylaw_script,0,0,00:00:00,0,00:00:00,0,0
20170214-ccc_city_script,2017/02/14,ccc_city_script,21,21,00:00:14,14,00:00:59,0,294
20170214-ccc_cty_online_script,2017/02/14,ccc_cty_online_script,0,0,00:00:00,0,00:00:00,0,0
20170214-ccc_feedback_script,2017/02/14,ccc_feedback_script,0,0,00:00:00,0,00:00:00,0,0
20170214-ccc_fpb_script,2017/02/14,ccc_fpb_script,0,0,00:00:00,0,00:00:00,0,0
20170214-ccc_help_script,2017/02/14,ccc_help_script,25,22,00:00:11,11,00:00:42,3,242
20170214-ccc_link_script,2017/02/14,ccc_link_script,0,0,00:00:00,0,00:00:00,0,0
20170214-ccc_media_line_script,2017/02/14,ccc_media_line_script,4,3,00:00:11,11,00:00:14,1,33
20170214-ccc_priority_script,2017/02/14,ccc_priority_script,32,31,00:00:12,12,00:01:08,1,372
20170214-ccc_tax_script,2017/02/14,ccc_tax_script,25,23,00:00:40,40,00:03:09,2,920
20170214-ccc_waste_recycling_script,2017/02/14,ccc_waste_recycling_script,0,0,00:00:00,0,00:00:00,0,0
20170215-ccc_311_calgary_script,2017/02/15,ccc_311_calgary_script,3169,2778,00:02:01,121,00:11:45,391,336138
20170215-ccc_311_lobby_ph_script,2017/02/15,ccc_311_lobby_ph_script,1,1,00:00:35,35,00:00:35,0,35
20170215-ccc_aserv_info_script,2017/02/15,ccc_aserv_info_script,0,0,00:00:00,0,00:00:00,0,0
20170215-ccc_bylaw_script,2017/02/15,ccc_bylaw_script,0,0,00:00:00,0,00:00:00,0,0
20170215-ccc_city_script,2017/02/15,ccc_city_script,18,16,00:00:37,37,00:03:34,2,592
20170215-ccc_cty_online_script,2017/02/15,ccc_cty_online_script,0,0,00:00:00,0,00:00:00,0,0
20170215-ccc_feedback_script,2017/02/15,ccc_feedback_script,0,0,00:00:00,0,00:00:00,0,0
20170215-ccc_fpb_script,2017/02/15,ccc_fpb_script,0,0,00:00:00,0,00:00:00,0,0
20170215-ccc_help_script,2017/02/15,ccc_help_script,21,19,00:00:18,18,00:00:51,2,342
20170215-ccc_link_script,2017/02/15,ccc_link_script,0,0,00:00:00,0,00:00:00,0,0
20170215-ccc_media_line_script,2017/02/15,ccc_media_line_script,1,1,00:00:04,4,00:00:04,0,4
20170215-ccc_priority_script,2017/02/15,ccc_priority_script,32,31,00:00:13,13,00:01:03,1,403
20170215-ccc_tax_script,2017/02/15,ccc_tax_script,25,19,00:02:06,126,00:06:28,6,2394
20170215-ccc_waste_recycling_script,2017/02/15,ccc_waste_recycling_script,0,0,00:00:00,0,00:00:00,0,0
20170216-ccc_311_calgary_script,2017/02/16,ccc_311_calgary_script,2834,2653,00:00:48,48,00:09:29,181,127344
20170216-ccc_311_lobby_ph_script,2017/02/16,ccc_311_lobby_ph_script,0,0,00:00:00,0,00:00:00,0,0
20170216-ccc_aserv_info_script,2017/02/16,ccc_aserv_info_script,0,0,00:00:00,0,00:00:00,0,0
20170216-ccc_bylaw_script,2017/02/16,ccc_bylaw_script,0,0,00:00:00,0,00:00:00,0,0
20170216-ccc_city_script,2017/02/16,ccc_city_script,18,17,00:00:31,31,00:04:41,1,527
20170216-ccc_cty_online_script,2017/02/16,ccc_cty_online_script,0,0,00:00:00,0,00:00:00,0,0
20170216-ccc_feedback_script,2017/02/16,ccc_feedback_script,0,0,00:00:00,0,00:00:00,0,0
20170216-ccc_fpb_script,2017/02/16,ccc_fpb_script,3,1,00:00:15,15,00:00:15,2,15
20170216-ccc_help_script,2017/02/16,ccc_help_script,30,27,00:00:10,10,00:00:46,3,270
20170216-ccc_link_script,2017/02/16,ccc_link_script,0,0,00:00:00,0,00:00:00,0,0
20170216-ccc_media_line_script,2017/02/16,ccc_media_line_script,0,0,00:00:00,0,00:00:00,0,0
20170216-ccc_priority_script,2017/02/16,ccc_priority_script,27,24,00:00:10,10,00:00:41,3,240
20170216-ccc_tax_script,2017/02/16,ccc_tax_script,25,24,00:01:02,62,00:08:09,1,1488
20170216-ccc_waste_recycling_script,2017/02/16,ccc_waste_recycling_script,0,0,00:00:00,0,00:00:00,0,0
20170217-ccc_311_calgary_script,2017/02/17,ccc_311_calgary_script,2886,2802,00:00:21,21,00:04:29,84,58842
20170217-ccc_311_lobby_ph_script,2017/02/17,ccc_311_lobby_ph_script,0,0,00:00:00,0,00:00:00,0,0
20170217-ccc_aserv_info_script,2017/02/17,ccc_aserv_info_script,0,0,00:00:00,0,00:00:00,0,0
20170217-ccc_bylaw_script,2017/02/17,ccc_bylaw_script,0,0,00:00:00,0,00:00:00,0,0
20170217-ccc_city_script,2017/02/17,ccc_city_script,24,24,00:00:09,9,00:00:46,0,216
20170217-ccc_cty_online_script,2017/02/17,ccc_cty_online_script,0,0,00:00:00,0,00:00:00,0,0
20170217-ccc_feedback_script,2017/02/17,ccc_feedback_script,0,0,00:00:00,0,00:00:00,0,0
20170217-ccc_fpb_script,2017/02/17,ccc_fpb_script,0,0,00:00:00,0,00:00:00,0,0
20170217-ccc_help_script,2017/02/17,ccc_help_script,12,11,00:00:13,13,00:00:58,1,143
20170217-ccc_link_script,2017/02/17,ccc_link_script,0,0,00:00:00,0,00:00:00,0,0
20170217-ccc_media_line_script,2017/02/17,ccc_media_line_script,0,0,00:00:00,0,00:00:00,0,0
20170217-ccc_priority_script,2017/02/17,ccc_priority_script,47,47,00:00:12,12,00:02:09,0,564
20170217-ccc_tax_script,2017/02/17,ccc_tax_script,18,18,00:00:21,21,00:01:10,0,378
20170217-ccc_waste_recycling_script,2017/02/17,ccc_waste_recycling_script,0,0,00:00:00,0,00:00:00,0,0
20170218-ccc_311_calgary_script,2017/02/18,ccc_311_calgary_script,1259,1195,00:00:32,32,00:05:34,64,38240
20170218-ccc_311_lobby_ph_script,2017/02/18,ccc_311_lobby_ph_script,0,0,00:00:00,0,00:00:00,0,0
20170218-ccc_aserv_info_script,2017/02/18,ccc_aserv_info_script,0,0,00:00:00,0,00:00:00,0,0
20170218-ccc_bylaw_script,2017/02/18,ccc_bylaw_script,0,0,00:00:00,0,00:00:00,0,0
20170218-ccc_city_script,2017/02/18,ccc_city_script,0,0,00:00:00,0,00:00:00,0,0
20170218-ccc_cty_online_script,2017/02/18,ccc_cty_online_script,0,0,00:00:00,0,00:00:00,0,0
20170218-ccc_feedback_script,2017/02/18,ccc_feedback_script,0,0,00:00:00,0,00:00:00,0,0
20170218-ccc_fpb_script,2017/02/18,ccc_fpb_script,0,0,00:00:00,0,00:00:00,0,0
20170218-ccc_help_script,2017/02/18,ccc_help_script,10,9,00:00:14,14,00:00:39,1,126
20170218-ccc_link_script,2017/02/18,ccc_link_script,0,0,00:00:00,0,00:00:00,0,0
20170218-ccc_media_line_script,2017/02/18,ccc_media_line_script,2,2,00:00:04,4,00:00:05,0,8
20170218-ccc_priority_script,2017/02/18,ccc_priority_script,30,30,00:00:11,11,00:01:05,0,330
20170218-ccc_tax_script,2017/02/18,ccc_tax_script,0,0,00:00:00,0,00:00:00,0,0
20170218-ccc_waste_recycling_script,2017/02/18,ccc_waste_recycling_script,0,0,00:00:00,0,00:00:00,0,0
20170219-ccc_311_calgary_script,2017/02/19,ccc_311_calgary_script,854,840,00:00:10,10,00:05:58,14,8400
20170219-ccc_311_lobby_ph_script,2017/02/19,ccc_311_lobby_ph_script,0,0,00:00:00,0,00:00:00,0,0
20170219-ccc_aserv_info_script,2017/02/19,ccc_aserv_info_script,0,0,00:00:00,0,00:00:00,0,0
20170219-ccc_bylaw_script,2017/02/19,ccc_bylaw_script,0,0,00:00:00,0,00:00:00,0,0
20170219-ccc_city_script,2017/02/19,ccc_city_script,0,0,00:00:00,0,00:00:00,0,0
20170219-ccc_cty_online_script,2017/02/19,ccc_cty_online_script,0,0,00:00:00,0,00:00:00,0,0
20170219-ccc_feedback_script,2017/02/19,ccc_feedback_script,0,0,00:00:00,0,00:00:00,0,0
20170219-ccc_fpb_script,2017/02/19,ccc_fpb_script,0,0,00:00:00,0,00:00:00,0,0
20170219-ccc_help_script,2017/02/19,ccc_help_script,11,11,00:00:08,8,00:00:16,0,88
20170219-ccc_link_script,2017/02/19,ccc_link_script,0,0,00:00:00,0,00:00:00,0,0
20170219-ccc_media_line_script,2017/02/19,ccc_media_line_script,1,1,00:00:45,45,00:00:45,0,45
20170219-ccc_priority_script,2017/02/19,ccc_priority_script,22,22,00:00:08,8,00:00:35,0,176
20170219-ccc_tax_script,2017/02/19,ccc_tax_script,0,0,00:00:00,0,00:00:00,0,0
20170219-ccc_waste_recycling_script,2017/02/19,ccc_waste_recycling_script,0,0,00:00:00,0,00:00:00,0,0
20170220-ccc_311_calgary_script,2017/02/20,ccc_311_calgary_script,1448,1428,00:00:10,10,00:04:57,20,14280
20170220-ccc_311_lobby_ph_script,2017/02/20,ccc_311_lobby_ph_script,0,0,00:00:00,0,00:00:00,0,0
20170220-ccc_aserv_info_script,2017/02/20,ccc_aserv_info_script,0,0,00:00:00,0,00:00:00,0,0
20170220-ccc_bylaw_script,2017/02/20,ccc_bylaw_script,0,0,00:00:00,0,00:00:00,0,0
20170220-ccc_city_script,2017/02/20,ccc_city_script,0,0,00:00:00,0,00:00:00,0,0
20170220-ccc_cty_online_script,2017/02/20,ccc_cty_online_script,0,0,00:00:00,0,00:00:00,0,0
20170220-ccc_feedback_script,2017/02/20,ccc_feedback_script,0,0,00:00:00,0,00:00:00,0,0
20170220-ccc_fpb_script,2017/02/20,ccc_fpb_script,0,0,00:00:00,0,00:00:00,0,0
20170220-ccc_help_script,2017/02/20,ccc_help_script,1,1,00:00:02,2,00:00:02,0,2
20170220-ccc_link_script,2017/02/20,ccc_link_script,0,0,00:00:00,0,00:00:00,0,0
20170220-ccc_media_line_script,2017/02/20,ccc_media_line_script,0,0,00:00:00,0,00:00:00,0,0
20170220-ccc_priority_script,2017/02/20,ccc_priority_script,21,20,00:00:05,5,00:00:09,1,100
20170220-ccc_tax_script,2017/02/20,ccc_tax_script,1,1,00:00:03,3,00:00:03,0,3
20170220-ccc_waste_recycling_script,2017/02/20,ccc_waste_recycling_script,0,0,00:00:00,0,00:00:00,0,0
20170221-ccc_311_calgary_script,2017/02/21,ccc_311_calgary_script,3198,3059,00:00:15,15,00:05:16,77,45885
20170221-ccc_311_lobby_ph_script,2017/02/21,ccc_311_lobby_ph_script,5,5,00:00:07,7,00:00:08,0,35
20170221-ccc_aserv_info_script,2017/02/21,ccc_aserv_info_script,0,0,00:00:00,0,00:00:00,0,0
20170221-ccc_bylaw_script,2017/02/21,ccc_bylaw_script,0,0,00:00:00,0,00:00:00,0,0
20170221-ccc_city_script,2017/02/21,ccc_city_script,12,12,00:00:06,6,00:00:13,0,72
20170221-ccc_cty_online_script,2017/02/21,ccc_cty_online_script,0,0,00:00:00,0,00:00:00,0,0
20170221-ccc_feedback_script,2017/02/21,ccc_feedback_script,0,0,00:00:00,0,00:00:00,0,0
20170221-ccc_fpb_script,2017/02/21,ccc_fpb_script,2,2,00:00:10,10,00:00:10,0,20
20170221-ccc_help_script,2017/02/21,ccc_help_script,9,9,00:00:06,6,00:00:16,0,54
20170221-ccc_link_script,2017/02/21,ccc_link_script,0,0,00:00:00,0,00:00:00,0,0
20170221-ccc_media_line_script,2017/02/21,ccc_media_line_script,0,0,00:00:00,0,00:00:00,0,0
20170221-ccc_priority_script,2017/02/21,ccc_priority_script,31,31,00:00:08,8,00:01:01,0,248
20170221-ccc_tax_script,2017/02/21,ccc_tax_script,19,18,00:00:15,15,00:00:45,1,270
20170221-ccc_waste_recycling_script,2017/02/21,ccc_waste_recycling_script,0,0,00:00:00,0,00:00:00,0,0
20170222-ccc_311_calgary_script,2017/02/22,ccc_311_calgary_script,2730,2625,00:00:36,36,00:05:53,105,94500
20170222-ccc_311_lobby_ph_script,2017/02/22,ccc_311_lobby_ph_script,6,5,00:00:07,7,00:00:15,1,35
20170222-ccc_aserv_info_script,2017/02/22,ccc_aserv_info_script,0,0,00:00:00,0,00:00:00,0,0
20170222-ccc_bylaw_script,2017/02/22,ccc_bylaw_script,0,0,00:00:00,0,00:00:00,0,0
20170222-ccc_city_script,2017/02/22,ccc_city_script,13,13,00:00:15,15,00:00:43,0,195
20170222-ccc_cty_online_script,2017/02/22,ccc_cty_online_script,0,0,00:00:00,0,00:00:00,0,0
20170222-ccc_feedback_script,2017/02/22,ccc_feedback_script,0,0,00:00:00,0,00:00:00,0,0
20170222-ccc_fpb_script,2017/02/22,ccc_fpb_script,0,0,00:00:00,0,00:00:00,0,0
20170222-ccc_help_script,2017/02/22,ccc_help_script,10,9,00:00:07,7,00:00:13,1,63
20170222-ccc_link_script,2017/02/22,ccc_link_script,0,0,00:00:00,0,00:00:00,0,0
20170222-ccc_media_line_script,2017/02/22,ccc_media_line_script,0,0,00:00:00,0,00:00:00,0,0
20170222-ccc_priority_script,2017/02/22,ccc_priority_script,21,21,00:00:07,7,00:00:34,0,147
20170222-ccc_tax_script,2017/02/22,ccc_tax_script,23,23,00:00:58,58,00:04:28,0,1334
20170222-ccc_waste_recycling_script,2017/02/22,ccc_waste_recycling_script,0,0,00:00:00,0,00:00:00,0,0
20170223-ccc_311_calgary_script,2017/02/23,ccc_311_calgary_script,2563,2475,00:00:28,28,00:03:48,88,69300
20170223-ccc_311_lobby_ph_script,2017/02/23,ccc_311_lobby_ph_script,4,4,00:00:16,16,00:00:25,0,64
20170223-ccc_aserv_info_script,2017/02/23,ccc_aserv_info_script,0,0,00:00:00,0,00:00:00,0,0
20170223-ccc_bylaw_script,2017/02/23,ccc_bylaw_script,0,0,00:00:00,0,00:00:00,0,0
20170223-ccc_city_script,2017/02/23,ccc_city_script,10,10,00:00:10,10,00:00:15,0,100
20170223-ccc_cty_online_script,2017/02/23,ccc_cty_online_script,0,0,00:00:00,0,00:00:00,0,0
20170223-ccc_feedback_script,2017/02/23,ccc_feedback_script,0,0,00:00:00,0,00:00:00,0,0
20170223-ccc_fpb_script,2017/02/23,ccc_fpb_script,0,0,00:00:00,0,00:00:00,0,0
20170223-ccc_help_script,2017/02/23,ccc_help_script,3,3,00:00:03,3,00:00:06,0,9
20170223-ccc_link_script,2017/02/23,ccc_link_script,0,0,00:00:00,0,00:00:00,0,0
20170223-ccc_media_line_script,2017/02/23,ccc_media_line_script,1,1,00:00:10,10,00:00:10,0,10
20170223-ccc_priority_script,2017/02/23,ccc_priority_script,24,24,00:00:08,8,00:00:25,0,192
20170223-ccc_tax_script,2017/02/23,ccc_tax_script,32,32,00:00:22,22,00:02:25,0,704
20170223-ccc_waste_recycling_script,2017/02/23,ccc_waste_recycling_script,0,0,00:00:00,0,00:00:00,0,0
20170224-ccc_311_calgary_script,2017/02/24,ccc_311_calgary_script,2379,2217,00:00:43,43,00:09:59,162,95331
20170224-ccc_311_lobby_ph_script,2017/02/24,ccc_311_lobby_ph_script,0,0,00:00:00,0,00:00:00,0,0
20170224-ccc_aserv_info_script,2017/02/24,ccc_aserv_info_script,0,0,00:00:00,0,00:00:00,0,0
20170224-ccc_bylaw_script,2017/02/24,ccc_bylaw_script,0,0,00:00:00,0,00:00:00,0,0
20170224-ccc_city_script,2017/02/24,ccc_city_script,9,9,00:00:12,12,00:00:27,0,108
20170224-ccc_cty_online_script,2017/02/24,ccc_cty_online_script,0,0,00:00:00,0,00:00:00,0,0
20170224-ccc_feedback_script,2017/02/24,ccc_feedback_script,0,0,00:00:00,0,00:00:00,0,0
20170224-ccc_fpb_script,2017/02/24,ccc_fpb_script,2,1,00:01:07,67,00:01:07,1,67
20170224-ccc_help_script,2017/02/24,ccc_help_script,22,20,00:00:19,19,00:02:38,2,380
20170224-ccc_link_script,2017/02/24,ccc_link_script,1,0,00:00:00,0,00:00:00,0,0
20170224-ccc_media_line_script,2017/02/24,ccc_media_line_script,1,1,00:00:05,5,00:00:05,0,5
20170224-ccc_priority_script,2017/02/24,ccc_priority_script,29,28,00:00:11,11,00:00:49,1,308
20170224-ccc_tax_script,2017/02/24,ccc_tax_script,25,23,00:01:10,70,00:06:32,2,1610
20170224-ccc_waste_recycling_script,2017/02/24,ccc_waste_recycling_script,0,0,00:00:00,0,00:00:00,0,0
20170225-ccc_311_calgary_script,2017/02/25,ccc_311_calgary_script,956,895,00:00:53,53,00:12:26,61,47435
20170225-ccc_311_lobby_ph_script,2017/02/25,ccc_311_lobby_ph_script,0,0,00:00:00,0,00:00:00,0,0
20170225-ccc_aserv_info_script,2017/02/25,ccc_aserv_info_script,0,0,00:00:00,0,00:00:00,0,0
20170225-ccc_bylaw_script,2017/02/25,ccc_bylaw_script,0,0,00:00:00,0,00:00:00,0,0
20170225-ccc_city_script,2017/02/25,ccc_city_script,0,0,00:00:00,0,00:00:00,0,0
20170225-ccc_cty_online_script,2017/02/25,ccc_cty_online_script,0,0,00:00:00,0,00:00:00,0,0
20170225-ccc_feedback_script,2017/02/25,ccc_feedback_script,0,0,00:00:00,0,00:00:00,0,0
20170225-ccc_fpb_script,2017/02/25,ccc_fpb_script,0,0,00:00:00,0,00:00:00,0,0
20170225-ccc_help_script,2017/02/25,ccc_help_script,13,11,00:00:13,13,00:01:13,0,143
20170225-ccc_link_script,2017/02/25,ccc_link_script,0,0,00:00:00,0,00:00:00,0,0
20170225-ccc_media_line_script,2017/02/25,ccc_media_line_script,1,0,00:00:00,0,00:00:00,1,0
20170225-ccc_priority_script,2017/02/25,ccc_priority_script,23,23,00:00:13,13,00:00:53,0,299
20170225-ccc_tax_script,2017/02/25,ccc_tax_script,0,0,00:00:00,0,00:00:00,0,0
20170225-ccc_waste_recycling_script,2017/02/25,ccc_waste_recycling_script,0,0,00:00:00,0,00:00:00,0,0
20170226-ccc_311_calgary_script,2017/02/26,ccc_311_calgary_script,680,658,00:00:17,17,00:03:52,20,11186
20170226-ccc_311_lobby_ph_script,2017/02/26,ccc_311_lobby_ph_script,0,0,00:00:00,0,00:00:00,0,0
20170226-ccc_aserv_info_script,2017/02/26,ccc_aserv_info_script,0,0,00:00:00,0,00:00:00,0,0
20170226-ccc_bylaw_script,2017/02/26,ccc_bylaw_script,0,0,00:00:00,0,00:00:00,0,0
20170226-ccc_city_script,2017/02/26,ccc_city_script,0,0,00:00:00,0,00:00:00,0,0
20170226-ccc_cty_online_script,2017/02/26,ccc_cty_online_script,0,0,00:00:00,0,00:00:00,0,0
20170226-ccc_feedback_script,2017/02/26,ccc_feedback_script,0,0,00:00:00,0,00:00:00,0,0
20170226-ccc_fpb_script,2017/02/26,ccc_fpb_script,0,0,00:00:00,0,00:00:00,0,0
20170226-ccc_help_script,2017/02/26,ccc_help_script,3,3,00:00:04,4,00:00:05,0,12
20170226-ccc_link_script,2017/02/26,ccc_link_script,0,0,00:00:00,0,00:00:00,0,0
20170226-ccc_media_line_script,2017/02/26,ccc_media_line_script,1,1,00:00:12,12,00:00:12,0,12
20170226-ccc_priority_script,2017/02/26,ccc_priority_script,9,9,00:00:07,7,00:00:10,0,63
20170226-ccc_tax_script,2017/02/26,ccc_tax_script,0,0,00:00:00,0,00:00:00,0,0
20170226-ccc_waste_recycling_script,2017/02/26,ccc_waste_recycling_script,0,0,00:00:00,0,00:00:00,0,0
20170227-ccc_311_calgary_script,2017/02/27,ccc_311_calgary_script,2745,2608,00:00:41,41,00:06:30,137,106928
20170227-ccc_311_lobby_ph_script,2017/02/27,ccc_311_lobby_ph_script,1,0,00:00:00,0,00:00:00,1,0
20170227-ccc_aserv_info_script,2017/02/27,ccc_aserv_info_script,0,0,00:00:00,0,00:00:00,0,0
20170227-ccc_bylaw_script,2017/02/27,ccc_bylaw_script,0,0,00:00:00,0,00:00:00,0,0
20170227-ccc_city_script,2017/02/27,ccc_city_script,24,23,00:00:21,21,00:01:26,1,483
20170227-ccc_cty_online_script,2017/02/27,ccc_cty_online_script,0,0,00:00:00,0,00:00:00,0,0
20170227-ccc_feedback_script,2017/02/27,ccc_feedback_script,1,0,00:00:00,0,00:00:00,0,0
20170227-ccc_fpb_script,2017/02/27,ccc_fpb_script,2,1,00:00:03,3,00:00:03,1,3
20170227-ccc_help_script,2017/02/27,ccc_help_script,10,7,00:00:04,4,00:00:05,3,28
20170227-ccc_link_script,2017/02/27,ccc_link_script,0,0,00:00:00,0,00:00:00,0,0
20170227-ccc_media_line_script,2017/02/27,ccc_media_line_script,0,0,00:00:00,0,00:00:00,0,0
20170227-ccc_priority_script,2017/02/27,ccc_priority_script,27,26,00:00:12,12,00:00:55,1,312
20170227-ccc_tax_script,2017/02/27,ccc_tax_script,16,16,00:00:32,32,00:03:02,0,512
20170227-ccc_waste_recycling_script,2017/02/27,ccc_waste_recycling_script,0,0,00:00:00,0,00:00:00,0,0
20170228-ccc_311_calgary_script,2017/02/28,ccc_311_calgary_script,2493,2366,00:00:44,44,00:06:14,127,104104
20170228-ccc_311_lobby_ph_script,2017/02/28,ccc_311_lobby_ph_script,1,1,00:00:15,15,00:00:15,0,15
20170228-ccc_aserv_info_script,2017/02/28,ccc_aserv_info_script,0,0,00:00:00,0,00:00:00,0,0
20170228-ccc_bylaw_script,2017/02/28,ccc_bylaw_script,0,0,00:00:00,0,00:00:00,0,0
20170228-ccc_city_script,2017/02/28,ccc_city_script,34,34,00:00:23,23,00:02:53,0,782
20170228-ccc_cty_online_script,2017/02/28,ccc_cty_online_script,0,0,00:00:00,0,00:00:00,0,0
20170228-ccc_feedback_script,2017/02/28,ccc_feedback_script,0,0,00:00:00,0,00:00:00,0,0
20170228-ccc_fpb_script,2017/02/28,ccc_fpb_script,1,1,00:00:04,4,00:00:04,0,4
20170228-ccc_help_script,2017/02/28,ccc_help_script,11,9,00:00:10,10,00:00:17,2,90
20170228-ccc_link_script,2017/02/28,ccc_link_script,0,0,00:00:00,0,00:00:00,0,0
20170228-ccc_media_line_script,2017/02/28,ccc_media_line_script,1,1,00:00:10,10,00:00:10,0,10
20170228-ccc_priority_script,2017/02/28,ccc_priority_script,43,43,00:00:09,9,00:00:29,0,387
20170228-ccc_tax_script,2017/02/28,ccc_tax_script,22,22,00:00:46,46,00:03:10,0,1012
20170228-ccc_waste_recycling_script,2017/02/28,ccc_waste_recycling_script,0,0,00:00:00,0,00:00:00,0,0
20170301-ccc_311_calgary_script,2017/03/01,ccc_311_calgary_script,2527,2372,00:00:44,44,00:05:50,155,104368
20170301-ccc_311_lobby_ph_script,2017/03/01,ccc_311_lobby_ph_script,3,2,00:00:04,4,00:00:04,1,8
20170301-ccc_aserv_info_script,2017/03/01,ccc_aserv_info_script,0,0,00:00:00,0,00:00:00,0,0
20170301-ccc_bylaw_script,2017/03/01,ccc_bylaw_script,0,0,00:00:00,0,00:00:00,0,0
20170301-ccc_city_script,2017/03/01,ccc_city_script,14,13,00:00:23,23,00:01:09,1,299
20170301-ccc_cty_online_script,2017/03/01,ccc_cty_online_script,0,0,00:00:00,0,00:00:00,0,0
20170301-ccc_feedback_script,2017/03/01,ccc_feedback_script,0,0,00:00:00,0,00:00:00,0,0
20170301-ccc_fpb_script,2017/03/01,ccc_fpb_script,1,1,00:00:21,21,00:00:21,0,21
20170301-ccc_help_script,2017/03/01,ccc_help_script,10,10,00:00:08,8,00:00:21,0,80
20170301-ccc_link_script,2017/03/01,ccc_link_script,0,0,00:00:00,0,00:00:00,0,0
20170301-ccc_media_line_script,2017/03/01,ccc_media_line_script,2,1,00:00:06,6,00:00:06,1,6
20170301-ccc_priority_script,2017/03/01,ccc_priority_script,29,26,00:00:09,9,00:00:34,3,234
20170301-ccc_tax_script,2017/03/01,ccc_tax_script,21,21,00:00:24,24,00:01:56,0,504
20170301-ccc_waste_recycling_script,2017/03/01,ccc_waste_recycling_script,0,0,00:00:00,0,00:00:00,0,0
20170302-ccc_311_calgary_script,2017/03/02,ccc_311_calgary_script,2871,2618,00:01:08,68,00:06:51,253,178024
20170302-ccc_311_lobby_ph_script,2017/03/02,ccc_311_lobby_ph_script,1,1,00:00:04,4,00:00:04,0,4
20170302-ccc_aserv_info_script,2017/03/02,ccc_aserv_info_script,0,0,00:00:00,0,00:00:00,0,0
20170302-ccc_bylaw_script,2017/03/02,ccc_bylaw_script,0,0,00:00:00,0,00:00:00,0,0
20170302-ccc_city_script,2017/03/02,ccc_city_script,28,25,00:00:21,21,00:01:22,3,525
20170302-ccc_cty_online_script,2017/03/02,ccc_cty_online_script,0,0,00:00:00,0,00:00:00,0,0
20170302-ccc_feedback_script,2017/03/02,ccc_feedback_script,0,0,00:00:00,0,00:00:00,0,0
20170302-ccc_fpb_script,2017/03/02,ccc_fpb_script,38,36,00:00:08,8,00:00:35,2,288
20170302-ccc_help_script,2017/03/02,ccc_help_script,11,11,00:00:10,10,00:00:23,0,110
20170302-ccc_link_script,2017/03/02,ccc_link_script,0,0,00:00:00,0,00:00:00,0,0
20170302-ccc_media_line_script,2017/03/02,ccc_media_line_script,2,2,00:00:54,54,00:01:44,0,108
20170302-ccc_priority_script,2017/03/02,ccc_priority_script,26,26,00:00:11,11,00:00:34,0,286
20170302-ccc_tax_script,2017/03/02,ccc_tax_script,22,20,00:01:17,77,00:05:00,2,1540
20170302-ccc_waste_recycling_script,2017/03/02,ccc_waste_recycling_script,0,0,00:00:00,0,00:00:00,0,0
20170303-ccc_311_calgary_script,2017/03/03,ccc_311_calgary_script,2647,2366,00:01:28,88,00:07:32,281,208208
20170303-ccc_311_lobby_ph_script,2017/03/03,ccc_311_lobby_ph_script,2,1,00:00:13,13,00:00:13,1,13
20170303-ccc_aserv_info_script,2017/03/03,ccc_aserv_info_script,0,0,00:00:00,0,00:00:00,0,0
20170303-ccc_bylaw_script,2017/03/03,ccc_bylaw_script,0,0,00:00:00,0,00:00:00,0,0
20170303-ccc_city_script,2017/03/03,ccc_city_script,25,23,00:00:30,30,00:02:32,2,690
20170303-ccc_cty_online_script,2017/03/03,ccc_cty_online_script,0,0,00:00:00,0,00:00:00,0,0
20170303-ccc_feedback_script,2017/03/03,ccc_feedback_script,0,0,00:00:00,0,00:00:00,0,0
20170303-ccc_fpb_script,2017/03/03,ccc_fpb_script,18,14,00:00:11,11,00:01:09,4,154
20170303-ccc_help_script,2017/03/03,ccc_help_script,17,17,00:00:08,8,00:00:34,0,136
20170303-ccc_link_script,2017/03/03,ccc_link_script,0,0,00:00:00,0,00:00:00,0,0
20170303-ccc_media_line_script,2017/03/03,ccc_media_line_script,1,0,00:00:00,0,00:00:00,1,0
20170303-ccc_priority_script,2017/03/03,ccc_priority_script,22,21,00:00:14,14,00:00:57,1,294
20170303-ccc_tax_script,2017/03/03,ccc_tax_script,23,22,00:01:58,118,00:05:43,1,2596
20170303-ccc_waste_recycling_script,2017/03/03,ccc_waste_recycling_script,0,0,00:00:00,0,00:00:00,0,0
20170306-ccc_311_calgary_script,2017/03/06,ccc_311_calgary_script,3302,2871,00:01:35,95,00:11:21,431,272745
20170306-ccc_311_lobby_ph_script,2017/03/06,ccc_311_lobby_ph_script,3,1,00:00:03,3,00:00:03,2,3
20170306-ccc_aserv_info_script,2017/03/06,ccc_aserv_info_script,0,0,00:00:00,0,00:00:00,0,0
20170306-ccc_bylaw_script,2017/03/06,ccc_bylaw_script,0,0,00:00:00,0,00:00:00,0,0
20170306-ccc_city_script,2017/03/06,ccc_city_script,15,15,00:00:19,19,00:01:07,0,285
20170306-ccc_cty_online_script,2017/03/06,ccc_cty_online_script,0,0,00:00:00,0,00:00:00,0,0
20170306-ccc_feedback_script,2017/03/06,ccc_feedback_script,1,0,00:00:00,0,00:00:00,0,0
20170306-ccc_fpb_script,2017/03/06,ccc_fpb_script,0,0,00:00:00,0,00:00:00,0,0
20170306-ccc_help_script,2017/03/06,ccc_help_script,16,13,00:00:29,29,00:03:32,3,377
20170306-ccc_link_script,2017/03/06,ccc_link_script,0,0,00:00:00,0,00:00:00,0,0
20170306-ccc_media_line_script,2017/03/06,ccc_media_line_script,0,0,00:00:00,0,00:00:00,0,0
20170306-ccc_priority_script,2017/03/06,ccc_priority_script,31,30,00:00:20,20,00:02:05,1,600
20170306-ccc_tax_script,2017/03/06,ccc_tax_script,21,20,00:01:40,100,00:04:06,1,2000
20170306-ccc_waste_recycling_script,2017/03/06,ccc_waste_recycling_script,0,0,00:00:00,0,00:00:00,0,0
20170311-ccc_311_calgary_script,2017/03/11,ccc_311_calgary_script,929,899,00:00:19,19,00:04:45,30,17081
20170311-ccc_311_lobby_ph_script,2017/03/11,ccc_311_lobby_ph_script,0,0,00:00:00,0,00:00:00,0,0
20170311-ccc_aserv_info_script,2017/03/11,ccc_aserv_info_script,0,0,00:00:00,0,00:00:00,0,0
20170311-ccc_bylaw_script,2017/03/11,ccc_bylaw_script,0,0,00:00:00,0,00:00:00,0,0
20170311-ccc_city_script,2017/03/11,ccc_city_script,0,0,00:00:00,0,00:00:00,0,0
20170311-ccc_cty_online_script,2017/03/11,ccc_cty_online_script,0,0,00:00:00,0,00:00:00,0,0
20170311-ccc_feedback_script,2017/03/11,ccc_feedback_script,0,0,00:00:00,0,00:00:00,0,0
20170311-ccc_fpb_script,2017/03/11,ccc_fpb_script,1,1,00:00:11,11,00:00:11,0,11
20170311-ccc_help_script,2017/03/11,ccc_help_script,10,9,00:00:07,7,00:00:21,1,63
20170311-ccc_link_script,2017/03/11,ccc_link_script,0,0,00:00:00,0,00:00:00,0,0
20170311-ccc_media_line_script,2017/03/11,ccc_media_line_script,1,1,00:00:03,3,00:00:03,0,3
20170311-ccc_priority_script,2017/03/11,ccc_priority_script,20,20,00:00:08,8,00:00:33,0,160
20170311-ccc_tax_script,2017/03/11,ccc_tax_script,0,0,00:00:00,0,00:00:00,0,0
20170311-ccc_waste_recycling_script,2017/03/11,ccc_waste_recycling_script,0,0,00:00:00,0,00:00:00,0,0
20170312-ccc_311_calgary_script,2017/03/12,ccc_311_calgary_script,818,801,00:00:12,12,00:03:48,17,9612
20170312-ccc_311_lobby_ph_script,2017/03/12,ccc_311_lobby_ph_script,0,0,00:00:00,0,00:00:00,0,0
20170312-ccc_aserv_info_script,2017/03/12,ccc_aserv_info_script,0,0,00:00:00,0,00:00:00,0,0
20170312-ccc_bylaw_script,2017/03/12,ccc_bylaw_script,0,0,00:00:00,0,00:00:00,0,0
20170312-ccc_city_script,2017/03/12,ccc_city_script,0,0,00:00:00,0,00:00:00,0,0
20170312-ccc_cty_online_script,2017/03/12,ccc_cty_online_script,0,0,00:00:00,0,00:00:00,0,0
20170312-ccc_feedback_script,2017/03/12,ccc_feedback_script,0,0,00:00:00,0,00:00:00,0,0
20170312-ccc_fpb_script,2017/03/12,ccc_fpb_script,0,0,00:00:00,0,00:00:00,0,0
20170312-ccc_help_script,2017/03/12,ccc_help_script,9,9,00:00:17,17,00:01:51,0,153
20170312-ccc_link_script,2017/03/12,ccc_link_script,0,0,00:00:00,0,00:00:00,0,0
20170312-ccc_media_line_script,2017/03/12,ccc_media_line_script,0,0,00:00:00,0,00:00:00,0,0
20170312-ccc_priority_script,2017/03/12,ccc_priority_script,28,28,00:00:11,11,00:01:27,0,308
20170312-ccc_tax_script,2017/03/12,ccc_tax_script,1,1,00:00:05,5,00:00:05,0,5
20170312-ccc_waste_recycling_script,2017/03/12,ccc_waste_recycling_script,0,0,00:00:00,0,00:00:00,0,0
20170313-ccc_311_calgary_script,2017/03/13,ccc_311_calgary_script,2788,2673,00:00:40,40,00:06:23,115,106920
20170313-ccc_311_lobby_ph_script,2017/03/13,ccc_311_lobby_ph_script,4,4,00:00:13,13,00:00:38,0,52
20170313-ccc_aserv_info_script,2017/03/13,ccc_aserv_info_script,0,0,00:00:00,0,00:00:00,0,0
20170313-ccc_bylaw_script,2017/03/13,ccc_bylaw_script,0,0,00:00:00,0,00:00:00,0,0
20170313-ccc_city_script,2017/03/13,ccc_city_script,18,18,00:00:12,12,00:00:35,0,216
20170313-ccc_cty_online_script,2017/03/13,ccc_cty_online_script,0,0,00:00:00,0,00:00:00,0,0
20170313-ccc_feedback_script,2017/03/13,ccc_feedback_script,0,0,00:00:00,0,00:00:00,0,0
20170313-ccc_fpb_script,2017/03/13,ccc_fpb_script,0,0,00:00:00,0,00:00:00,0,0
20170313-ccc_help_script,2017/03/13,ccc_help_script,10,9,00:00:06,6,00:00:17,1,54
20170313-ccc_link_script,2017/03/13,ccc_link_script,0,0,00:00:00,0,00:00:00,0,0
20170313-ccc_media_line_script,2017/03/13,ccc_media_line_script,1,1,00:00:06,6,00:00:06,0,6
20170313-ccc_priority_script,2017/03/13,ccc_priority_script,39,39,00:00:08,8,00:00:42,0,312
20170313-ccc_tax_script,2017/03/13,ccc_tax_script,20,20,00:00:41,41,00:03:15,0,820
20170313-ccc_waste_recycling_script,2017/03/13,ccc_waste_recycling_script,0,0,00:00:00,0,00:00:00,0,0
20170314-ccc_311_calgary_script,2017/03/14,ccc_311_calgary_script,3315,2791,00:02:43,163,00:11:15,524,454933
20170314-ccc_311_lobby_ph_script,2017/03/14,ccc_311_lobby_ph_script,3,3,00:00:17,17,00:00:42,0,51
20170314-ccc_aserv_info_script,2017/03/14,ccc_aserv_info_script,0,0,00:00:00,0,00:00:00,0,0
20170314-ccc_bylaw_script,2017/03/14,ccc_bylaw_script,0,0,00:00:00,0,00:00:00,0,0
20170314-ccc_city_script,2017/03/14,ccc_city_script,21,19,00:00:33,33,00:02:21,2,627
20170314-ccc_cty_online_script,2017/03/14,ccc_cty_online_script,0,0,00:00:00,0,00:00:00,0,0
20170314-ccc_feedback_script,2017/03/14,ccc_feedback_script,0,0,00:00:00,0,00:00:00,0,0
20170314-ccc_fpb_script,2017/03/14,ccc_fpb_script,0,0,00:00:00,0,00:00:00,0,0
20170314-ccc_help_script,2017/03/14,ccc_help_script,68,57,00:00:16,16,00:00:57,11,912
20170314-ccc_link_script,2017/03/14,ccc_link_script,2,0,00:00:00,0,00:00:00,1,0
20170314-ccc_media_line_script,2017/03/14,ccc_media_line_script,1,1,00:00:03,3,00:00:03,0,3
20170314-ccc_priority_script,2017/03/14,ccc_priority_script,36,35,00:00:15,15,00:00:46,1,525
20170314-ccc_tax_script,2017/03/14,ccc_tax_script,23,20,00:03:17,197,00:06:06,3,3940
20170314-ccc_waste_recycling_script,2017/03/14,ccc_waste_recycling_script,0,0,00:00:00,0,00:00:00,0,0
20170315-ccc_311_calgary_script,2017/03/15,ccc_311_calgary_script,3327,2892,00:01:57,117,00:12:20,435,338364
20170315-ccc_311_lobby_ph_script,2017/03/15,ccc_311_lobby_ph_script,4,4,00:00:14,14,00:00:32,0,56
20170315-ccc_aserv_info_script,2017/03/15,ccc_aserv_info_script,0,0,00:00:00,0,00:00:00,0,0
20170315-ccc_bylaw_script,2017/03/15,ccc_bylaw_script,0,0,00:00:00,0,00:00:00,0,0
20170315-ccc_city_script,2017/03/15,ccc_city_script,23,20,00:00:30,30,00:03:45,3,600
20170315-ccc_cty_online_script,2017/03/15,ccc_cty_online_script,0,0,00:00:00,0,00:00:00,0,0
20170315-ccc_feedback_script,2017/03/15,ccc_feedback_script,0,0,00:00:00,0,00:00:00,0,0
20170315-ccc_fpb_script,2017/03/15,ccc_fpb_script,3,2,00:03:21,201,00:06:39,1,402
20170315-ccc_help_script,2017/03/15,ccc_help_script,54,50,00:00:17,17,00:01:36,4,850
20170315-ccc_link_script,2017/03/15,ccc_link_script,0,0,00:00:00,0,00:00:00,0,0
20170315-ccc_media_line_script,2017/03/15,ccc_media_line_script,3,3,00:00:04,4,00:00:05,0,12
20170315-ccc_priority_script,2017/03/15,ccc_priority_script,50,49,00:00:15,15,00:01:57,1,735
20170315-ccc_tax_script,2017/03/15,ccc_tax_script,30,29,00:01:37,97,00:07:21,1,2813
20170315-ccc_waste_recycling_script,2017/03/15,ccc_waste_recycling_script,0,0,00:00:00,0,00:00:00,0,0
20170316-ccc_311_calgary_script,2017/03/16,ccc_311_calgary_script,3025,2713,00:01:22,82,00:14:58,312,222466
20170316-ccc_311_lobby_ph_script,2017/03/16,ccc_311_lobby_ph_script,2,2,00:00:07,7,00:00:07,0,14
20170316-ccc_aserv_info_script,2017/03/16,ccc_aserv_info_script,0,0,00:00:00,0,00:00:00,0,0
20170316-ccc_bylaw_script,2017/03/16,ccc_bylaw_script,0,0,00:00:00,0,00:00:00,0,0
20170316-ccc_city_script,2017/03/16,ccc_city_script,17,16,00:00:30,30,00:04:36,1,480
20170316-ccc_cty_online_script,2017/03/16,ccc_cty_online_script,0,0,00:00:00,0,00:00:00,0,0
20170316-ccc_feedback_script,2017/03/16,ccc_feedback_script,0,0,00:00:00,0,00:00:00,0,0
20170316-ccc_fpb_script,2017/03/16,ccc_fpb_script,1,1,00:00:34,34,00:00:34,0,34
20170316-ccc_help_script,2017/03/16,ccc_help_script,32,27,00:00:15,15,00:01:42,5,405
20170316-ccc_link_script,2017/03/16,ccc_link_script,0,0,00:00:00,0,00:00:00,0,0
20170316-ccc_media_line_script,2017/03/16,ccc_media_line_script,3,2,00:00:08,8,00:00:11,1,16
20170316-ccc_priority_script,2017/03/16,ccc_priority_script,38,38,00:00:11,11,00:00:49,0,418
20170316-ccc_tax_script,2017/03/16,ccc_tax_script,27,25,00:00:41,41,00:05:27,2,1025
20170316-ccc_waste_recycling_script,2017/03/16,ccc_waste_recycling_script,0,0,00:00:00,0,00:00:00,0,0
20170317-ccc_311_calgary_script,2017/03/17,ccc_311_calgary_script,2500,2397,00:00:30,30,00:06:21,103,71910
20170317-ccc_311_lobby_ph_script,2017/03/17,ccc_311_lobby_ph_script,0,0,00:00:00,0,00:00:00,0,0
20170317-ccc_aserv_info_script,2017/03/17,ccc_aserv_info_script,0,0,00:00:00,0,00:00:00,0,0
20170317-ccc_bylaw_script,2017/03/17,ccc_bylaw_script,0,0,00:00:00,0,00:00:00,0,0
20170317-ccc_city_script,2017/03/17,ccc_city_script,14,14,00:00:15,15,00:00:50,0,210
20170317-ccc_cty_online_script,2017/03/17,ccc_cty_online_script,0,0,00:00:00,0,00:00:00,0,0
20170317-ccc_feedback_script,2017/03/17,ccc_feedback_script,0,0,00:00:00,0,00:00:00,0,0
20170317-ccc_fpb_script,2017/03/17,ccc_fpb_script,3,2,00:00:02,2,00:00:03,1,4
20170317-ccc_help_script,2017/03/17,ccc_help_script,20,20,00:00:08,8,00:00:26,0,160
20170317-ccc_link_script,2017/03/17,ccc_link_script,0,0,00:00:00,0,00:00:00,0,0
20170317-ccc_media_line_script,2017/03/17,ccc_media_line_script,1,1,00:00:03,3,00:00:03,0,3
20170317-ccc_priority_script,2017/03/17,ccc_priority_script,22,22,00:00:11,11,00:00:37,0,242
20170317-ccc_tax_script,2017/03/17,ccc_tax_script,20,18,00:00:21,21,00:01:50,2,378
20170317-ccc_waste_recycling_script,2017/03/17,ccc_waste_recycling_script,0,0,00:00:00,0,00:00:00,0,0
20170318-ccc_311_calgary_script,2017/03/18,ccc_311_calgary_script,1473,1246,00:01:47,107,00:18:43,225,133322
20170318-ccc_311_lobby_ph_script,2017/03/18,ccc_311_lobby_ph_script,0,0,00:00:00,0,00:00:00,0,0
20170318-ccc_aserv_info_script,2017/03/18,ccc_aserv_info_script,0,0,00:00:00,0,00:00:00,0,0
20170318-ccc_bylaw_script,2017/03/18,ccc_bylaw_script,0,0,00:00:00,0,00:00:00,0,0
20170318-ccc_city_script,2017/03/18,ccc_city_script,0,0,00:00:00,0,00:00:00,0,0
20170318-ccc_cty_online_script,2017/03/18,ccc_cty_online_script,0,0,00:00:00,0,00:00:00,0,0
20170318-ccc_feedback_script,2017/03/18,ccc_feedback_script,0,0,00:00:00,0,00:00:00,0,0
20170318-ccc_fpb_script,2017/03/18,ccc_fpb_script,1,1,00:01:47,107,00:01:47,0,107
20170318-ccc_help_script,2017/03/18,ccc_help_script,12,8,00:00:13,13,00:00:31,4,104
20170318-ccc_link_script,2017/03/18,ccc_link_script,0,0,00:00:00,0,00:00:00,0,0
20170318-ccc_media_line_script,2017/03/18,ccc_media_line_script,0,0,00:00:00,0,00:00:00,0,0
20170318-ccc_priority_script,2017/03/18,ccc_priority_script,29,24,00:00:26,26,00:03:01,5,624
20170318-ccc_tax_script,2017/03/18,ccc_tax_script,1,1,00:00:53,53,00:00:53,0,53
20170318-ccc_waste_recycling_script,2017/03/18,ccc_waste_recycling_script,0,0,00:00:00,0,00:00:00,0,0
20170319-ccc_311_calgary_script,2017/03/19,ccc_311_calgary_script,958,935,00:00:21,21,00:06:23,25,19635
20170319-ccc_311_lobby_ph_script,2017/03/19,ccc_311_lobby_ph_script,0,0,00:00:00,0,00:00:00,0,0
20170319-ccc_aserv_info_script,2017/03/19,ccc_aserv_info_script,0,0,00:00:00,0,00:00:00,0,0
20170319-ccc_bylaw_script,2017/03/19,ccc_bylaw_script,0,0,00:00:00,0,00:00:00,0,0
20170319-ccc_city_script,2017/03/19,ccc_city_script,0,0,00:00:00,0,00:00:00,0,0
20170319-ccc_cty_online_script,2017/03/19,ccc_cty_online_script,0,0,00:00:00,0,00:00:00,0,0
20170319-ccc_feedback_script,2017/03/19,ccc_feedback_script,0,0,00:00:00,0,00:00:00,0,0
20170319-ccc_fpb_script,2017/03/19,ccc_fpb_script,0,0,00:00:00,0,00:00:00,0,0
20170319-ccc_help_script,2017/03/19,ccc_help_script,4,4,00:00:13,13,00:00:35,0,52
20170319-ccc_link_script,2017/03/19,ccc_link_script,0,0,00:00:00,0,00:00:00,0,0
20170319-ccc_media_line_script,2017/03/19,ccc_media_line_script,0,0,00:00:00,0,00:00:00,0,0
20170319-ccc_priority_script,2017/03/19,ccc_priority_script,11,10,00:00:11,11,00:00:39,1,110
20170319-ccc_tax_script,2017/03/19,ccc_tax_script,0,0,00:00:00,0,00:00:00,0,0
20170319-ccc_waste_recycling_script,2017/03/19,ccc_waste_recycling_script,0,0,00:00:00,0,00:00:00,0,0
20170320-ccc_311_calgary_script,2017/03/20,ccc_311_calgary_script,3246,3000,00:01:01,61,00:08:26,246,183000
20170320-ccc_311_lobby_ph_script,2017/03/20,ccc_311_lobby_ph_script,2,2,00:00:06,6,00:00:07,0,12
20170320-ccc_aserv_info_script,2017/03/20,ccc_aserv_info_script,0,0,00:00:00,0,00:00:00,0,0
20170320-ccc_bylaw_script,2017/03/20,ccc_bylaw_script,0,0,00:00:00,0,00:00:00,0,0
20170320-ccc_city_script,2017/03/20,ccc_city_script,9,9,00:00:29,29,00:01:27,0,261
20170320-ccc_cty_online_script,2017/03/20,ccc_cty_online_script,0,0,00:00:00,0,00:00:00,0,0
20170320-ccc_feedback_script,2017/03/20,ccc_feedback_script,0,0,00:00:00,0,00:00:00,0,0
20170320-ccc_fpb_script,2017/03/20,ccc_fpb_script,1,1,00:00:09,9,00:00:09,0,9
20170320-ccc_help_script,2017/03/20,ccc_help_script,33,30,00:00:10,10,00:00:40,3,300
20170320-ccc_link_script,2017/03/20,ccc_link_script,0,0,00:00:00,0,00:00:00,0,0
20170320-ccc_media_line_script,2017/03/20,ccc_media_line_script,8,5,00:00:08,8,00:00:15,3,40
20170320-ccc_priority_script,2017/03/20,ccc_priority_script,30,28,00:00:11,11,00:00:53,2,308
20170320-ccc_tax_script,2017/03/20,ccc_tax_script,21,20,00:01:09,69,00:04:22,1,1380
20170320-ccc_waste_recycling_script,2017/03/20,ccc_waste_recycling_script,0,0,00:00:00,0,00:00:00,0,0
20170321-ccc_311_calgary_script,2017/03/21,ccc_311_calgary_script,2704,2629,00:00:20,20,00:03:29,75,52580
20170321-ccc_311_lobby_ph_script,2017/03/21,ccc_311_lobby_ph_script,5,5,00:00:06,6,00:00:07,0,30
20170321-ccc_aserv_info_script,2017/03/21,ccc_aserv_info_script,0,0,00:00:00,0,00:00:00,0,0
20170321-ccc_bylaw_script,2017/03/21,ccc_bylaw_script,0,0,00:00:00,0,00:00:00,0,0
20170321-ccc_city_script,2017/03/21,ccc_city_script,10,10,00:00:12,12,00:00:33,0,120
20170321-ccc_cty_online_script,2017/03/21,ccc_cty_online_script,0,0,00:00:00,0,00:00:00,0,0
20170321-ccc_feedback_script,2017/03/21,ccc_feedback_script,0,0,00:00:00,0,00:00:00,0,0
20170321-ccc_fpb_script,2017/03/21,ccc_fpb_script,1,0,00:00:00,0,00:00:00,1,0
20170321-ccc_help_script,2017/03/21,ccc_help_script,18,18,00:00:07,7,00:00:18,0,126
20170321-ccc_link_script,2017/03/21,ccc_link_script,0,0,00:00:00,0,00:00:00,0,0
20170321-ccc_media_line_script,2017/03/21,ccc_media_line_script,0,0,00:00:00,0,00:00:00,0,0
20170321-ccc_priority_script,2017/03/21,ccc_priority_script,32,31,00:00:09,9,00:01:05,1,279
20170321-ccc_tax_script,2017/03/21,ccc_tax_script,22,21,00:00:26,26,00:01:57,1,546
20170321-ccc_waste_recycling_script,2017/03/21,ccc_waste_recycling_script,0,0,00:00:00,0,00:00:00,0,0
20170322-ccc_311_calgary_script,2017/03/22,ccc_311_calgary_script,3107,2658,00:02:23,143,00:09:17,449,380094
20170322-ccc_311_lobby_ph_script,2017/03/22,ccc_311_lobby_ph_script,1,1,00:00:07,7,00:00:07,0,7
20170322-ccc_aserv_info_script,2017/03/22,ccc_aserv_info_script,0,0,00:00:00,0,00:00:00,0,0
20170322-ccc_bylaw_script,2017/03/22,ccc_bylaw_script,0,0,00:00:00,0,00:00:00,0,0
20170322-ccc_city_script,2017/03/22,ccc_city_script,14,14,00:00:52,52,00:05:20,0,728
20170322-ccc_cty_online_script,2017/03/22,ccc_cty_online_script,0,0,00:00:00,0,00:00:00,0,0
20170322-ccc_feedback_script,2017/03/22,ccc_feedback_script,1,0,00:00:00,0,00:00:00,1,0
20170322-ccc_fpb_script,2017/03/22,ccc_fpb_script,1,1,00:00:04,4,00:00:04,0,4
20170322-ccc_help_script,2017/03/22,ccc_help_script,42,37,00:00:16,16,00:01:04,5,592
20170322-ccc_link_script,2017/03/22,ccc_link_script,0,0,00:00:00,0,00:00:00,0,0
20170322-ccc_media_line_script,2017/03/22,ccc_media_line_script,2,2,00:00:13,13,00:00:22,0,26
20170322-ccc_priority_script,2017/03/22,ccc_priority_script,29,29,00:00:08,8,00:00:21,0,232
20170322-ccc_tax_script,2017/03/22,ccc_tax_script,27,22,00:02:14,134,00:06:11,5,2948
20170322-ccc_waste_recycling_script,2017/03/22,ccc_waste_recycling_script,0,0,00:00:00,0,00:00:00,0,0
20170323-ccc_311_calgary_script,2017/03/23,ccc_311_calgary_script,3161,2777,00:01:56,116,00:08:48,384,322132
20170323-ccc_311_lobby_ph_script,2017/03/23,ccc_311_lobby_ph_script,0,0,00:00:00,0,00:00:00,0,0
20170323-ccc_aserv_info_script,2017/03/23,ccc_aserv_info_script,0,0,00:00:00,0,00:00:00,0,0
20170323-ccc_bylaw_script,2017/03/23,ccc_bylaw_script,0,0,00:00:00,0,00:00:00,0,0
20170323-ccc_city_script,2017/03/23,ccc_city_script,8,8,00:00:31,31,00:02:10,0,248
20170323-ccc_cty_online_script,2017/03/23,ccc_cty_online_script,0,0,00:00:00,0,00:00:00,0,0
20170323-ccc_feedback_script,2017/03/23,ccc_feedback_script,0,0,00:00:00,0,00:00:00,0,0
20170323-ccc_fpb_script,2017/03/23,ccc_fpb_script,2,2,00:01:03,63,00:02:01,0,126
20170323-ccc_help_script,2017/03/23,ccc_help_script,38,30,00:00:12,12,00:00:35,8,360
20170323-ccc_link_script,2017/03/23,ccc_link_script,0,0,00:00:00,0,00:00:00,0,0
20170323-ccc_media_line_script,2017/03/23,ccc_media_line_script,0,0,00:00:00,0,00:00:00,0,0
20170323-ccc_priority_script,2017/03/23,ccc_priority_script,39,39,00:00:13,13,00:01:46,0,507
20170323-ccc_tax_script,2017/03/23,ccc_tax_script,22,20,00:01:35,95,00:05:10,2,1900
20170323-ccc_waste_recycling_script,2017/03/23,ccc_waste_recycling_script,0,0,00:00:00,0,00:00:00,0,0
20170324-ccc_311_calgary_script,2017/03/24,ccc_311_calgary_script,2881,2582,00:01:29,89,00:06:25,298,229798
20170324-ccc_311_lobby_ph_script,2017/03/24,ccc_311_lobby_ph_script,4,1,00:00:03,3,00:00:03,3,3
20170324-ccc_aserv_info_script,2017/03/24,ccc_aserv_info_script,0,0,00:00:00,0,00:00:00,0,0
20170324-ccc_bylaw_script,2017/03/24,ccc_bylaw_script,0,0,00:00:00,0,00:00:00,0,0
20170324-ccc_city_script,2017/03/24,ccc_city_script,11,10,00:00:32,32,00:02:39,1,320
20170324-ccc_cty_online_script,2017/03/24,ccc_cty_online_script,0,0,00:00:00,0,00:00:00,0,0
20170324-ccc_feedback_script,2017/03/24,ccc_feedback_script,0,0,00:00:00,0,00:00:00,0,0
20170324-ccc_fpb_script,2017/03/24,ccc_fpb_script,4,1,00:00:15,15,00:00:15,3,15
20170324-ccc_help_script,2017/03/24,ccc_help_script,41,34,00:00:13,13,00:01:09,7,442
20170324-ccc_link_script,2017/03/24,ccc_link_script,0,0,00:00:00,0,00:00:00,0,0
20170324-ccc_media_line_script,2017/03/24,ccc_media_line_script,1,1,00:01:42,102,00:01:42,0,102
20170324-ccc_priority_script,2017/03/24,ccc_priority_script,30,29,00:00:14,14,00:00:54,1,406
20170324-ccc_tax_script,2017/03/24,ccc_tax_script,15,13,00:01:45,105,00:04:27,2,1365
20170324-ccc_waste_recycling_script,2017/03/24,ccc_waste_recycling_script,0,0,00:00:00,0,00:00:00,0,0
20170325-ccc_311_calgary_script,2017/03/25,ccc_311_calgary_script,1205,1175,00:00:17,17,00:04:03,31,19975
20170325-ccc_311_lobby_ph_script,2017/03/25,ccc_311_lobby_ph_script,0,0,00:00:00,0,00:00:00,0,0
20170325-ccc_aserv_info_script,2017/03/25,ccc_aserv_info_script,0,0,00:00:00,0,00:00:00,0,0
20170325-ccc_bylaw_script,2017/03/25,ccc_bylaw_script,0,0,00:00:00,0,00:00:00,0,0
20170325-ccc_city_script,2017/03/25,ccc_city_script,0,0,00:00:00,0,00:00:00,0,0
20170325-ccc_cty_online_script,2017/03/25,ccc_cty_online_script,0,0,00:00:00,0,00:00:00,0,0
20170325-ccc_feedback_script,2017/03/25,ccc_feedback_script,0,0,00:00:00,0,00:00:00,0,0
20170325-ccc_fpb_script,2017/03/25,ccc_fpb_script,1,1,00:00:05,5,00:00:05,0,5
20170325-ccc_help_script,2017/03/25,ccc_help_script,3,3,00:00:24,24,00:01:05,0,72
20170325-ccc_link_script,2017/03/25,ccc_link_script,0,0,00:00:00,0,00:00:00,0,0
20170325-ccc_media_line_script,2017/03/25,ccc_media_line_script,6,5,00:00:08,8,00:00:20,1,40
20170325-ccc_priority_script,2017/03/25,ccc_priority_script,16,16,00:00:07,7,00:00:13,0,112
20170325-ccc_tax_script,2017/03/25,ccc_tax_script,0,0,00:00:00,0,00:00:00,0,0
20170325-ccc_waste_recycling_script,2017/03/25,ccc_waste_recycling_script,0,0,00:00:00,0,00:00:00,0,0
20170326-ccc_311_calgary_script,2017/03/26,ccc_311_calgary_script,1047,1027,00:00:18,18,00:04:31,20,18486
20170326-ccc_311_lobby_ph_script,2017/03/26,ccc_311_lobby_ph_script,0,0,00:00:00,0,00:00:00,0,0
20170326-ccc_aserv_info_script,2017/03/26,ccc_aserv_info_script,0,0,00:00:00,0,00:00:00,0,0
20170326-ccc_bylaw_script,2017/03/26,ccc_bylaw_script,0,0,00:00:00,0,00:00:00,0,0
20170326-ccc_city_script,2017/03/26,ccc_city_script,0,0,00:00:00,0,00:00:00,0,0
20170326-ccc_cty_online_script,2017/03/26,ccc_cty_online_script,0,0,00:00:00,0,00:00:00,0,0
20170326-ccc_feedback_script,2017/03/26,ccc_feedback_script,0,0,00:00:00,0,00:00:00,0,0
20170326-ccc_fpb_script,2017/03/26,ccc_fpb_script,0,0,00:00:00,0,00:00:00,0,0
20170326-ccc_help_script,2017/03/26,ccc_help_script,4,4,00:00:09,9,00:00:12,0,36
20170326-ccc_link_script,2017/03/26,ccc_link_script,0,0,00:00:00,0,00:00:00,0,0
20170326-ccc_media_line_script,2017/03/26,ccc_media_line_script,3,3,00:00:04,4,00:00:06,0,12
20170326-ccc_priority_script,2017/03/26,ccc_priority_script,14,13,00:00:08,8,00:00:16,1,104
20170326-ccc_tax_script,2017/03/26,ccc_tax_script,0,0,00:00:00,0,00:00:00,0,0
20170326-ccc_waste_recycling_script,2017/03/26,ccc_waste_recycling_script,0,0,00:00:00,0,00:00:00,0,0
20170327-ccc_311_calgary_script,2017/03/27,ccc_311_calgary_script,3485,2996,00:02:13,133,00:08:46,489,398468
20170327-ccc_311_lobby_ph_script,2017/03/27,ccc_311_lobby_ph_script,0,0,00:00:00,0,00:00:00,0,0
20170327-ccc_aserv_info_script,2017/03/27,ccc_aserv_info_script,0,0,00:00:00,0,00:00:00,0,0
20170327-ccc_bylaw_script,2017/03/27,ccc_bylaw_script,0,0,00:00:00,0,00:00:00,0,0
20170327-ccc_city_script,2017/03/27,ccc_city_script,14,14,00:00:13,13,00:00:33,0,182
20170327-ccc_cty_online_script,2017/03/27,ccc_cty_online_script,0,0,00:00:00,0,00:00:00,0,0
20170327-ccc_feedback_script,2017/03/27,ccc_feedback_script,0,0,00:00:00,0,00:00:00,0,0
20170327-ccc_fpb_script,2017/03/27,ccc_fpb_script,2,1,00:04:39,279,00:04:39,1,279
20170327-ccc_help_script,2017/03/27,ccc_help_script,39,35,00:00:14,14,00:00:59,4,490
20170327-ccc_link_script,2017/03/27,ccc_link_script,0,0,00:00:00,0,00:00:00,0,0
20170327-ccc_media_line_script,2017/03/27,ccc_media_line_script,0,0,00:00:00,0,00:00:00,0,0
20170327-ccc_priority_script,2017/03/27,ccc_priority_script,28,27,00:00:12,12,00:00:35,1,324
20170327-ccc_tax_script,2017/03/27,ccc_tax_script,31,30,00:02:20,140,00:07:21,1,4200
20170327-ccc_waste_recycling_script,2017/03/27,ccc_waste_recycling_script,0,0,00:00:00,0,00:00:00,0,0
20170328-ccc_311_calgary_script,2017/03/28,ccc_311_calgary_script,3169,2729,00:02:00,120,00:10:10,440,327480
20170328-ccc_311_lobby_ph_script,2017/03/28,ccc_311_lobby_ph_script,2,2,00:00:36,36,00:00:49,0,72
20170328-ccc_aserv_info_script,2017/03/28,ccc_aserv_info_script,0,0,00:00:00,0,00:00:00,0,0
20170328-ccc_bylaw_script,2017/03/28,ccc_bylaw_script,0,0,00:00:00,0,00:00:00,0,0
20170328-ccc_city_script,2017/03/28,ccc_city_script,12,11,00:00:22,22,00:01:31,1,242
20170328-ccc_cty_online_script,2017/03/28,ccc_cty_online_script,0,0,00:00:00,0,00:00:00,0,0
20170328-ccc_feedback_script,2017/03/28,ccc_feedback_script,0,0,00:00:00,0,00:00:00,0,0
20170328-ccc_fpb_script,2017/03/28,ccc_fpb_script,0,0,00:00:00,0,00:00:00,0,0
20170328-ccc_help_script,2017/03/28,ccc_help_script,54,44,00:00:21,21,00:01:46,10,924
20170328-ccc_link_script,2017/03/28,ccc_link_script,0,0,00:00:00,0,00:00:00,0,0
20170328-ccc_media_line_script,2017/03/28,ccc_media_line_script,2,2,00:00:11,11,00:00:18,0,22
20170328-ccc_priority_script,2017/03/28,ccc_priority_script,23,22,00:00:13,13,00:01:21,1,286
20170328-ccc_tax_script,2017/03/28,ccc_tax_script,24,20,00:02:28,148,00:05:44,4,2960
20170328-ccc_waste_recycling_script,2017/03/28,ccc_waste_recycling_script,0,0,00:00:00,0,00:00:00,0,0
20170329-ccc_311_calgary_script,2017/03/29,ccc_311_calgary_script,3103,2825,00:01:09,69,00:07:23,278,194925
20170329-ccc_311_lobby_ph_script,2017/03/29,ccc_311_lobby_ph_script,3,3,00:00:13,13,00:00:26,0,39
20170329-ccc_aserv_info_script,2017/03/29,ccc_aserv_info_script,0,0,00:00:00,0,00:00:00,0,0
20170329-ccc_bylaw_script,2017/03/29,ccc_bylaw_script,0,0,00:00:00,0,00:00:00,0,0
20170329-ccc_city_script,2017/03/29,ccc_city_script,25,25,00:00:16,16,00:00:52,0,400
20170329-ccc_cty_online_script,2017/03/29,ccc_cty_online_script,0,0,00:00:00,0,00:00:00,0,0
20170329-ccc_feedback_script,2017/03/29,ccc_feedback_script,0,0,00:00:00,0,00:00:00,0,0
20170329-ccc_fpb_script,2017/03/29,ccc_fpb_script,2,2,00:00:38,38,00:00:50,0,76
20170329-ccc_help_script,2017/03/29,ccc_help_script,13,12,00:00:17,17,00:00:50,1,204
20170329-ccc_link_script,2017/03/29,ccc_link_script,0,0,00:00:00,0,00:00:00,0,0
20170329-ccc_media_line_script,2017/03/29,ccc_media_line_script,1,1,00:00:03,3,00:00:03,0,3
20170329-ccc_priority_script,2017/03/29,ccc_priority_script,26,26,00:00:09,9,00:00:34,0,234
20170329-ccc_tax_script,2017/03/29,ccc_tax_script,13,12,00:00:51,51,00:03:24,1,612
20170329-ccc_waste_recycling_script,2017/03/29,ccc_waste_recycling_script,0,0,00:00:00,0,00:00:00,0,0
20170330-ccc_311_calgary_script,2017/03/30,ccc_311_calgary_script,3051,2862,00:00:45,45,00:05:55,189,128790
20170330-ccc_311_lobby_ph_script,2017/03/30,ccc_311_lobby_ph_script,2,1,00:00:04,4,00:00:04,1,4
20170330-ccc_aserv_info_script,2017/03/30,ccc_aserv_info_script,0,0,00:00:00,0,00:00:00,0,0
20170330-ccc_bylaw_script,2017/03/30,ccc_bylaw_script,0,0,00:00:00,0,00:00:00,0,0
20170330-ccc_city_script,2017/03/30,ccc_city_script,14,14,00:00:10,10,00:00:22,0,140
20170330-ccc_cty_online_script,2017/03/30,ccc_cty_online_script,0,0,00:00:00,0,00:00:00,0,0
20170330-ccc_feedback_script,2017/03/30,ccc_feedback_script,0,0,00:00:00,0,00:00:00,0,0
20170330-ccc_fpb_script,2017/03/30,ccc_fpb_script,2,1,00:00:44,44,00:00:44,1,44
20170330-ccc_help_script,2017/03/30,ccc_help_script,23,20,00:00:14,14,00:01:14,3,280
20170330-ccc_link_script,2017/03/30,ccc_link_script,0,0,00:00:00,0,00:00:00,0,0
20170330-ccc_media_line_script,2017/03/30,ccc_media_line_script,2,2,00:00:02,2,00:00:03,0,4
20170330-ccc_priority_script,2017/03/30,ccc_priority_script,44,43,00:00:07,7,00:00:39,1,301
20170330-ccc_tax_script,2017/03/30,ccc_tax_script,32,31,00:00:38,38,00:03:58,1,1178
20170330-ccc_waste_recycling_script,2017/03/30,ccc_waste_recycling_script,0,0,00:00:00,0,00:00:00,0,0
20170331-ccc_311_calgary_script,2017/03/31,ccc_311_calgary_script,3059,2615,00:01:56,116,00:08:49,444,303340
20170331-ccc_311_lobby_ph_script,2017/03/31,ccc_311_lobby_ph_script,4,2,00:00:09,9,00:00:11,2,18
20170331-ccc_aserv_info_script,2017/03/31,ccc_aserv_info_script,0,0,00:00:00,0,00:00:00,0,0
20170331-ccc_bylaw_script,2017/03/31,ccc_bylaw_script,0,0,00:00:00,0,00:00:00,0,0
20170331-ccc_city_script,2017/03/31,ccc_city_script,18,18,00:00:29,29,00:01:55,0,522
20170331-ccc_cty_online_script,2017/03/31,ccc_cty_online_script,0,0,00:00:00,0,00:00:00,0,0
20170331-ccc_feedback_script,2017/03/31,ccc_feedback_script,0,0,00:00:00,0,00:00:00,0,0
20170331-ccc_fpb_script,2017/03/31,ccc_fpb_script,0,0,00:00:00,0,00:00:00,0,0
20170331-ccc_help_script,2017/03/31,ccc_help_script,67,63,00:00:24,24,00:03:08,4,1512
20170331-ccc_link_script,2017/03/31,ccc_link_script,0,0,00:00:00,0,00:00:00,0,0
20170331-ccc_media_line_script,2017/03/31,ccc_media_line_script,0,0,00:00:00,0,00:00:00,0,0
20170331-ccc_priority_script,2017/03/31,ccc_priority_script,30,29,00:00:11,11,00:00:46,1,319
20170331-ccc_tax_script,2017/03/31,ccc_tax_script,24,20,00:02:22,142,00:04:43,4,2840
20170331-ccc_waste_recycling_script,2017/03/31,ccc_waste_recycling_script,0,0,00:00:00,0,00:00:00,0,0
20170401-ccc_311_calgary_script,2017/04/01,ccc_311_calgary_script,1984,1308,00:02:38,158,00:19:06,676,206664
20170401-ccc_311_lobby_ph_script,2017/04/01,ccc_311_lobby_ph_script,0,0,00:00:00,0,00:00:00,0,0
20170401-ccc_aserv_info_script,2017/04/01,ccc_aserv_info_script,0,0,00:00:00,0,00:00:00,0,0
20170401-ccc_bylaw_script,2017/04/01,ccc_bylaw_script,0,0,00:00:00,0,00:00:00,0,0
20170401-ccc_city_script,2017/04/01,ccc_city_script,0,0,00:00:00,0,00:00:00,0,0
20170401-ccc_cty_online_script,2017/04/01,ccc_cty_online_script,0,0,00:00:00,0,00:00:00,0,0
20170401-ccc_feedback_script,2017/04/01,ccc_feedback_script,0,0,00:00:00,0,00:00:00,0,0
20170401-ccc_fpb_script,2017/04/01,ccc_fpb_script,2,2,00:08:32,512,00:16:58,0,1024
20170401-ccc_help_script,2017/04/01,ccc_help_script,5,4,00:00:25,25,00:01:01,1,100
20170401-ccc_link_script,2017/04/01,ccc_link_script,0,0,00:00:00,0,00:00:00,0,0
20170401-ccc_media_line_script,2017/04/01,ccc_media_line_script,2,2,00:00:04,4,00:00:05,0,8
20170401-ccc_priority_script,2017/04/01,ccc_priority_script,26,25,00:00:22,22,00:01:55,1,550
20170401-ccc_tax_script,2017/04/01,ccc_tax_script,1,1,00:00:17,17,00:00:17,0,17
20170401-ccc_waste_recycling_script,2017/04/01,ccc_waste_recycling_script,0,0,00:00:00,0,00:00:00,0,0
20170402-ccc_311_calgary_script,2017/04/02,ccc_311_calgary_script,800,764,00:00:22,22,00:05:33,36,16808
20170402-ccc_311_lobby_ph_script,2017/04/02,ccc_311_lobby_ph_script,0,0,00:00:00,0,00:00:00,0,0
20170402-ccc_aserv_info_script,2017/04/02,ccc_aserv_info_script,0,0,00:00:00,0,00:00:00,0,0
20170402-ccc_bylaw_script,2017/04/02,ccc_bylaw_script,0,0,00:00:00,0,00:00:00,0,0
20170402-ccc_city_script,2017/04/02,ccc_city_script,0,0,00:00:00,0,00:00:00,0,0
20170402-ccc_cty_online_script,2017/04/02,ccc_cty_online_script,0,0,00:00:00,0,00:00:00,0,0
20170402-ccc_feedback_script,2017/04/02,ccc_feedback_script,0,0,00:00:00,0,00:00:00,0,0
20170402-ccc_fpb_script,2017/04/02,ccc_fpb_script,1,1,00:00:04,4,00:00:04,0,4
20170402-ccc_help_script,2017/04/02,ccc_help_script,2,2,00:00:23,23,00:00:42,0,46
20170402-ccc_link_script,2017/04/02,ccc_link_script,0,0,00:00:00,0,00:00:00,0,0
20170402-ccc_media_line_script,2017/04/02,ccc_media_line_script,2,2,00:00:04,4,00:00:05,0,8
20170402-ccc_priority_script,2017/04/02,ccc_priority_script,9,9,00:00:13,13,00:00:52,0,117
20170402-ccc_tax_script,2017/04/02,ccc_tax_script,0,0,00:00:00,0,00:00:00,0,0
20170402-ccc_waste_recycling_script,2017/04/02,ccc_waste_recycling_script,0,0,00:00:00,0,00:00:00,0,0
20170403-ccc_311_calgary_script,2017/04/03,ccc_311_calgary_script,3465,2833,00:03:05,185,00:09:01,631,524105
20170403-ccc_311_lobby_ph_script,2017/04/03,ccc_311_lobby_ph_script,3,3,00:00:13,13,00:00:18,0,39
20170403-ccc_aserv_info_script,2017/04/03,ccc_aserv_info_script,0,0,00:00:00,0,00:00:00,0,0
20170403-ccc_bylaw_script,2017/04/03,ccc_bylaw_script,0,0,00:00:00,0,00:00:00,0,0
20170403-ccc_city_script,2017/04/03,ccc_city_script,13,11,00:01:17,77,00:03:58,2,847
20170403-ccc_cty_online_script,2017/04/03,ccc_cty_online_script,0,0,00:00:00,0,00:00:00,0,0
20170403-ccc_feedback_script,2017/04/03,ccc_feedback_script,0,0,00:00:00,0,00:00:00,0,0
20170403-ccc_fpb_script,2017/04/03,ccc_fpb_script,0,0,00:00:00,0,00:00:00,0,0
20170403-ccc_help_script,2017/04/03,ccc_help_script,31,26,00:00:16,16,00:01:35,5,416
20170403-ccc_link_script,2017/04/03,ccc_link_script,0,0,00:00:00,0,00:00:00,0,0
20170403-ccc_media_line_script,2017/04/03,ccc_media_line_script,0,0,00:00:00,0,00:00:00,0,0
20170403-ccc_priority_script,2017/04/03,ccc_priority_script,18,17,00:00:12,12,00:00:33,1,204
20170403-ccc_tax_script,2017/04/03,ccc_tax_script,21,20,00:04:27,267,00:07:19,1,5340
20170403-ccc_waste_recycling_script,2017/04/03,ccc_waste_recycling_script,0,0,00:00:00,0,00:00:00,0,0
20170404-ccc_311_calgary_script,2017/04/04,ccc_311_calgary_script,3421,2889,00:02:32,152,00:13:42,532,439128
20170404-ccc_311_lobby_ph_script,2017/04/04,ccc_311_lobby_ph_script,2,2,00:00:11,11,00:00:18,0,22
20170404-ccc_aserv_info_script,2017/04/04,ccc_aserv_info_script,0,0,00:00:00,0,00:00:00,0,0
20170404-ccc_bylaw_script,2017/04/04,ccc_bylaw_script,0,0,00:00:00,0,00:00:00,0,0
20170404-ccc_city_script,2017/04/04,ccc_city_script,9,9,00:00:21,21,00:01:16,0,189
20170404-ccc_cty_online_script,2017/04/04,ccc_cty_online_script,0,0,00:00:00,0,00:00:00,0,0
20170404-ccc_feedback_script,2017/04/04,ccc_feedback_script,1,0,00:00:00,0,00:00:00,0,0
20170404-ccc_fpb_script,2017/04/04,ccc_fpb_script,3,1,00:00:07,7,00:00:07,2,7
20170404-ccc_help_script,2017/04/04,ccc_help_script,33,27,00:00:15,15,00:00:52,6,405
20170404-ccc_link_script,2017/04/04,ccc_link_script,0,0,00:00:00,0,00:00:00,0,0
20170404-ccc_media_line_script,2017/04/04,ccc_media_line_script,0,0,00:00:00,0,00:00:00,0,0
20170404-ccc_priority_script,2017/04/04,ccc_priority_script,25,24,00:00:13,13,00:00:40,1,312
20170404-ccc_tax_script,2017/04/04,ccc_tax_script,19,15,00:02:17,137,00:05:54,4,2055
20170404-ccc_waste_recycling_script,2017/04/04,ccc_waste_recycling_script,0,0,00:00:00,0,00:00:00,0,0
20170405-ccc_311_calgary_script,2017/04/05,ccc_311_calgary_script,3585,3007,00:02:41,161,00:11:42,578,484127
20170405-ccc_311_lobby_ph_script,2017/04/05,ccc_311_lobby_ph_script,2,2,00:00:32,32,00:00:47,0,64
20170405-ccc_aserv_info_script,2017/04/05,ccc_aserv_info_script,0,0,00:00:00,0,00:00:00,0,0
20170405-ccc_bylaw_script,2017/04/05,ccc_bylaw_script,0,0,00:00:00,0,00:00:00,0,0
20170405-ccc_city_script,2017/04/05,ccc_city_script,19,19,00:01:11,71,00:07:33,0,1349
20170405-ccc_cty_online_script,2017/04/05,ccc_cty_online_script,0,0,00:00:00,0,00:00:00,0,0
20170405-ccc_feedback_script,2017/04/05,ccc_feedback_script,0,0,00:00:00,0,00:00:00,0,0
20170405-ccc_fpb_script,2017/04/05,ccc_fpb_script,3,3,00:03:17,197,00:05:38,0,591
20170405-ccc_help_script,2017/04/05,ccc_help_script,27,26,00:00:16,16,00:01:00,1,416
20170405-ccc_link_script,2017/04/05,ccc_link_script,0,0,00:00:00,0,00:00:00,0,0
20170405-ccc_media_line_script,2017/04/05,ccc_media_line_script,0,0,00:00:00,0,00:00:00,0,0
20170405-ccc_priority_script,2017/04/05,ccc_priority_script,32,29,00:00:16,16,00:01:58,3,464
20170405-ccc_tax_script,2017/04/05,ccc_tax_script,27,20,00:02:43,163,00:11:01,7,3260
20170405-ccc_waste_recycling_script,2017/04/05,ccc_waste_recycling_script,0,0,00:00:00,0,00:00:00,0,0
20170406-ccc_311_calgary_script,2017/04/06,ccc_311_calgary_script,3163,3013,00:00:44,44,00:05:30,150,132572
20170406-ccc_311_lobby_ph_script,2017/04/06,ccc_311_lobby_ph_script,2,1,00:00:04,4,00:00:04,1,4
20170406-ccc_aserv_info_script,2017/04/06,ccc_aserv_info_script,0,0,00:00:00,0,00:00:00,0,0
20170406-ccc_bylaw_script,2017/04/06,ccc_bylaw_script,0,0,00:00:00,0,00:00:00,0,0
20170406-ccc_city_script,2017/04/06,ccc_city_script,11,10,00:00:23,23,00:00:58,1,230
20170406-ccc_cty_online_script,2017/04/06,ccc_cty_online_script,0,0,00:00:00,0,00:00:00,0,0
20170406-ccc_feedback_script,2017/04/06,ccc_feedback_script,0,0,00:00:00,0,00:00:00,0,0
20170406-ccc_fpb_script,2017/04/06,ccc_fpb_script,1,1,00:00:02,2,00:00:02,0,2
20170406-ccc_help_script,2017/04/06,ccc_help_script,32,29,00:00:12,12,00:00:41,3,348
20170406-ccc_link_script,2017/04/06,ccc_link_script,0,0,00:00:00,0,00:00:00,0,0
20170406-ccc_media_line_script,2017/04/06,ccc_media_line_script,2,1,00:00:02,2,00:00:02,1,2
20170406-ccc_priority_script,2017/04/06,ccc_priority_script,32,32,00:00:08,8,00:00:39,0,256
20170406-ccc_tax_script,2017/04/06,ccc_tax_script,22,21,00:00:19,19,00:02:38,1,399
20170406-ccc_waste_recycling_script,2017/04/06,ccc_waste_recycling_script,0,0,00:00:00,0,00:00:00,0,0
20170407-ccc_311_calgary_script,2017/04/07,ccc_311_calgary_script,2863,2759,00:00:40,40,00:04:43,104,110360
20170407-ccc_311_lobby_ph_script,2017/04/07,ccc_311_lobby_ph_script,1,1,00:00:05,5,00:00:05,0,5
20170407-ccc_aserv_info_script,2017/04/07,ccc_aserv_info_script,0,0,00:00:00,0,00:00:00,0,0
20170407-ccc_bylaw_script,2017/04/07,ccc_bylaw_script,0,0,00:00:00,0,00:00:00,0,0
20170407-ccc_city_script,2017/04/07,ccc_city_script,16,16,00:00:20,20,00:01:17,0,320
20170407-ccc_cty_online_script,2017/04/07,ccc_cty_online_script,0,0,00:00:00,0,00:00:00,0,0
20170407-ccc_feedback_script,2017/04/07,ccc_feedback_script,0,0,00:00:00,0,00:00:00,0,0
20170407-ccc_fpb_script,2017/04/07,ccc_fpb_script,0,0,00:00:00,0,00:00:00,0,0
20170407-ccc_help_script,2017/04/07,ccc_help_script,18,17,00:00:12,12,00:00:42,1,204
20170407-ccc_link_script,2017/04/07,ccc_link_script,0,0,00:00:00,0,00:00:00,0,0
20170407-ccc_media_line_script,2017/04/07,ccc_media_line_script,0,0,00:00:00,0,00:00:00,0,0
20170407-ccc_priority_script,2017/04/07,ccc_priority_script,29,27,00:00:09,9,00:00:32,2,243
20170407-ccc_tax_script,2017/04/07,ccc_tax_script,28,28,00:00:24,24,00:03:00,0,672
20170407-ccc_waste_recycling_script,2017/04/07,ccc_waste_recycling_script,0,0,00:00:00,0,00:00:00,0,0
20170408-ccc_311_calgary_script,2017/04/08,ccc_311_calgary_script,1314,1196,00:00:56,56,00:10:25,118,66976
20170408-ccc_311_lobby_ph_script,2017/04/08,ccc_311_lobby_ph_script,0,0,00:00:00,0,00:00:00,0,0
20170408-ccc_aserv_info_script,2017/04/08,ccc_aserv_info_script,0,0,00:00:00,0,00:00:00,0,0
20170408-ccc_bylaw_script,2017/04/08,ccc_bylaw_script,0,0,00:00:00,0,00:00:00,0,0
20170408-ccc_city_script,2017/04/08,ccc_city_script,0,0,00:00:00,0,00:00:00,0,0
20170408-ccc_cty_online_script,2017/04/08,ccc_cty_online_script,0,0,00:00:00,0,00:00:00,0,0
20170408-ccc_feedback_script,2017/04/08,ccc_feedback_script,0,0,00:00:00,0,00:00:00,0,0
20170408-ccc_fpb_script,2017/04/08,ccc_fpb_script,0,0,00:00:00,0,00:00:00,0,0
20170408-ccc_help_script,2017/04/08,ccc_help_script,4,4,00:00:16,16,00:00:53,0,64
20170408-ccc_link_script,2017/04/08,ccc_link_script,0,0,00:00:00,0,00:00:00,0,0
20170408-ccc_media_line_script,2017/04/08,ccc_media_line_script,1,1,00:00:53,53,00:00:53,0,53
20170408-ccc_priority_script,2017/04/08,ccc_priority_script,20,19,00:00:14,14,00:00:57,1,266
20170408-ccc_tax_script,2017/04/08,ccc_tax_script,2,2,00:01:04,64,00:02:05,0,128
20170408-ccc_waste_recycling_script,2017/04/08,ccc_waste_recycling_script,0,0,00:00:00,0,00:00:00,0,0
20170409-ccc_311_calgary_script,2017/04/09,ccc_311_calgary_script,871,830,00:00:37,37,00:07:52,41,30710
20170409-ccc_311_lobby_ph_script,2017/04/09,ccc_311_lobby_ph_script,0,0,00:00:00,0,00:00:00,0,0
20170409-ccc_aserv_info_script,2017/04/09,ccc_aserv_info_script,0,0,00:00:00,0,00:00:00,0,0
20170409-ccc_bylaw_script,2017/04/09,ccc_bylaw_script,0,0,00:00:00,0,00:00:00,0,0
20170409-ccc_city_script,2017/04/09,ccc_city_script,0,0,00:00:00,0,00:00:00,0,0
20170409-ccc_cty_online_script,2017/04/09,ccc_cty_online_script,0,0,00:00:00,0,00:00:00,0,0
20170409-ccc_feedback_script,2017/04/09,ccc_feedback_script,0,0,00:00:00,0,00:00:00,0,0
20170409-ccc_fpb_script,2017/04/09,ccc_fpb_script,2,2,00:00:26,26,00:00:39,0,52
20170409-ccc_help_script,2017/04/09,ccc_help_script,4,4,00:00:05,5,00:00:08,0,20
20170409-ccc_link_script,2017/04/09,ccc_link_script,0,0,00:00:00,0,00:00:00,0,0
20170409-ccc_media_line_script,2017/04/09,ccc_media_line_script,0,0,00:00:00,0,00:00:00,0,0
20170409-ccc_priority_script,2017/04/09,ccc_priority_script,12,12,00:00:12,12,00:00:35,0,144
20170409-ccc_tax_script,2017/04/09,ccc_tax_script,0,0,00:00:00,0,00:00:00,0,0
20170409-ccc_waste_recycling_script,2017/04/09,ccc_waste_recycling_script,0,0,00:00:00,0,00:00:00,0,0
20170410-ccc_311_calgary_script,2017/04/10,ccc_311_calgary_script,3533,3332,00:01:00,60,00:05:50,201,199920
20170410-ccc_311_lobby_ph_script,2017/04/10,ccc_311_lobby_ph_script,1,1,00:00:04,4,00:00:04,0,4
20170410-ccc_aserv_info_script,2017/04/10,ccc_aserv_info_script,0,0,00:00:00,0,00:00:00,0,0
20170410-ccc_bylaw_script,2017/04/10,ccc_bylaw_script,0,0,00:00:00,0,00:00:00,0,0
20170410-ccc_city_script,2017/04/10,ccc_city_script,18,18,00:00:21,21,00:02:01,0,378
20170410-ccc_cty_online_script,2017/04/10,ccc_cty_online_script,0,0,00:00:00,0,00:00:00,0,0
20170410-ccc_feedback_script,2017/04/10,ccc_feedback_script,0,0,00:00:00,0,00:00:00,0,0
20170410-ccc_fpb_script,2017/04/10,ccc_fpb_script,2,2,00:00:32,32,00:00:59,0,64
20170410-ccc_help_script,2017/04/10,ccc_help_script,7,7,00:00:09,9,00:00:21,0,63
20170410-ccc_link_script,2017/04/10,ccc_link_script,0,0,00:00:00,0,00:00:00,0,0
20170410-ccc_media_line_script,2017/04/10,ccc_media_line_script,1,1,00:00:03,3,00:00:03,0,3
20170410-ccc_priority_script,2017/04/10,ccc_priority_script,24,24,00:00:08,8,00:00:18,0,192
20170410-ccc_tax_script,2017/04/10,ccc_tax_script,17,16,00:01:23,83,00:04:57,1,1328
20170410-ccc_waste_recycling_script,2017/04/10,ccc_waste_recycling_script,0,0,00:00:00,0,00:00:00,0,0
20170411-ccc_311_calgary_script,2017/04/11,ccc_311_calgary_script,3266,2820,00:02:18,138,00:08:16,446,389160
20170411-ccc_311_lobby_ph_script,2017/04/11,ccc_311_lobby_ph_script,2,2,00:00:13,13,00:00:21,0,26
20170411-ccc_aserv_info_script,2017/04/11,ccc_aserv_info_script,0,0,00:00:00,0,00:00:00,0,0
20170411-ccc_bylaw_script,2017/04/11,ccc_bylaw_script,0,0,00:00:00,0,00:00:00,0,0
20170411-ccc_city_script,2017/04/11,ccc_city_script,20,19,00:00:26,26,00:02:01,1,494
20170411-ccc_cty_online_script,2017/04/11,ccc_cty_online_script,0,0,00:00:00,0,00:00:00,0,0
20170411-ccc_feedback_script,2017/04/11,ccc_feedback_script,0,0,00:00:00,0,00:00:00,0,0
20170411-ccc_fpb_script,2017/04/11,ccc_fpb_script,1,1,00:03:52,232,00:03:52,0,232
20170411-ccc_help_script,2017/04/11,ccc_help_script,30,28,00:00:12,12,00:00:38,2,336
20170411-ccc_link_script,2017/04/11,ccc_link_script,0,0,00:00:00,0,00:00:00,0,0
20170411-ccc_media_line_script,2017/04/11,ccc_media_line_script,0,0,00:00:00,0,00:00:00,0,0
20170411-ccc_priority_script,2017/04/11,ccc_priority_script,20,20,00:00:15,15,00:02:09,0,300
20170411-ccc_tax_script,2017/04/11,ccc_tax_script,29,26,00:02:27,147,00:07:38,3,3822
20170411-ccc_waste_recycling_script,2017/04/11,ccc_waste_recycling_script,0,0,00:00:00,0,00:00:00,0,0
20170412-ccc_311_calgary_script,2017/04/12,ccc_311_calgary_script,3064,2953,00:00:28,28,00:04:10,111,82684
20170412-ccc_311_lobby_ph_script,2017/04/12,ccc_311_lobby_ph_script,6,3,00:00:04,4,00:00:07,3,12
20170412-ccc_aserv_info_script,2017/04/12,ccc_aserv_info_script,0,0,00:00:00,0,00:00:00,0,0
20170412-ccc_bylaw_script,2017/04/12,ccc_bylaw_script,0,0,00:00:00,0,00:00:00,0,0
20170412-ccc_city_script,2017/04/12,ccc_city_script,16,16,00:00:12,12,00:00:43,0,192
20170412-ccc_cty_online_script,2017/04/12,ccc_cty_online_script,0,0,00:00:00,0,00:00:00,0,0
20170412-ccc_feedback_script,2017/04/12,ccc_feedback_script,0,0,00:00:00,0,00:00:00,0,0
20170412-ccc_fpb_script,2017/04/12,ccc_fpb_script,1,0,00:00:00,0,00:00:00,1,0
20170412-ccc_help_script,2017/04/12,ccc_help_script,23,20,00:00:08,8,00:00:29,3,160
20170412-ccc_link_script,2017/04/12,ccc_link_script,0,0,00:00:00,0,00:00:00,0,0
20170412-ccc_media_line_script,2017/04/12,ccc_media_line_script,0,0,00:00:00,0,00:00:00,0,0
20170412-ccc_priority_script,2017/04/12,ccc_priority_script,21,21,00:00:08,8,00:00:29,0,168
20170412-ccc_tax_script,2017/04/12,ccc_tax_script,22,22,00:00:34,34,00:02:27,0,748
20170412-ccc_waste_recycling_script,2017/04/12,ccc_waste_recycling_script,0,0,00:00:00,0,00:00:00,0,0
20170413-ccc_311_calgary_script,2017/04/13,ccc_311_calgary_script,2959,2872,00:00:24,24,00:04:41,87,68928
20170413-ccc_311_lobby_ph_script,2017/04/13,ccc_311_lobby_ph_script,5,5,00:00:05,5,00:00:06,0,25
20170413-ccc_aserv_info_script,2017/04/13,ccc_aserv_info_script,0,0,00:00:00,0,00:00:00,0,0
20170413-ccc_bylaw_script,2017/04/13,ccc_bylaw_script,0,0,00:00:00,0,00:00:00,0,0
20170413-ccc_city_script,2017/04/13,ccc_city_script,12,12,00:00:09,9,00:00:14,0,108
20170413-ccc_cty_online_script,2017/04/13,ccc_cty_online_script,0,0,00:00:00,0,00:00:00,0,0
20170413-ccc_feedback_script,2017/04/13,ccc_feedback_script,0,0,00:00:00,0,00:00:00,0,0
20170413-ccc_fpb_script,2017/04/13,ccc_fpb_script,2,2,00:00:10,10,00:00:10,0,20
20170413-ccc_help_script,2017/04/13,ccc_help_script,26,25,00:00:08,8,00:00:40,1,200
20170413-ccc_link_script,2017/04/13,ccc_link_script,0,0,00:00:00,0,00:00:00,0,0
20170413-ccc_media_line_script,2017/04/13,ccc_media_line_script,2,2,00:00:04,4,00:00:06,0,8
20170413-ccc_priority_script,2017/04/13,ccc_priority_script,33,31,00:00:08,8,00:00:23,2,248
20170413-ccc_tax_script,2017/04/13,ccc_tax_script,21,21,00:00:25,25,00:02:32,0,525
20170413-ccc_waste_recycling_script,2017/04/13,ccc_waste_recycling_script,0,0,00:00:00,0,00:00:00,0,0
20170414-ccc_311_calgary_script,2017/04/14,ccc_311_calgary_script,1407,1376,00:00:18,18,00:08:00,31,24768
20170414-ccc_311_lobby_ph_script,2017/04/14,ccc_311_lobby_ph_script,0,0,00:00:00,0,00:00:00,0,0
20170414-ccc_aserv_info_script,2017/04/14,ccc_aserv_info_script,0,0,00:00:00,0,00:00:00,0,0
20170414-ccc_bylaw_script,2017/04/14,ccc_bylaw_script,0,0,00:00:00,0,00:00:00,0,0
20170414-ccc_city_script,2017/04/14,ccc_city_script,0,0,00:00:00,0,00:00:00,0,0
20170414-ccc_cty_online_script,2017/04/14,ccc_cty_online_script,0,0,00:00:00,0,00:00:00,0,0
20170414-ccc_feedback_script,2017/04/14,ccc_feedback_script,1,0,00:00:00,0,00:00:00,0,0
20170414-ccc_fpb_script,2017/04/14,ccc_fpb_script,0,0,00:00:00,0,00:00:00,0,0
20170414-ccc_help_script,2017/04/14,ccc_help_script,11,10,00:00:10,10,00:00:46,1,100
20170414-ccc_link_script,2017/04/14,ccc_link_script,0,0,00:00:00,0,00:00:00,0,0
20170414-ccc_media_line_script,2017/04/14,ccc_media_line_script,0,0,00:00:00,0,00:00:00,0,0
20170414-ccc_priority_script,2017/04/14,ccc_priority_script,18,17,00:00:07,7,00:00:15,1,119
20170414-ccc_tax_script,2017/04/14,ccc_tax_script,0,0,00:00:00,0,00:00:00,0,0
20170414-ccc_waste_recycling_script,2017/04/14,ccc_waste_recycling_script,0,0,00:00:00,0,00:00:00,0,0
20170415-ccc_311_calgary_script,2017/04/15,ccc_311_calgary_script,1060,1026,00:00:19,19,00:03:13,34,19494
20170415-ccc_311_lobby_ph_script,2017/04/15,ccc_311_lobby_ph_script,0,0,00:00:00,0,00:00:00,0,0
20170415-ccc_aserv_info_script,2017/04/15,ccc_aserv_info_script,0,0,00:00:00,0,00:00:00,0,0
20170415-ccc_bylaw_script,2017/04/15,ccc_bylaw_script,0,0,00:00:00,0,00:00:00,0,0
20170415-ccc_city_script,2017/04/15,ccc_city_script,0,0,00:00:00,0,00:00:00,0,0
20170415-ccc_cty_online_script,2017/04/15,ccc_cty_online_script,0,0,00:00:00,0,00:00:00,0,0
20170415-ccc_feedback_script,2017/04/15,ccc_feedback_script,0,0,00:00:00,0,00:00:00,0,0
20170415-ccc_fpb_script,2017/04/15,ccc_fpb_script,1,1,00:00:06,6,00:00:06,0,6
20170415-ccc_help_script,2017/04/15,ccc_help_script,4,3,00:00:30,30,00:01:17,1,90
20170415-ccc_link_script,2017/04/15,ccc_link_script,0,0,00:00:00,0,00:00:00,0,0
20170415-ccc_media_line_script,2017/04/15,ccc_media_line_script,1,1,00:00:05,5,00:00:05,0,5
20170415-ccc_priority_script,2017/04/15,ccc_priority_script,22,22,00:00:12,12,00:01:40,0,264
20170415-ccc_tax_script,2017/04/15,ccc_tax_script,0,0,00:00:00,0,00:00:00,0,0
20170415-ccc_waste_recycling_script,2017/04/15,ccc_waste_recycling_script,0,0,00:00:00,0,00:00:00,0,0
20170416-ccc_311_calgary_script,2017/04/16,ccc_311_calgary_script,872,846,00:00:19,19,00:07:04,26,16074
20170416-ccc_311_lobby_ph_script,2017/04/16,ccc_311_lobby_ph_script,0,0,00:00:00,0,00:00:00,0,0
20170416-ccc_aserv_info_script,2017/04/16,ccc_aserv_info_script,0,0,00:00:00,0,00:00:00,0,0
20170416-ccc_bylaw_script,2017/04/16,ccc_bylaw_script,0,0,00:00:00,0,00:00:00,0,0
20170416-ccc_city_script,2017/04/16,ccc_city_script,0,0,00:00:00,0,00:00:00,0,0
20170416-ccc_cty_online_script,2017/04/16,ccc_cty_online_script,0,0,00:00:00,0,00:00:00,0,0
20170416-ccc_feedback_script,2017/04/16,ccc_feedback_script,0,0,00:00:00,0,00:00:00,0,0
20170416-ccc_fpb_script,2017/04/16,ccc_fpb_script,1,1,00:00:03,3,00:00:03,0,3
20170416-ccc_help_script,2017/04/16,ccc_help_script,7,6,00:00:04,4,00:00:07,1,24
20170416-ccc_link_script,2017/04/16,ccc_link_script,0,0,00:00:00,0,00:00:00,0,0
20170416-ccc_media_line_script,2017/04/16,ccc_media_line_script,4,4,00:00:03,3,00:00:05,0,12
20170416-ccc_priority_script,2017/04/16,ccc_priority_script,14,14,00:00:15,15,00:02:17,0,210
20170416-ccc_tax_script,2017/04/16,ccc_tax_script,0,0,00:00:00,0,00:00:00,0,0
20170416-ccc_waste_recycling_script,2017/04/16,ccc_waste_recycling_script,0,0,00:00:00,0,00:00:00,0,0
20170417-ccc_311_calgary_script,2017/04/17,ccc_311_calgary_script,3166,3057,00:00:28,28,00:04:51,109,85596
20170417-ccc_311_lobby_ph_script,2017/04/17,ccc_311_lobby_ph_script,1,1,00:00:06,6,00:00:06,0,6
20170417-ccc_aserv_info_script,2017/04/17,ccc_aserv_info_script,0,0,00:00:00,0,00:00:00,0,0
20170417-ccc_bylaw_script,2017/04/17,ccc_bylaw_script,0,0,00:00:00,0,00:00:00,0,0
20170417-ccc_city_script,2017/04/17,ccc_city_script,13,13,00:00:13,13,00:00:38,0,169
20170417-ccc_cty_online_script,2017/04/17,ccc_cty_online_script,0,0,00:00:00,0,00:00:00,0,0
20170417-ccc_feedback_script,2017/04/17,ccc_feedback_script,0,0,00:00:00,0,00:00:00,0,0
20170417-ccc_fpb_script,2017/04/17,ccc_fpb_script,3,3,00:00:05,5,00:00:08,0,15
20170417-ccc_help_script,2017/04/17,ccc_help_script,15,15,00:00:08,8,00:00:17,0,120
20170417-ccc_link_script,2017/04/17,ccc_link_script,0,0,00:00:00,0,00:00:00,0,0
20170417-ccc_media_line_script,2017/04/17,ccc_media_line_script,1,1,00:00:04,4,00:00:04,0,4
20170417-ccc_priority_script,2017/04/17,ccc_priority_script,36,36,00:00:11,11,00:02:03,0,396
20170417-ccc_tax_script,2017/04/17,ccc_tax_script,2,2,00:00:48,48,00:01:22,0,96
20170417-ccc_waste_recycling_script,2017/04/17,ccc_waste_recycling_script,0,0,00:00:00,0,00:00:00,0,0
20170418-ccc_311_calgary_script,2017/04/18,ccc_311_calgary_script,3357,3207,00:00:37,37,00:07:08,150,118659
20170418-ccc_311_lobby_ph_script,2017/04/18,ccc_311_lobby_ph_script,5,5,00:00:07,7,00:00:18,0,35
20170418-ccc_aserv_info_script,2017/04/18,ccc_aserv_info_script,0,0,00:00:00,0,00:00:00,0,0
20170418-ccc_bylaw_script,2017/04/18,ccc_bylaw_script,0,0,00:00:00,0,00:00:00,0,0
20170418-ccc_city_script,2017/04/18,ccc_city_script,12,12,00:00:13,13,00:00:31,0,156
20170418-ccc_cty_online_script,2017/04/18,ccc_cty_online_script,0,0,00:00:00,0,00:00:00,0,0
20170418-ccc_feedback_script,2017/04/18,ccc_feedback_script,0,0,00:00:00,0,00:00:00,0,0
20170418-ccc_fpb_script,2017/04/18,ccc_fpb_script,4,4,00:00:18,18,00:00:51,0,72
20170418-ccc_help_script,2017/04/18,ccc_help_script,23,22,00:00:12,12,00:01:00,1,264
20170418-ccc_link_script,2017/04/18,ccc_link_script,0,0,00:00:00,0,00:00:00,0,0
20170418-ccc_media_line_script,2017/04/18,ccc_media_line_script,2,2,00:00:03,3,00:00:03,0,6
20170418-ccc_priority_script,2017/04/18,ccc_priority_script,30,30,00:00:13,13,00:01:53,0,390
20170418-ccc_tax_script,2017/04/18,ccc_tax_script,20,20,00:00:51,51,00:02:28,0,1020
20170418-ccc_waste_recycling_script,2017/04/18,ccc_waste_recycling_script,0,0,00:00:00,0,00:00:00,0,0
20170419-ccc_311_calgary_script,2017/04/19,ccc_311_calgary_script,3243,3051,00:00:48,48,00:10:15,192,146448
20170419-ccc_311_lobby_ph_script,2017/04/19,ccc_311_lobby_ph_script,6,5,00:00:08,8,00:00:15,1,40
20170419-ccc_aserv_info_script,2017/04/19,ccc_aserv_info_script,0,0,00:00:00,0,00:00:00,0,0
20170419-ccc_bylaw_script,2017/04/19,ccc_bylaw_script,0,0,00:00:00,0,00:00:00,0,0
20170419-ccc_city_script,2017/04/19,ccc_city_script,9,9,00:00:14,14,00:00:30,0,126
20170419-ccc_cty_online_script,2017/04/19,ccc_cty_online_script,0,0,00:00:00,0,00:00:00,0,0
20170419-ccc_feedback_script,2017/04/19,ccc_feedback_script,0,0,00:00:00,0,00:00:00,0,0
20170419-ccc_fpb_script,2017/04/19,ccc_fpb_script,2,1,00:00:02,2,00:00:02,1,2
20170419-ccc_help_script,2017/04/19,ccc_help_script,23,21,00:00:28,28,00:03:21,2,588
20170419-ccc_link_script,2017/04/19,ccc_link_script,0,0,00:00:00,0,00:00:00,0,0
20170419-ccc_media_line_script,2017/04/19,ccc_media_line_script,2,2,00:00:29,29,00:00:33,0,58
20170419-ccc_priority_script,2017/04/19,ccc_priority_script,27,26,00:00:07,7,00:00:21,1,182
20170419-ccc_tax_script,2017/04/19,ccc_tax_script,22,17,00:00:30,30,00:02:17,5,510
20170419-ccc_waste_recycling_script,2017/04/19,ccc_waste_recycling_script,0,0,00:00:00,0,00:00:00,0,0
2017-04-20-ccc_fpb_script,2017/04/20,ccc_fpb_script,1,1,00:00:04,4,00:00:04,0,4
2017-04-20-ccc_help_script,2017/04/20,ccc_help_script,15,13,00:00:13,13,00:00:30,2,169
2017-04-20-ccc_link_script,2017/04/20,ccc_link_script,0,0,00:00:00,0,00:00:00,0,0
2017-04-20-ccc_media_line_script,2017/04/20,ccc_media_line_script,6,6,00:00:11,11,00:00:28,0,66
2017-04-20-ccc_priority_script,2017/04/20,ccc_priority_script,43,42,00:00:13,13,00:02:33,1,546
2017-04-20-ccc_tax_script,2017/04/20,ccc_tax_script,27,26,00:00:39,39,00:03:09,1,1014
2017-04-20-ccc_waste_recycling_script,2017/04/20,ccc_waste_recycling_script,0,0,00:00:00,0,00:00:00,0,0
2017-04-21-ccc_311_calgary_script,2017/04/21,ccc_311_calgary_script,3225,3037,00:00:52,52,00:07:27,188,157924
2017-04-21-ccc_311_lobby_ph_script,2017/04/21,ccc_311_lobby_ph_script,2,1,00:00:11,11,00:00:11,1,11
2017-04-21-ccc_aserv_info_script,2017/04/21,ccc_aserv_info_script,0,0,00:00:00,0,00:00:00,0,0
2017-04-21-ccc_bylaw_script,2017/04/21,ccc_bylaw_script,0,0,00:00:00,0,00:00:00,0,0
2017-04-21-ccc_city_script,2017/04/21,ccc_city_script,17,12,00:00:28,28,00:02:26,5,336
2017-04-21-ccc_cty_online_script,2017/04/21,ccc_cty_online_script,0,0,00:00:00,0,00:00:00,0,0
2017-04-21-ccc_feedback_script,2017/04/21,ccc_feedback_script,1,0,00:00:00,0,00:00:00,0,0
2017-04-22-ccc_311_calgary_script,2017/04/22,ccc_311_calgary_script,1593,1493,00:00:39,39,00:10:23,100,58227
2017-04-22-ccc_311_lobby_ph_script,2017/04/22,ccc_311_lobby_ph_script,0,0,00:00:00,0,00:00:00,0,0
2017-04-22-ccc_aserv_info_script,2017/04/22,ccc_aserv_info_script,0,0,00:00:00,0,00:00:00,0,0
2017-04-22-ccc_bylaw_script,2017/04/22,ccc_bylaw_script,0,0,00:00:00,0,00:00:00,0,0
2017-04-22-ccc_city_script,2017/04/22,ccc_city_script,0,0,00:00:00,0,00:00:00,0,0
2017-04-22-ccc_cty_online_script,2017/04/22,ccc_cty_online_script,0,0,00:00:00,0,00:00:00,0,0
2017-04-22-ccc_feedback_script,2017/04/22,ccc_feedback_script,0,0,00:00:00,0,00:00:00,0,0
2017-04-22-ccc_fpb_script,2017/04/22,ccc_fpb_script,4,4,00:00:13,13,00:00:24,0,52
2017-04-22-ccc_help_script,2017/04/22,ccc_help_script,9,9,00:00:09,9,00:00:25,0,81
2017-04-22-ccc_link_script,2017/04/22,ccc_link_script,0,0,00:00:00,0,00:00:00,0,0
2017-04-22-ccc_media_line_script,2017/04/22,ccc_media_line_script,2,2,00:00:41,41,00:00:51,0,82
2017-04-22-ccc_priority_script,2017/04/22,ccc_priority_script,16,15,00:00:11,11,00:00:43,1,165
2017-04-22-ccc_tax_script,2017/04/22,ccc_tax_script,1,1,00:00:43,43,00:00:43,0,43
2017-04-22-ccc_waste_recycling_script,2017/04/22,ccc_waste_recycling_script,0,0,00:00:00,0,00:00:00,0,0
2017-04-23-ccc_help_script,2017/04/23,ccc_help_script,12,10,00:00:25,25,00:03:02,2,250
2017-04-23-ccc_link_script,2017/04/23,ccc_link_script,0,0,00:00:00,0,00:00:00,0,0
2017-04-23-ccc_media_line_script,2017/04/23,ccc_media_line_script,1,1,00:00:04,4,00:00:04,0,4
2017-04-23-ccc_priority_script,2017/04/23,ccc_priority_script,17,17,00:00:27,27,00:01:47,0,459
2017-04-23-ccc_tax_script,2017/04/23,ccc_tax_script,0,0,00:00:00,0,00:00:00,0,0
2017-04-23-ccc_waste_recycling_script,2017/04/23,ccc_waste_recycling_script,0,0,00:00:00,0,00:00:00,0,0
2017-04-24-ccc_311_calgary_script,2017/04/24,ccc_311_calgary_script,3441,3313,00:00:34,34,00:05:14,128,112642
2017-04-24-ccc_311_lobby_ph_script,2017/04/24,ccc_311_lobby_ph_script,3,3,00:00:11,11,00:00:21,0,33
2017-04-24-ccc_aserv_info_script,2017/04/24,ccc_aserv_info_script,0,0,00:00:00,0,00:00:00,0,0
2017-04-24-ccc_bylaw_script,2017/04/24,ccc_bylaw_script,0,0,00:00:00,0,00:00:00,0,0
2017-04-24-ccc_city_script,2017/04/24,ccc_city_script,13,13,00:00:12,12,00:00:29,0,156
2017-04-24-ccc_cty_online_script,2017/04/24,ccc_cty_online_script,0,0,00:00:00,0,00:00:00,0,0
2017-04-24-ccc_feedback_script,2017/04/24,ccc_feedback_script,0,0,00:00:00,0,00:00:00,0,0
2017-04-24-ccc_fpb_script,2017/04/24,ccc_fpb_script,1,1,00:00:09,9,00:00:09,0,9
2017-04-25-ccc_311_lobby_ph_script,2017/04/25,ccc_311_lobby_ph_script,4,3,00:00:04,4,00:00:06,1,12
2017-04-25-ccc_aserv_info_script,2017/04/25,ccc_aserv_info_script,0,0,00:00:00,0,00:00:00,0,0
2017-04-25-ccc_bylaw_script,2017/04/25,ccc_bylaw_script,0,0,00:00:00,0,00:00:00,0,0
2017-04-25-ccc_city_script,2017/04/25,ccc_city_script,18,18,00:00:10,10,00:00:31,0,180
2017-04-25-ccc_cty_online_script,2017/04/25,ccc_cty_online_script,0,0,00:00:00,0,00:00:00,0,0
2017-04-25-ccc_feedback_script,2017/04/25,ccc_feedback_script,0,0,00:00:00,0,00:00:00,0,0
2017-04-25-ccc_fpb_script,2017/04/25,ccc_fpb_script,1,1,00:00:04,4,00:00:04,0,4
2017-04-25-ccc_help_script,2017/04/25,ccc_help_script,25,25,00:00:11,11,00:00:57,0,275
2017-04-25-ccc_link_script,2017/04/25,ccc_link_script,0,0,00:00:00,0,00:00:00,0,0
2017-04-25-ccc_media_line_script,2017/04/25,ccc_media_line_script,1,1,00:00:42,42,00:00:42,0,42
2017-04-25-ccc_priority_script,2017/04/25,ccc_priority_script,30,30,00:00:07,7,00:00:33,0,210
2017-04-25-ccc_tax_script,2017/04/25,ccc_tax_script,22,21,00:00:18,18,00:01:53,1,378
2017-04-25-ccc_waste_recycling_script,2017/04/25,ccc_waste_recycling_script,0,0,00:00:00,0,00:00:00,0,0
2017-04-26-ccc_link_script,2017/04/26,ccc_link_script,0,0,00:00:00,0,00:00:00,0,0
2017-04-26-ccc_media_line_script,2017/04/26,ccc_media_line_script,1,1,00:00:04,4,00:00:04,0,4
2017-04-26-ccc_priority_script,2017/04/26,ccc_priority_script,14,14,00:00:10,10,00:00:35,0,140
2017-04-26-ccc_tax_script,2017/04/26,ccc_tax_script,21,16,00:02:46,166,00:06:13,5,2656
2017-04-26-ccc_waste_recycling_script,2017/04/26,ccc_waste_recycling_script,0,0,00:00:00,0,00:00:00,0,0
2017-04-27-ccc_311_calgary_script,2017/04/27,ccc_311_calgary_script,3148,2963,00:00:51,51,00:06:10,185,151113
2017-04-27-ccc_311_lobby_ph_script,2017/04/27,ccc_311_lobby_ph_script,2,2,00:00:07,7,00:00:08,0,14
2017-04-27-ccc_aserv_info_script,2017/04/27,ccc_aserv_info_script,0,0,00:00:00,0,00:00:00,0,0
2017-04-27-ccc_bylaw_script,2017/04/27,ccc_bylaw_script,0,0,00:00:00,0,00:00:00,0,0
2017-04-27-ccc_city_script,2017/04/27,ccc_city_script,13,13,00:00:20,20,00:01:04,0,260
2017-04-28-ccc_aserv_info_script,2017/04/28,ccc_aserv_info_script,0,0,00:00:00,0,00:00:00,0,0
2017-04-28-ccc_bylaw_script,2017/04/28,ccc_bylaw_script,0,0,00:00:00,0,00:00:00,0,0
2017-04-28-ccc_city_script,2017/04/28,ccc_city_script,24,23,00:00:36,36,00:03:58,1,828
2017-04-28-ccc_cty_online_script,2017/04/28,ccc_cty_online_script,0,0,00:00:00,0,00:00:00,0,0
2017-04-28-ccc_feedback_script,2017/04/28,ccc_feedback_script,0,0,00:00:00,0,00:00:00,0,0
2017-04-28-ccc_fpb_script,2017/04/28,ccc_fpb_script,4,3,00:00:19,19,00:00:39,1,57
2017-04-28-ccc_help_script,2017/04/28,ccc_help_script,45,34,00:00:16,16,00:01:13,11,544
2017-04-28-ccc_link_script,2017/04/28,ccc_link_script,0,0,00:00:00,0,00:00:00,0,0
2017-04-28-ccc_media_line_script,2017/04/28,ccc_media_line_script,1,1,00:00:07,7,00:00:07,0,7
2017-04-28-ccc_priority_script,2017/04/28,ccc_priority_script,25,24,00:00:12,12,00:00:53,1,288
2017-04-28-ccc_tax_script,2017/04/28,ccc_tax_script,22,20,00:01:27,87,00:06:24,2,1740
2017-04-28-ccc_waste_recycling_script,2017/04/28,ccc_waste_recycling_script,0,0,00:00:00,0,00:00:00,0,0
2017-04-29-ccc_311_calgary_script,2017/04/29,ccc_311_calgary_script,1550,1361,00:01:22,82,00:10:30,189,111602
2017-04-30-ccc_311_calgary_script,2017/04/30,ccc_311_calgary_script,1135,1107,00:00:25,25,00:07:11,28,27675
2017-04-30-ccc_311_lobby_ph_script,2017/04/30,ccc_311_lobby_ph_script,0,0,00:00:00,0,00:00:00,0,0
2017-04-30-ccc_aserv_info_script,2017/04/30,ccc_aserv_info_script,0,0,00:00:00,0,00:00:00,0,0
2017-04-30-ccc_bylaw_script,2017/04/30,ccc_bylaw_script,0,0,00:00:00,0,00:00:00,0,0
2017-04-30-ccc_city_script,2017/04/30,ccc_city_script,0,0,00:00:00,0,00:00:00,0,0
2017-04-30-ccc_cty_online_script,2017/04/30,ccc_cty_online_script,0,0,00:00:00,0,00:00:00,0,0
2017-04-30-ccc_feedback_script,2017/04/30,ccc_feedback_script,0,0,00:00:00,0,00:00:00,0,0
2017-04-30-ccc_fpb_script,2017/04/30,ccc_fpb_script,2,1,00:00:59,59,00:00:59,1,59
2017-04-30-ccc_help_script,2017/04/30,ccc_help_script,4,4,00:00:07,7,00:00:16,0,28
2017-04-30-ccc_link_script,2017/04/30,ccc_link_script,0,0,00:00:00,0,00:00:00,0,0
2017-04-30-ccc_media_line_script,2017/04/30,ccc_media_line_script,1,1,00:00:15,15,00:00:15,0,15
2017-04-30-ccc_priority_script,2017/04/30,ccc_priority_script,13,13,00:00:14,14,00:01:30,0,182
2017-04-30-ccc_tax_script,2017/04/30,ccc_tax_script,1,1,00:02:20,140,00:02:20,0,140
2017-05-01-ccc_aserv_info_script,2017/05/01,ccc_aserv_info_script,0,0,00:00:00,0,00:00:00,0,0
2017-05-01-ccc_help_script,2017/05/01,ccc_help_script,29,27,00:00:11,11,00:00:49,2,297
2017-05-04-ccc_311_calgary_script,2017/05/04,ccc_311_calgary_script,3516,3371,00:00:37,37,00:03:32,145,124727
2017-05-04-ccc_311_lobby_ph_script,2017/05/04,ccc_311_lobby_ph_script,2,2,00:00:10,10,00:00:17,0,20
2017-05-04-ccc_aserv_info_script,2017/05/04,ccc_aserv_info_script,0,0,00:00:00,0,00:00:00,0,0
2017-05-04-ccc_bylaw_script,2017/05/04,ccc_bylaw_script,0,0,00:00:00,0,00:00:00,0,0
2017-05-04-ccc_city_script,2017/05/04,ccc_city_script,6,6,00:00:08,8,00:00:11,0,48
2017-05-04-ccc_cty_online_script,2017/05/04,ccc_cty_online_script,0,0,00:00:00,0,00:00:00,0,0
2017-05-04-ccc_feedback_script,2017/05/04,ccc_feedback_script,0,0,00:00:00,0,00:00:00,0,0
2017-05-04-ccc_fpb_script,2017/05/04,ccc_fpb_script,6,4,00:00:29,29,00:00:55,2,116
2017-05-04-ccc_help_script,2017/05/04,ccc_help_script,30,30,00:00:10,10,00:00:56,0,300
2017-05-04-ccc_link_script,2017/05/04,ccc_link_script,0,0,00:00:00,0,00:00:00,0,0
2017-05-04-ccc_media_line_script,2017/05/04,ccc_media_line_script,1,1,00:00:02,2,00:00:02,0,2
2017-05-04-ccc_priority_script,2017/05/04,ccc_priority_script,27,27,00:00:09,9,00:00:29,0,243
2017-05-05-ccc_link_script,2017/05/05,ccc_link_script,0,0,00:00:00,0,00:00:00,0,0
2017-05-05-ccc_media_line_script,2017/05/05,ccc_media_line_script,0,0,00:00:00,0,00:00:00,0,0
2017-05-05-ccc_priority_script,2017/05/05,ccc_priority_script,40,39,00:00:08,8,00:00:49,1,312
2017-05-05-ccc_tax_script,2017/05/05,ccc_tax_script,18,17,00:00:50,50,00:03:28,1,850
2017-05-05-ccc_waste_recycling_script,2017/05/05,ccc_waste_recycling_script,0,0,00:00:00,0,00:00:00,0,0
2017-05-06-ccc_311_calgary_script,2017/05/06,ccc_311_calgary_script,1481,1356,00:00:52,52,00:11:58,125,70512
2017-05-06-ccc_311_lobby_ph_script,2017/05/06,ccc_311_lobby_ph_script,4,4,00:00:22,22,00:01:07,0,88
2017-05-06-ccc_aserv_info_script,2017/05/06,ccc_aserv_info_script,0,0,00:00:00,0,00:00:00,0,0
2017-05-06-ccc_bylaw_script,2017/05/06,ccc_bylaw_script,0,0,00:00:00,0,00:00:00,0,0
2017-05-06-ccc_city_script,2017/05/06,ccc_city_script,0,0,00:00:00,0,00:00:00,0,0
2017-05-06-ccc_cty_online_script,2017/05/06,ccc_cty_online_script,0,0,00:00:00,0,00:00:00,0,0
2017-05-06-ccc_feedback_script,2017/05/06,ccc_feedback_script,0,0,00:00:00,0,00:00:00,0,0
2017-05-06-ccc_fpb_script,2017/05/06,ccc_fpb_script,4,2,00:00:34,34,00:00:55,2,68
2017-05-06-ccc_help_script,2017/05/06,ccc_help_script,22,18,00:00:09,9,00:00:35,4,162
2017-05-07-ccc_aserv_info_script,2017/05/07,ccc_aserv_info_script,0,0,00:00:00,0,00:00:00,0,0
2017-05-07-ccc_bylaw_script,2017/05/07,ccc_bylaw_script,0,0,00:00:00,0,00:00:00,0,0
2017-05-07-ccc_city_script,2017/05/07,ccc_city_script,0,0,00:00:00,0,00:00:00,0,0
2017-05-07-ccc_cty_online_script,2017/05/07,ccc_cty_online_script,0,0,00:00:00,0,00:00:00,0,0
2017-05-07-ccc_feedback_script,2017/05/07,ccc_feedback_script,0,0,00:00:00,0,00:00:00,0,0
2017-05-07-ccc_fpb_script,2017/05/07,ccc_fpb_script,2,1,00:06:55,415,00:06:55,1,415
2017-05-07-ccc_help_script,2017/05/07,ccc_help_script,8,6,00:00:05,5,00:00:06,2,30
2017-05-07-ccc_link_script,2017/05/07,ccc_link_script,0,0,00:00:00,0,00:00:00,0,0
2017-05-07-ccc_media_line_script,2017/05/07,ccc_media_line_script,4,4,00:00:08,8,00:00:16,0,32
2017-05-07-ccc_priority_script,2017/05/07,ccc_priority_script,16,16,00:00:09,9,00:00:14,0,144
2017-05-07-ccc_tax_script,2017/05/07,ccc_tax_script,0,0,00:00:00,0,00:00:00,0,0
2017-05-07-ccc_waste_recycling_script,2017/05/07,ccc_waste_recycling_script,0,0,00:00:00,0,00:00:00,0,0
2017-05-08-ccc_311_calgary_script,2017/05/08,ccc_311_calgary_script,3617,3375,00:00:59,59,00:05:24,242,199125
2017-05-08-ccc_aserv_info_script,2017/05/08,ccc_aserv_info_script,0,0,00:00:00,0,00:00:00,0,0
2017-05-08-ccc_media_line_script,2017/05/08,ccc_media_line_script,0,0,00:00:00,0,00:00:00,0,0
2017-05-08-ccc_priority_script,2017/05/08,ccc_priority_script,26,26,00:00:11,11,00:01:34,0,286
2017-05-08-ccc_tax_script,2017/05/08,ccc_tax_script,29,24,00:01:31,91,00:04:09,5,2184
2017-05-08-ccc_waste_recycling_script,2017/05/08,ccc_waste_recycling_script,0,0,00:00:00,0,00:00:00,0,0
2017-05-09-ccc_311_calgary_script,2017/05/09,ccc_311_calgary_script,3331,3185,00:00:34,34,00:10:17,146,108290
2017-05-09-ccc_311_lobby_ph_script,2017/05/09,ccc_311_lobby_ph_script,14,13,00:00:09,9,00:00:33,1,117
2017-05-09-ccc_aserv_info_script,2017/05/09,ccc_aserv_info_script,0,0,00:00:00,0,00:00:00,0,0
2017-05-09-ccc_bylaw_script,2017/05/09,ccc_bylaw_script,0,0,00:00:00,0,00:00:00,0,0
2017-05-09-ccc_city_script,2017/05/09,ccc_city_script,28,27,00:00:10,10,00:00:29,1,270
2017-05-09-ccc_cty_online_script,2017/05/09,ccc_cty_online_script,0,0,00:00:00,0,00:00:00,0,0
2017-05-09-ccc_feedback_script,2017/05/09,ccc_feedback_script,0,0,00:00:00,0,00:00:00,0,0
2017-05-09-ccc_fpb_script,2017/05/09,ccc_fpb_script,4,3,00:00:11,11,00:00:20,1,33
2017-05-09-ccc_help_script,2017/05/09,ccc_help_script,32,30,00:00:21,21,00:02:09,2,630
2017-05-09-ccc_link_script,2017/05/09,ccc_link_script,0,0,00:00:00,0,00:00:00,0,0
2017-05-10-ccc_bylaw_script,2017/05/10,ccc_bylaw_script,0,0,00:00:00,0,00:00:00,0,0
2017-05-10-ccc_city_script,2017/05/10,ccc_city_script,21,20,00:00:21,21,00:01:53,1,420
2017-05-10-ccc_cty_online_script,2017/05/10,ccc_cty_online_script,0,0,00:00:00,0,00:00:00,0,0
2017-05-10-ccc_feedback_script,2017/05/10,ccc_feedback_script,0,0,00:00:00,0,00:00:00,0,0
2017-05-10-ccc_fpb_script,2017/05/10,ccc_fpb_script,4,4,00:02:17,137,00:08:04,0,548
2017-05-10-ccc_help_script,2017/05/10,ccc_help_script,24,23,00:00:23,23,00:02:37,1,529
2017-05-10-ccc_link_script,2017/05/10,ccc_link_script,0,0,00:00:00,0,00:00:00,0,0
2017-05-10-ccc_media_line_script,2017/05/10,ccc_media_line_script,0,0,00:00:00,0,00:00:00,0,0
2017-05-10-ccc_priority_script,2017/05/10,ccc_priority_script,24,24,00:00:08,8,00:00:29,0,192
2017-05-10-ccc_tax_script,2017/05/10,ccc_tax_script,12,12,00:00:50,50,00:04:26,0,600
2017-05-10-ccc_waste_recycling_script,2017/05/10,ccc_waste_recycling_script,0,0,00:00:00,0,00:00:00,0,0
2017-05-11-ccc_311_calgary_script,2017/05/11,ccc_311_calgary_script,3097,2997,00:00:27,27,00:07:23,100,80919
2017-05-11-ccc_311_lobby_ph_script,2017/05/11,ccc_311_lobby_ph_script,1,1,00:00:09,9,00:00:09,0,9
2017-05-11-ccc_aserv_info_script,2017/05/11,ccc_aserv_info_script,0,0,00:00:00,0,00:00:00,0,0
2017-05-11-ccc_media_line_script,2017/05/11,ccc_media_line_script,1,1,00:00:14,14,00:00:14,0,14
2017-05-11-ccc_priority_script,2017/05/11,ccc_priority_script,31,30,00:00:08,8,00:00:53,1,240
2017-05-11-ccc_tax_script,2017/05/11,ccc_tax_script,20,20,00:00:10,10,00:01:19,0,200
2017-05-11-ccc_waste_recycling_script,2017/05/11,ccc_waste_recycling_script,0,0,00:00:00,0,00:00:00,0,0
2017-05-12-ccc_311_calgary_script,2017/05/12,ccc_311_calgary_script,3066,2936,00:00:37,37,00:03:50,130,108632
2017-05-12-ccc_311_lobby_ph_script,2017/05/12,ccc_311_lobby_ph_script,3,3,00:00:09,9,00:00:13,0,27
2017-05-12-ccc_aserv_info_script,2017/05/12,ccc_aserv_info_script,0,0,00:00:00,0,00:00:00,0,0
2017-05-12-ccc_bylaw_script,2017/05/12,ccc_bylaw_script,0,0,00:00:00,0,00:00:00,0,0
2017-05-12-ccc_city_script,2017/05/12,ccc_city_script,19,19,00:00:18,18,00:01:29,0,342
2017-05-12-ccc_cty_online_script,2017/05/12,ccc_cty_online_script,0,0,00:00:00,0,00:00:00,0,0
2017-05-12-ccc_feedback_script,2017/05/12,ccc_feedback_script,0,0,00:00:00,0,00:00:00,0,0
2017-05-12-ccc_fpb_script,2017/05/12,ccc_fpb_script,3,2,00:00:32,32,00:00:58,1,64
2017-05-12-ccc_help_script,2017/05/12,ccc_help_script,21,20,00:00:09,9,00:00:52,1,180
2017-05-12-ccc_link_script,2017/05/12,ccc_link_script,0,0,00:00:00,0,00:00:00,0,0
2017-05-13-ccc_bylaw_script,2017/05/13,ccc_bylaw_script,0,0,00:00:00,0,00:00:00,0,0
2017-05-13-ccc_city_script,2017/05/13,ccc_city_script,0,0,00:00:00,0,00:00:00,0,0
2017-05-13-ccc_cty_online_script,2017/05/13,ccc_cty_online_script,0,0,00:00:00,0,00:00:00,0,0
2017-05-13-ccc_feedback_script,2017/05/13,ccc_feedback_script,0,0,00:00:00,0,00:00:00,0,0
2017-05-13-ccc_fpb_script,2017/05/13,ccc_fpb_script,4,2,00:00:22,22,00:00:39,2,44
2017-05-13-ccc_help_script,2017/05/13,ccc_help_script,7,6,00:00:08,8,00:00:16,1,48
2017-05-13-ccc_link_script,2017/05/13,ccc_link_script,0,0,00:00:00,0,00:00:00,0,0
2017-05-13-ccc_media_line_script,2017/05/13,ccc_media_line_script,2,1,00:00:42,42,00:00:42,1,42
2017-05-13-ccc_priority_script,2017/05/13,ccc_priority_script,26,26,00:00:25,25,00:06:12,0,650
2017-05-13-ccc_tax_script,2017/05/13,ccc_tax_script,0,0,00:00:00,0,00:00:00,0,0
2017-05-13-ccc_waste_recycling_script,2017/05/13,ccc_waste_recycling_script,0,0,00:00:00,0,00:00:00,0,0
2017-05-14-ccc_311_calgary_script,2017/05/14,ccc_311_calgary_script,880,860,00:00:21,21,00:16:49,20,18060
2017-05-14-ccc_311_lobby_ph_script,2017/05/14,ccc_311_lobby_ph_script,0,0,00:00:00,0,00:00:00,0,0
2017-05-14-ccc_aserv_info_script,2017/05/14,ccc_aserv_info_script,0,0,00:00:00,0,00:00:00,0,0
2017-05-14-ccc_priority_script,2017/05/14,ccc_priority_script,20,19,00:00:07,7,00:00:16,1,133
2017-05-14-ccc_tax_script,2017/05/14,ccc_tax_script,0,0,00:00:00,0,00:00:00,0,0
2017-05-14-ccc_waste_recycling_script,2017/05/14,ccc_waste_recycling_script,0,0,00:00:00,0,00:00:00,0,0
2017-05-15-ccc_311_calgary_script,2017/05/15,ccc_311_calgary_script,3541,3326,00:00:54,54,00:07:11,215,179604
2017-05-15-ccc_311_lobby_ph_script,2017/05/15,ccc_311_lobby_ph_script,1,0,00:00:00,0,00:00:00,1,0
2017-05-15-ccc_aserv_info_script,2017/05/15,ccc_aserv_info_script,0,0,00:00:00,0,00:00:00,0,0
2017-05-15-ccc_bylaw_script,2017/05/15,ccc_bylaw_script,0,0,00:00:00,0,00:00:00,0,0
2017-05-15-ccc_city_script,2017/05/15,ccc_city_script,23,22,00:00:25,25,00:02:32,1,550
2017-05-15-ccc_cty_online_script,2017/05/15,ccc_cty_online_script,0,0,00:00:00,0,00:00:00,0,0
2017-05-15-ccc_feedback_script,2017/05/15,ccc_feedback_script,0,0,00:00:00,0,00:00:00,0,0
2017-05-15-ccc_fpb_script,2017/05/15,ccc_fpb_script,5,5,00:00:06,6,00:00:10,0,30
2017-05-15-ccc_help_script,2017/05/15,ccc_help_script,19,17,00:00:14,14,00:01:07,2,238
2017-05-15-ccc_link_script,2017/05/15,ccc_link_script,0,0,00:00:00,0,00:00:00,0,0
2017-05-15-ccc_media_line_script,2017/05/15,ccc_media_line_script,0,0,00:00:00,0,00:00:00,0,0
2017-05-16-ccc_city_script,2017/05/16,ccc_city_script,11,11,00:00:16,16,00:01:12,0,176
2017-05-16-ccc_cty_online_script,2017/05/16,ccc_cty_online_script,0,0,00:00:00,0,00:00:00,0,0
2017-05-16-ccc_feedback_script,2017/05/16,ccc_feedback_script,0,0,00:00:00,0,00:00:00,0,0
2017-05-16-ccc_fpb_script,2017/05/16,ccc_fpb_script,4,3,00:00:12,12,00:00:22,1,36
2017-05-21-ccc_311_calgary_script,2017/05/21,ccc_311_calgary_script,1030,980,00:00:30,30,00:06:39,50,29400
2017-05-21-ccc_311_lobby_ph_script,2017/05/21,ccc_311_lobby_ph_script,0,0,00:00:00,0,00:00:00,0,0
2017-05-21-ccc_aserv_info_script,2017/05/21,ccc_aserv_info_script,0,0,00:00:00,0,00:00:00,0,0
2017-05-21-ccc_bylaw_script,2017/05/21,ccc_bylaw_script,0,0,00:00:00,0,00:00:00,0,0
2017-05-21-ccc_city_script,2017/05/21,ccc_city_script,0,0,00:00:00,0,00:00:00,0,0
2017-05-21-ccc_cty_online_script,2017/05/21,ccc_cty_online_script,0,0,00:00:00,0,00:00:00,0,0
2017-05-21-ccc_feedback_script,2017/05/21,ccc_feedback_script,0,0,00:00:00,0,00:00:00,0,0
2017-05-21-ccc_fpb_script,2017/05/21,ccc_fpb_script,0,0,00:00:00,0,00:00:00,0,0
2017-05-23-ccc_311_calgary_script,2017/05/23,ccc_311_calgary_script,4026,3835,00:00:41,41,00:09:19,191,157235
2017-05-23-ccc_311_lobby_ph_script,2017/05/23,ccc_311_lobby_ph_script,2,2,00:00:05,5,00:00:05,0,10
2017-05-23-ccc_aserv_info_script,2017/05/23,ccc_aserv_info_script,0,0,00:00:00,0,00:00:00,0,0
2017-05-23-ccc_bylaw_script,2017/05/23,ccc_bylaw_script,0,0,00:00:00,0,00:00:00,0,0
2017-05-23-ccc_city_script,2017/05/23,ccc_city_script,25,25,00:00:10,10,00:00:23,0,250
2017-05-23-ccc_cty_online_script,2017/05/23,ccc_cty_online_script,0,0,00:00:00,0,00:00:00,0,0
2017-05-23-ccc_feedback_script,2017/05/23,ccc_feedback_script,0,0,00:00:00,0,00:00:00,0,0
2017-05-23-ccc_fpb_script,2017/05/23,ccc_fpb_script,3,3,00:00:17,17,00:00:42,0,51
2017-05-23-ccc_help_script,2017/05/23,ccc_help_script,25,23,00:00:25,25,00:03:29,2,575
2017-05-23-ccc_link_script,2017/05/23,ccc_link_script,0,0,00:00:00,0,00:00:00,0,0
2017-05-23-ccc_media_line_script,2017/05/23,ccc_media_line_script,0,0,00:00:00,0,00:00:00,0,0
2017-05-23-ccc_priority_script,2017/05/23,ccc_priority_script,48,47,00:00:12,12,00:03:04,1,564
2017-05-23-ccc_tax_script,2017/05/23,ccc_tax_script,11,10,00:00:44,44,00:01:54,1,440
2017-05-23-ccc_waste_recycling_script,2017/05/23,ccc_waste_recycling_script,0,0,00:00:00,0,00:00:00,0,0
2017-05-24-ccc_fpb_script,2017/05/24,ccc_fpb_script,4,4,00:00:11,11,00:00:25,0,44
2017-05-24-ccc_help_script,2017/05/24,ccc_help_script,32,31,00:00:15,15,00:01:03,1,465
2017-05-24-ccc_link_script,2017/05/24,ccc_link_script,0,0,00:00:00,0,00:00:00,0,0
2017-05-24-ccc_media_line_script,2017/05/24,ccc_media_line_script,3,3,00:00:13,13,00:00:27,0,39
2017-05-24-ccc_priority_script,2017/05/24,ccc_priority_script,82,81,00:00:11,11,00:01:31,1,891
2017-05-24-ccc_tax_script,2017/05/24,ccc_tax_script,27,27,00:00:17,17,00:01:44,0,459
2017-05-24-ccc_waste_recycling_script,2017/05/24,ccc_waste_recycling_script,0,0,00:00:00,0,00:00:00,0,0
2017-05-25-ccc_311_calgary_script,2017/05/25,ccc_311_calgary_script,3517,3089,00:01:48,108,00:11:23,428,333612
2017-05-25-ccc_311_lobby_ph_script,2017/05/25,ccc_311_lobby_ph_script,3,2,00:00:08,8,00:00:08,1,16
2017-05-25-ccc_aserv_info_script,2017/05/25,ccc_aserv_info_script,0,0,00:00:00,0,00:00:00,0,0
2017-05-25-ccc_bylaw_script,2017/05/25,ccc_bylaw_script,0,0,00:00:00,0,00:00:00,0,0
2017-05-25-ccc_city_script,2017/05/25,ccc_city_script,18,17,00:00:20,20,00:02:02,1,340
2017-05-25-ccc_cty_online_script,2017/05/25,ccc_cty_online_script,0,0,00:00:00,0,00:00:00,0,0
2017-05-26-ccc_311_calgary_script,2017/05/26,ccc_311_calgary_script,3283,3163,00:00:28,28,00:04:43,120,88564
2017-05-26-ccc_311_lobby_ph_script,2017/05/26,ccc_311_lobby_ph_script,5,5,00:00:09,9,00:00:19,0,45
2017-05-26-ccc_aserv_info_script,2017/05/26,ccc_aserv_info_script,0,0,00:00:00,0,00:00:00,0,0
2017-05-26-ccc_bylaw_script,2017/05/26,ccc_bylaw_script,0,0,00:00:00,0,00:00:00,0,0
2017-05-26-ccc_city_script,2017/05/26,ccc_city_script,28,27,00:00:09,9,00:00:23,1,243
2017-05-26-ccc_cty_online_script,2017/05/26,ccc_cty_online_script,0,0,00:00:00,0,00:00:00,0,0
2017-05-26-ccc_feedback_script,2017/05/26,ccc_feedback_script,0,0,00:00:00,0,00:00:00,0,0
2017-05-26-ccc_fpb_script,2017/05/26,ccc_fpb_script,4,3,00:00:28,28,00:01:05,1,84
2017-05-26-ccc_help_script,2017/05/26,ccc_help_script,19,19,00:00:07,7,00:00:21,0,133
2017-05-26-ccc_media_line_script,2017/05/26,ccc_media_line_script,5,5,00:00:04,4,00:00:08,0,20
2017-05-26-ccc_priority_script,2017/05/26,ccc_priority_script,37,37,00:00:09,9,00:00:48,0,333
2017-05-26-ccc_tax_script,2017/05/26,ccc_tax_script,17,17,00:00:20,20,00:01:45,0,340
2017-05-26-ccc_waste_recycling_script,2017/05/26,ccc_waste_recycling_script,0,0,00:00:00,0,00:00:00,0,0
2017-05-27-ccc_link_script,2017/05/27,ccc_link_script,0,0,00:00:00,0,00:00:00,0,0
2017-05-27-ccc_media_line_script,2017/05/27,ccc_media_line_script,5,4,00:00:20,20,00:00:45,1,80
2017-05-27-ccc_priority_script,2017/05/27,ccc_priority_script,35,34,00:00:19,19,00:01:47,1,646
2017-05-27-ccc_tax_script,2017/05/27,ccc_tax_script,4,4,00:01:02,62,00:01:50,0,248
2017-05-27-ccc_waste_recycling_script,2017/05/27,ccc_waste_recycling_script,0,0,00:00:00,0,00:00:00,0,0
2017-05-28-ccc_311_calgary_script,2017/05/28,ccc_311_calgary_script,1342,1240,00:01:02,62,00:09:17,102,76880
2017-05-28-ccc_311_lobby_ph_script,2017/05/28,ccc_311_lobby_ph_script,0,0,00:00:00,0,00:00:00,0,0
2017-05-28-ccc_aserv_info_script,2017/05/28,ccc_aserv_info_script,0,0,00:00:00,0,00:00:00,0,0
2017-05-28-ccc_bylaw_script,2017/05/28,ccc_bylaw_script,0,0,00:00:00,0,00:00:00,0,0
2017-05-28-ccc_city_script,2017/05/28,ccc_city_script,0,0,00:00:00,0,00:00:00,0,0
2017-05-28-ccc_cty_online_script,2017/05/28,ccc_cty_online_script,0,0,00:00:00,0,00:00:00,0,0
2017-05-28-ccc_feedback_script,2017/05/28,ccc_feedback_script,0,0,00:00:00,0,00:00:00,0,0
2017-05-28-ccc_fpb_script,2017/05/28,ccc_fpb_script,1,1,00:00:44,44,00:00:44,0,44
2017-05-28-ccc_help_script,2017/05/28,ccc_help_script,7,7,00:00:14,14,00:00:40,0,98
2017-05-29-ccc_aserv_info_script,2017/05/29,ccc_aserv_info_script,0,0,00:00:00,0,00:00:00,0,0
2017-05-29-ccc_bylaw_script,2017/05/29,ccc_bylaw_script,0,0,00:00:00,0,00:00:00,0,0
2017-05-29-ccc_city_script,2017/05/29,ccc_city_script,23,23,00:00:45,45,00:03:56,0,1035
2017-05-29-ccc_cty_online_script,2017/05/29,ccc_cty_online_script,0,0,00:00:00,0,00:00:00,0,0
2017-05-29-ccc_feedback_script,2017/05/29,ccc_feedback_script,0,0,00:00:00,0,00:00:00,0,0
2017-05-29-ccc_fpb_script,2017/05/29,ccc_fpb_script,4,3,00:03:35,215,00:06:25,1,645
2017-05-29-ccc_help_script,2017/05/29,ccc_help_script,27,27,00:00:16,16,00:01:35,0,432
2017-05-29-ccc_link_script,2017/05/29,ccc_link_script,0,0,00:00:00,0,00:00:00,0,0
2017-05-29-ccc_media_line_script,2017/05/29,ccc_media_line_script,0,0,00:00:00,0,00:00:00,0,0
2017-05-29-ccc_priority_script,2017/05/29,ccc_priority_script,37,36,00:00:09,9,00:00:35,1,324
2017-05-31-ccc_311_calgary_script,2017/05/31,ccc_311_calgary_script,4588,4169,00:01:22,82,00:09:03,419,341858
2017-05-31-ccc_311_lobby_ph_script,2017/05/31,ccc_311_lobby_ph_script,3,3,00:00:08,8,00:00:17,0,24
2017-05-31-ccc_aserv_info_script,2017/05/31,ccc_aserv_info_script,0,0,00:00:00,0,00:00:00,0,0
2017-05-31-ccc_bylaw_script,2017/05/31,ccc_bylaw_script,0,0,00:00:00,0,00:00:00,0,0
2017-05-31-ccc_city_script,2017/05/31,ccc_city_script,12,12,00:00:22,22,00:01:41,0,264
2017-05-31-ccc_cty_online_script,2017/05/31,ccc_cty_online_script,0,0,00:00:00,0,00:00:00,0,0
2017-05-31-ccc_feedback_script,2017/05/31,ccc_feedback_script,0,0,00:00:00,0,00:00:00,0,0
2017-05-31-ccc_fpb_script,2017/05/31,ccc_fpb_script,4,2,00:00:17,17,00:00:23,2,34
2017-05-31-ccc_help_script,2017/05/31,ccc_help_script,9,9,00:00:11,11,00:00:28,0,99
2017-05-31-ccc_link_script,2017/05/31,ccc_link_script,0,0,00:00:00,0,00:00:00,0,0
2017-05-31-ccc_media_line_script,2017/05/31,ccc_media_line_script,2,2,00:00:12,12,00:00:20,0,24
2017-05-31-ccc_priority_script,2017/05/31,ccc_priority_script,44,44,00:00:13,13,00:01:45,0,572
2017-05-31-ccc_tax_script,2017/05/31,ccc_tax_script,28,27,00:01:43,103,00:04:59,1,2781
2017-05-31-ccc_waste_recycling_script,2017/05/31,ccc_waste_recycling_script,0,0,00:00:00,0,00:00:00,0,0
2017-06-01-ccc_311_calgary_script,2017/06/01,ccc_311_calgary_script,4264,4071,00:00:44,44,00:06:41,193,179124
2017-06-01-ccc_311_lobby_ph_script,2017/06/01,ccc_311_lobby_ph_script,7,6,00:00:08,8,00:00:13,1,48
2017-06-01-ccc_aserv_info_script,2017/06/01,ccc_aserv_info_script,0,0,00:00:00,0,00:00:00,0,0
2017-06-01-ccc_bylaw_script,2017/06/01,ccc_bylaw_script,0,0,00:00:00,0,00:00:00,0,0
2017-06-01-ccc_city_script,2017/06/01,ccc_city_script,16,16,00:00:12,12,00:00:40,0,192
2017-06-01-ccc_cty_online_script,2017/06/01,ccc_cty_online_script,0,0,00:00:00,0,00:00:00,0,0
2017-06-01-ccc_feedback_script,2017/06/01,ccc_feedback_script,1,0,00:00:00,0,00:00:00,0,0
2017-06-01-ccc_fpb_script,2017/06/01,ccc_fpb_script,4,4,00:00:10,10,00:00:23,0,40
2017-06-01-ccc_help_script,2017/06/01,ccc_help_script,20,17,00:00:12,12,00:00:57,3,204
2017-06-01-ccc_link_script,2017/06/01,ccc_link_script,0,0,00:00:00,0,00:00:00,0,0
2017-06-01-ccc_media_line_script,2017/06/01,ccc_media_line_script,2,2,00:00:07,7,00:00:09,0,14
2017-06-01-ccc_priority_script,2017/06/01,ccc_priority_script,38,37,00:00:10,10,00:01:26,1,370
2017-06-01-ccc_tax_script,2017/06/01,ccc_tax_script,31,31,00:00:43,43,00:02:48,0,1333
2017-06-01-ccc_waste_recycling_script,2017/06/01,ccc_waste_recycling_script,0,0,00:00:00,0,00:00:00,0,0
2017-06-02-ccc_311_calgary_script,2017/06/02,ccc_311_calgary_script,4079,3489,00:02:18,138,00:09:09,590,481482
2017-06-02-ccc_311_lobby_ph_script,2017/06/02,ccc_311_lobby_ph_script,5,4,00:00:05,5,00:00:07,1,20
2017-06-02-ccc_aserv_info_script,2017/06/02,ccc_aserv_info_script,0,0,00:00:00,0,00:00:00,0,0
2017-06-02-ccc_media_line_script,2017/06/02,ccc_media_line_script,3,2,00:01:07,67,00:01:51,1,134
2017-06-02-ccc_priority_script,2017/06/02,ccc_priority_script,43,40,00:00:12,12,00:00:56,3,480
2017-06-02-ccc_tax_script,2017/06/02,ccc_tax_script,19,17,00:03:02,182,00:09:11,2,3094
2017-06-02-ccc_waste_recycling_script,2017/06/02,ccc_waste_recycling_script,0,0,00:00:00,0,00:00:00,0,0
2017-06-03-ccc_311_calgary_script,2017/06/03,ccc_311_calgary_script,1598,1447,00:01:04,64,00:09:15,149,92608
2017-06-03-ccc_311_lobby_ph_script,2017/06/03,ccc_311_lobby_ph_script,0,0,00:00:00,0,00:00:00,0,0
2017-06-03-ccc_aserv_info_script,2017/06/03,ccc_aserv_info_script,0,0,00:00:00,0,00:00:00,0,0
2017-06-03-ccc_bylaw_script,2017/06/03,ccc_bylaw_script,0,0,00:00:00,0,00:00:00,0,0
2017-06-03-ccc_city_script,2017/06/03,ccc_city_script,0,0,00:00:00,0,00:00:00,0,0
2017-06-03-ccc_cty_online_script,2017/06/03,ccc_cty_online_script,0,0,00:00:00,0,00:00:00,0,0
2017-06-03-ccc_feedback_script,2017/06/03,ccc_feedback_script,0,0,00:00:00,0,00:00:00,0,0
2017-06-03-ccc_fpb_script,2017/06/03,ccc_fpb_script,0,0,00:00:00,0,00:00:00,0,0
2017-06-03-ccc_help_script,2017/06/03,ccc_help_script,5,5,00:00:25,25,00:01:30,0,125
2017-06-04-ccc_city_script,2017/06/04,ccc_city_script,0,0,00:00:00,0,00:00:00,0,0
2017-06-04-ccc_cty_online_script,2017/06/04,ccc_cty_online_script,0,0,00:00:00,0,00:00:00,0,0
2017-06-04-ccc_feedback_script,2017/06/04,ccc_feedback_script,0,0,00:00:00,0,00:00:00,0,0
2017-06-04-ccc_fpb_script,2017/06/04,ccc_fpb_script,1,1,00:00:46,46,00:00:46,0,46
2017-06-04-ccc_help_script,2017/06/04,ccc_help_script,20,19,00:00:24,24,00:02:20,1,456
2017-06-04-ccc_link_script,2017/06/04,ccc_link_script,0,0,00:00:00,0,00:00:00,0,0
2017-06-04-ccc_media_line_script,2017/06/04,ccc_media_line_script,2,1,00:02:05,125,00:02:05,1,125
2017-06-04-ccc_priority_script,2017/06/04,ccc_priority_script,41,40,00:00:15,15,00:02:16,1,600
2017-06-04-ccc_tax_script,2017/06/04,ccc_tax_script,0,0,00:00:00,0,00:00:00,0,0
2017-06-04-ccc_waste_recycling_script,2017/06/04,ccc_waste_recycling_script,0,0,00:00:00,0,00:00:00,0,0
2017-06-05-ccc_311_calgary_script,2017/06/05,ccc_311_calgary_script,4960,4149,00:02:50,170,00:09:47,811,705330
2017-06-05-ccc_311_lobby_ph_script,2017/06/05,ccc_311_lobby_ph_script,1,1,00:00:03,3,00:00:03,0,3
2017-06-05-ccc_aserv_info_script,2017/06/05,ccc_aserv_info_script,0,0,00:00:00,0,00:00:00,0,0
2017-06-05-ccc_tax_script,2017/06/05,ccc_tax_script,37,34,00:03:25,205,00:09:02,3,6970
2017-06-05-ccc_waste_recycling_script,2017/06/05,ccc_waste_recycling_script,0,0,00:00:00,0,00:00:00,0,0
2017-06-06-ccc_311_calgary_script,2017/06/06,ccc_311_calgary_script,4614,3855,00:02:37,157,00:09:29,759,605235
2017-06-06-ccc_311_lobby_ph_script,2017/06/06,ccc_311_lobby_ph_script,6,5,00:00:21,21,00:00:41,1,105
2017-06-06-ccc_aserv_info_script,2017/06/06,ccc_aserv_info_script,0,0,00:00:00,0,00:00:00,0,0
2017-06-06-ccc_bylaw_script,2017/06/06,ccc_bylaw_script,0,0,00:00:00,0,00:00:00,0,0
2017-06-06-ccc_city_script,2017/06/06,ccc_city_script,29,28,00:01:05,65,00:07:15,1,1820
2017-06-06-ccc_cty_online_script,2017/06/06,ccc_cty_online_script,0,0,00:00:00,0,00:00:00,0,0
2017-06-06-ccc_feedback_script,2017/06/06,ccc_feedback_script,0,0,00:00:00,0,00:00:00,0,0
2017-06-06-ccc_fpb_script,2017/06/06,ccc_fpb_script,3,3,00:03:11,191,00:05:44,0,573
2017-06-06-ccc_help_script,2017/06/06,ccc_help_script,24,20,00:00:14,14,00:01:20,4,280
2017-06-06-ccc_link_script,2017/06/06,ccc_link_script,0,0,00:00:00,0,00:00:00,0,0
2017-06-06-ccc_media_line_script,2017/06/06,ccc_media_line_script,4,4,00:00:14,14,00:00:29,0,56
2017-06-06-ccc_priority_script,2017/06/06,ccc_priority_script,52,51,00:00:11,11,00:00:51,1,561
2017-06-07-ccc_cty_online_script,2017/06/07,ccc_cty_online_script,0,0,00:00:00,0,00:00:00,0,0
2017-06-07-ccc_feedback_script,2017/06/07,ccc_feedback_script,0,0,00:00:00,0,00:00:00,0,0
2017-06-07-ccc_fpb_script,2017/06/07,ccc_fpb_script,5,4,00:02:32,152,00:07:20,1,608
2017-06-07-ccc_help_script,2017/06/07,ccc_help_script,9,7,00:00:25,25,00:01:20,2,175
2017-06-07-ccc_link_script,2017/06/07,ccc_link_script,0,0,00:00:00,0,00:00:00,0,0
2017-06-07-ccc_media_line_script,2017/06/07,ccc_media_line_script,1,0,00:00:00,0,00:00:00,1,0
2017-06-07-ccc_priority_script,2017/06/07,ccc_priority_script,44,43,00:00:13,13,00:01:37,1,559
2017-06-07-ccc_tax_script,2017/06/07,ccc_tax_script,23,22,00:01:42,102,00:05:49,1,2244
2017-06-07-ccc_waste_recycling_script,2017/06/07,ccc_waste_recycling_script,0,0,00:00:00,0,00:00:00,0,0
2017-06-08-ccc_311_calgary_script,2017/06/08,ccc_311_calgary_script,4155,3406,00:02:36,156,00:24:43,749,531336
2017-06-08-ccc_311_lobby_ph_script,2017/06/08,ccc_311_lobby_ph_script,0,0,00:00:00,0,00:00:00,0,0
2017-06-08-ccc_aserv_info_script,2017/06/08,ccc_aserv_info_script,0,0,00:00:00,0,00:00:00,0,0
2017-06-08-ccc_bylaw_script,2017/06/08,ccc_bylaw_script,0,0,00:00:00,0,00:00:00,0,0
2017-06-08-ccc_waste_recycling_script,2017/06/08,ccc_waste_recycling_script,0,0,00:00:00,0,00:00:00,0,0
2017-06-09-ccc_311_calgary_script,2017/06/09,ccc_311_calgary_script,4265,3617,00:02:27,147,00:09:45,644,531699
2017-06-09-ccc_311_lobby_ph_script,2017/06/09,ccc_311_lobby_ph_script,1,1,00:00:26,26,00:00:26,0,26
2017-06-09-ccc_aserv_info_script,2017/06/09,ccc_aserv_info_script,0,0,00:00:00,0,00:00:00,0,0
2017-06-09-ccc_bylaw_script,2017/06/09,ccc_bylaw_script,0,0,00:00:00,0,00:00:00,0,0
2017-06-09-ccc_city_script,2017/06/09,ccc_city_script,22,19,00:01:23,83,00:06:42,3,1577
2017-06-09-ccc_cty_online_script,2017/06/09,ccc_cty_online_script,0,0,00:00:00,0,00:00:00,0,0
2017-06-09-ccc_feedback_script,2017/06/09,ccc_feedback_script,0,0,00:00:00,0,00:00:00,0,0
2017-06-09-ccc_fpb_script,2017/06/09,ccc_fpb_script,5,4,00:03:42,222,00:08:59,1,888
2017-06-09-ccc_help_script,2017/06/09,ccc_help_script,24,20,00:00:11,11,00:01:00,3,220
2017-06-09-ccc_link_script,2017/06/09,ccc_link_script,0,0,00:00:00,0,00:00:00,0,0
2017-06-09-ccc_media_line_script,2017/06/09,ccc_media_line_script,2,1,00:00:03,3,00:00:03,1,3
2017-06-09-ccc_priority_script,2017/06/09,ccc_priority_script,45,40,00:00:08,8,00:00:44,1,320
2017-06-09-ccc_tax_script,2017/06/09,ccc_tax_script,26,22,00:02:47,167,00:08:42,4,3674
2017-06-10-ccc_feedback_script,2017/06/10,ccc_feedback_script,0,0,00:00:00,0,00:00:00,0,0
2017-06-10-ccc_fpb_script,2017/06/10,ccc_fpb_script,1,1,00:00:06,6,00:00:06,0,6
2017-06-10-ccc_help_script,2017/06/10,ccc_help_script,3,3,00:00:08,8,00:00:11,0,24
2017-06-10-ccc_link_script,2017/06/10,ccc_link_script,0,0,00:00:00,0,00:00:00,0,0
2017-06-10-ccc_media_line_script,2017/06/10,ccc_media_line_script,1,1,00:00:06,6,00:00:06,0,6
2017-06-10-ccc_priority_script,2017/06/10,ccc_priority_script,18,17,00:00:06,6,00:00:11,1,102
2017-06-10-ccc_tax_script,2017/06/10,ccc_tax_script,1,1,00:00:23,23,00:00:23,0,23
2017-06-10-ccc_waste_recycling_script,2017/06/10,ccc_waste_recycling_script,0,0,00:00:00,0,00:00:00,0,0
2017-06-11-ccc_311_calgary_script,2017/06/11,ccc_311_calgary_script,1180,1119,00:00:37,37,00:12:11,61,41403
2017-06-11-ccc_311_lobby_ph_script,2017/06/11,ccc_311_lobby_ph_script,0,0,00:00:00,0,00:00:00,0,0
2017-06-11-ccc_aserv_info_script,2017/06/11,ccc_aserv_info_script,0,0,00:00:00,0,00:00:00,0,0
2017-06-11-ccc_bylaw_script,2017/06/11,ccc_bylaw_script,0,0,00:00:00,0,00:00:00,0,0
2017-06-11-ccc_city_script,2017/06/11,ccc_city_script,0,0,00:00:00,0,00:00:00,0,0
2017-06-12-ccc_311_calgary_script,2017/06/12,ccc_311_calgary_script,4797,4201,00:02:11,131,00:11:57,596,550331
2017-06-12-ccc_311_lobby_ph_script,2017/06/12,ccc_311_lobby_ph_script,0,0,00:00:00,0,00:00:00,0,0
2017-06-12-ccc_aserv_info_script,2017/06/12,ccc_aserv_info_script,0,0,00:00:00,0,00:00:00,0,0
2017-06-12-ccc_bylaw_script,2017/06/12,ccc_bylaw_script,0,0,00:00:00,0,00:00:00,0,0
2017-06-12-ccc_city_script,2017/06/12,ccc_city_script,26,24,00:00:52,52,00:04:17,2,1248
2017-06-12-ccc_cty_online_script,2017/06/12,ccc_cty_online_script,0,0,00:00:00,0,00:00:00,0,0
2017-06-12-ccc_feedback_script,2017/06/12,ccc_feedback_script,0,0,00:00:00,0,00:00:00,0,0
2017-06-12-ccc_fpb_script,2017/06/12,ccc_fpb_script,9,5,00:00:47,47,00:03:04,4,235
2017-06-12-ccc_help_script,2017/06/12,ccc_help_script,27,23,00:00:10,10,00:00:40,4,230
2017-06-12-ccc_link_script,2017/06/12,ccc_link_script,0,0,00:00:00,0,00:00:00,0,0
2017-06-12-ccc_media_line_script,2017/06/12,ccc_media_line_script,1,1,00:00:44,44,00:00:44,0,44
2017-06-12-ccc_priority_script,2017/06/12,ccc_priority_script,29,28,00:00:22,22,00:03:15,1,616
2017-06-12-ccc_tax_script,2017/06/12,ccc_tax_script,19,15,00:02:11,131,00:07:15,4,1965
2017-06-12-ccc_waste_recycling_script,2017/06/12,ccc_waste_recycling_script,0,0,00:00:00,0,00:00:00,0,0
2017-06-14-ccc_fpb_script,2017/06/14,ccc_fpb_script,8,4,00:00:27,27,00:01:24,4,108
2017-06-14-ccc_help_script,2017/06/14,ccc_help_script,17,14,00:00:13,13,00:00:40,3,182
2017-06-14-ccc_link_script,2017/06/14,ccc_link_script,0,0,00:00:00,0,00:00:00,0,0
2017-06-14-ccc_media_line_script,2017/06/14,ccc_media_line_script,2,2,00:00:04,4,00:00:06,0,8
2017-06-14-ccc_priority_script,2017/06/14,ccc_priority_script,35,35,00:00:11,11,00:00:54,0,385
2017-06-14-ccc_tax_script,2017/06/14,ccc_tax_script,20,17,00:00:40,40,00:01:49,3,680
2017-06-14-ccc_waste_recycling_script,2017/06/14,ccc_waste_recycling_script,0,0,00:00:00,0,00:00:00,0,0
2017-06-15-ccc_311_calgary_script,2017/06/15,ccc_311_calgary_script,3832,3465,00:01:32,92,00:15:54,367,318780
2017-06-15-ccc_311_lobby_ph_script,2017/06/15,ccc_311_lobby_ph_script,3,3,00:00:06,6,00:00:11,0,18
2017-06-15-ccc_aserv_info_script,2017/06/15,ccc_aserv_info_script,0,0,00:00:00,0,00:00:00,0,0
2017-06-15-ccc_bylaw_script,2017/06/15,ccc_bylaw_script,0,0,00:00:00,0,00:00:00,0,0
2017-06-15-ccc_city_script,2017/06/15,ccc_city_script,14,14,00:00:19,19,00:00:50,0,266
2017-06-15-ccc_cty_online_script,2017/06/15,ccc_cty_online_script,0,0,00:00:00,0,00:00:00,0,0
2017-06-15-ccc_feedback_script,2017/06/15,ccc_feedback_script,0,0,00:00:00,0,00:00:00,0,0
2017-06-16-ccc_311_calgary_script,2017/06/16,ccc_311_calgary_script,3511,3420,00:00:18,18,00:11:28,91,61560
2017-06-16-ccc_311_lobby_ph_script,2017/06/16,ccc_311_lobby_ph_script,5,4,00:00:05,5,00:00:06,1,20
2017-06-16-ccc_aserv_info_script,2017/06/16,ccc_aserv_info_script,0,0,00:00:00,0,00:00:00,0,0
2017-06-16-ccc_bylaw_script,2017/06/16,ccc_bylaw_script,0,0,00:00:00,0,00:00:00,0,0
2017-06-16-ccc_city_script,2017/06/16,ccc_city_script,22,22,00:00:11,11,00:00:46,0,242
2017-06-16-ccc_cty_online_script,2017/06/16,ccc_cty_online_script,0,0,00:00:00,0,00:00:00,0,0
2017-06-16-ccc_feedback_script,2017/06/16,ccc_feedback_script,0,0,00:00:00,0,00:00:00,0,0
2017-06-16-ccc_fpb_script,2017/06/16,ccc_fpb_script,8,5,00:00:08,8,00:00:19,3,40
2017-06-16-ccc_help_script,2017/06/16,ccc_help_script,11,11,00:00:09,9,00:00:18,0,99
2017-06-16-ccc_link_script,2017/06/16,ccc_link_script,0,0,00:00:00,0,00:00:00,0,0
2017-06-16-ccc_media_line_script,2017/06/16,ccc_media_line_script,3,3,00:00:19,19,00:00:29,0,57
2017-06-16-ccc_priority_script,2017/06/16,ccc_priority_script,42,42,00:00:07,7,00:00:13,0,294
2017-06-16-ccc_tax_script,2017/06/16,ccc_tax_script,25,25,00:00:14,14,00:01:14,0,350
2017-06-17-ccc_help_script,2017/06/17,ccc_help_script,3,3,00:00:08,8,00:00:16,0,24
2017-06-17-ccc_link_script,2017/06/17,ccc_link_script,0,0,00:00:00,0,00:00:00,0,0
2017-06-17-ccc_media_line_script,2017/06/17,ccc_media_line_script,2,1,00:00:04,4,00:00:04,1,4
2017-06-17-ccc_priority_script,2017/06/17,ccc_priority_script,35,35,00:00:08,8,00:00:35,0,280
2017-06-17-ccc_tax_script,2017/06/17,ccc_tax_script,0,0,00:00:00,0,00:00:00,0,0
2017-06-17-ccc_waste_recycling_script,2017/06/17,ccc_waste_recycling_script,0,0,00:00:00,0,00:00:00,0,0
2017-06-18-ccc_311_calgary_script,2017/06/18,ccc_311_calgary_script,1152,1125,00:00:16,16,00:04:24,26,18000
2017-06-18-ccc_311_lobby_ph_script,2017/06/18,ccc_311_lobby_ph_script,0,0,00:00:00,0,00:00:00,0,0
2017-06-18-ccc_aserv_info_script,2017/06/18,ccc_aserv_info_script,0,0,00:00:00,0,00:00:00,0,0
2017-06-18-ccc_bylaw_script,2017/06/18,ccc_bylaw_script,0,0,00:00:00,0,00:00:00,0,0
2017-06-18-ccc_city_script,2017/06/18,ccc_city_script,0,0,00:00:00,0,00:00:00,0,0
2017-06-18-ccc_cty_online_script,2017/06/18,ccc_cty_online_script,0,0,00:00:00,0,00:00:00,0,0
2017-06-18-ccc_feedback_script,2017/06/18,ccc_feedback_script,0,0,00:00:00,0,00:00:00,0,0
2017-06-18-ccc_fpb_script,2017/06/18,ccc_fpb_script,2,2,00:00:05,5,00:00:06,0,10
2017-06-19-ccc_311_lobby_ph_script,2017/06/19,ccc_311_lobby_ph_script,1,1,00:00:14,14,00:00:14,0,14
2017-06-19-ccc_aserv_info_script,2017/06/19,ccc_aserv_info_script,0,0,00:00:00,0,00:00:00,0,0
2017-06-19-ccc_bylaw_script,2017/06/19,ccc_bylaw_script,0,0,00:00:00,0,00:00:00,0,0
2017-06-19-ccc_city_script,2017/06/19,ccc_city_script,30,30,00:00:22,22,00:02:23,0,660
2017-06-19-ccc_cty_online_script,2017/06/19,ccc_cty_online_script,0,0,00:00:00,0,00:00:00,0,0
2017-06-19-ccc_feedback_script,2017/06/19,ccc_feedback_script,0,0,00:00:00,0,00:00:00,0,0
2017-06-19-ccc_fpb_script,2017/06/19,ccc_fpb_script,4,2,00:01:36,96,00:02:05,2,192
2017-06-19-ccc_help_script,2017/06/19,ccc_help_script,8,8,00:00:22,22,00:01:06,0,176
2017-06-19-ccc_link_script,2017/06/19,ccc_link_script,0,0,00:00:00,0,00:00:00,0,0
2017-06-19-ccc_media_line_script,2017/06/19,ccc_media_line_script,2,2,00:00:22,22,00:00:33,0,44
2017-06-19-ccc_priority_script,2017/06/19,ccc_priority_script,36,35,00:00:10,10,00:00:49,1,350
2017-06-19-ccc_tax_script,2017/06/19,ccc_tax_script,22,20,00:02:14,134,00:05:36,2,2680
2017-06-19-ccc_waste_recycling_script,2017/06/19,ccc_waste_recycling_script,0,0,00:00:00,0,00:00:00,0,0
2017-06-20-ccc_link_script,2017/06/20,ccc_link_script,0,0,00:00:00,0,00:00:00,0,0
2017-06-20-ccc_media_line_script,2017/06/20,ccc_media_line_script,0,0,00:00:00,0,00:00:00,0,0
2017-06-20-ccc_priority_script,2017/06/20,ccc_priority_script,49,49,00:00:11,11,00:00:36,0,539
2017-06-20-ccc_tax_script,2017/06/20,ccc_tax_script,22,20,00:00:51,51,00:08:48,2,1020
2017-06-20-ccc_waste_recycling_script,2017/06/20,ccc_waste_recycling_script,0,0,00:00:00,0,00:00:00,0,0
2017-06-21-ccc_311_calgary_script,2017/06/21,ccc_311_calgary_script,4376,4150,00:00:45,45,00:10:17,225,186750
2017-06-21-ccc_311_lobby_ph_script,2017/06/21,ccc_311_lobby_ph_script,1,1,00:00:04,4,00:00:04,0,4
2017-06-21-ccc_aserv_info_script,2017/06/21,ccc_aserv_info_script,0,0,00:00:00,0,00:00:00,0,0
2017-06-21-ccc_bylaw_script,2017/06/21,ccc_bylaw_script,0,0,00:00:00,0,00:00:00,0,0
2017-06-21-ccc_city_script,2017/06/21,ccc_city_script,22,21,00:00:15,15,00:00:36,1,315
2017-06-21-ccc_cty_online_script,2017/06/21,ccc_cty_online_script,0,0,00:00:00,0,00:00:00,0,0
2017-06-21-ccc_feedback_script,2017/06/21,ccc_feedback_script,0,0,00:00:00,0,00:00:00,0,0
2017-06-21-ccc_fpb_script,2017/06/21,ccc_fpb_script,5,3,00:01:26,86,00:03:26,2,258
2017-06-21-ccc_help_script,2017/06/21,ccc_help_script,20,19,00:00:12,12,00:00:32,1,228
2017-06-22-ccc_aserv_info_script,2017/06/22,ccc_aserv_info_script,0,0,00:00:00,0,00:00:00,0,0
2017-06-22-ccc_bylaw_script,2017/06/22,ccc_bylaw_script,0,0,00:00:00,0,00:00:00,0,0
2017-06-22-ccc_city_script,2017/06/22,ccc_city_script,24,24,00:00:11,11,00:00:20,0,264
2017-06-22-ccc_cty_online_script,2017/06/22,ccc_cty_online_script,0,0,00:00:00,0,00:00:00,0,0
2017-06-22-ccc_feedback_script,2017/06/22,ccc_feedback_script,0,0,00:00:00,0,00:00:00,0,0
2017-06-22-ccc_fpb_script,2017/06/22,ccc_fpb_script,3,2,00:00:04,4,00:00:06,1,8
2017-06-22-ccc_help_script,2017/06/22,ccc_help_script,16,16,00:00:07,7,00:00:28,0,112
2017-06-22-ccc_link_script,2017/06/22,ccc_link_script,0,0,00:00:00,0,00:00:00,0,0
2017-06-22-ccc_media_line_script,2017/06/22,ccc_media_line_script,2,2,00:00:20,20,00:00:29,0,40
2017-06-22-ccc_priority_script,2017/06/22,ccc_priority_script,28,28,00:00:09,9,00:00:30,0,252
2017-06-22-ccc_tax_script,2017/06/22,ccc_tax_script,24,24,00:00:19,19,00:01:18,0,456
2017-06-22-ccc_waste_recycling_script,2017/06/22,ccc_waste_recycling_script,0,0,00:00:00,0,00:00:00,0,0
2017-06-23-ccc_311_calgary_script,2017/06/23,ccc_311_calgary_script,3612,3489,00:00:36,36,00:07:40,123,125604
2017-06-23-ccc_aserv_info_script,2017/06/23,ccc_aserv_info_script,0,0,00:00:00,0,00:00:00,0,0
2017-06-23-ccc_media_line_script,2017/06/23,ccc_media_line_script,1,0,00:00:00,0,00:00:00,1,0
2017-06-23-ccc_priority_script,2017/06/23,ccc_priority_script,31,31,00:00:10,10,00:00:56,0,310
2017-06-23-ccc_tax_script,2017/06/23,ccc_tax_script,32,31,00:00:28,28,00:03:18,1,868
2017-06-23-ccc_waste_recycling_script,2017/06/23,ccc_waste_recycling_script,0,0,00:00:00,0,00:00:00,0,0
2017-06-24-ccc_311_calgary_script,2017/06/24,ccc_311_calgary_script,1517,1424,00:00:42,42,00:10:57,93,59808
2017-06-24-ccc_311_lobby_ph_script,2017/06/24,ccc_311_lobby_ph_script,0,0,00:00:00,0,00:00:00,0,0
2017-06-24-ccc_aserv_info_script,2017/06/24,ccc_aserv_info_script,0,0,00:00:00,0,00:00:00,0,0
2017-06-24-ccc_bylaw_script,2017/06/24,ccc_bylaw_script,0,0,00:00:00,0,00:00:00,0,0
2017-06-24-ccc_city_script,2017/06/24,ccc_city_script,0,0,00:00:00,0,00:00:00,0,0
2017-06-24-ccc_cty_online_script,2017/06/24,ccc_cty_online_script,0,0,00:00:00,0,00:00:00,0,0
2017-06-24-ccc_feedback_script,2017/06/24,ccc_feedback_script,0,0,00:00:00,0,00:00:00,0,0
2017-06-24-ccc_fpb_script,2017/06/24,ccc_fpb_script,1,1,00:04:05,245,00:04:05,0,245
2017-06-24-ccc_help_script,2017/06/24,ccc_help_script,13,11,00:00:21,21,00:01:35,2,231
2017-06-25-ccc_city_script,2017/06/25,ccc_city_script,0,0,00:00:00,0,00:00:00,0,0
2017-06-25-ccc_cty_online_script,2017/06/25,ccc_cty_online_script,0,0,00:00:00,0,00:00:00,0,0
2017-06-25-ccc_feedback_script,2017/06/25,ccc_feedback_script,0,0,00:00:00,0,00:00:00,0,0
2017-06-25-ccc_fpb_script,2017/06/25,ccc_fpb_script,2,2,00:01:16,76,00:02:18,0,152
2017-06-25-ccc_help_script,2017/06/25,ccc_help_script,12,9,00:00:40,40,00:02:26,3,360
2017-06-25-ccc_link_script,2017/06/25,ccc_link_script,0,0,00:00:00,0,00:00:00,0,0
2017-06-25-ccc_media_line_script,2017/06/25,ccc_media_line_script,1,1,00:00:03,3,00:00:03,0,3
2017-06-25-ccc_priority_script,2017/06/25,ccc_priority_script,16,16,00:00:09,9,00:00:55,0,144
2017-06-26-ccc_priority_script,2017/06/26,ccc_priority_script,45,43,00:00:07,7,00:00:35,2,301
2017-06-26-ccc_waste_recycling_script,2017/06/26,ccc_waste_recycling_script,0,0,00:00:00,0,00:00:00,0,0
2017-06-27-ccc_311_calgary_script,2017/06/27,ccc_311_calgary_script,4756,4327,00:01:36,96,00:08:09,429,415392
2017-06-27-ccc_311_lobby_ph_script,2017/06/27,ccc_311_lobby_ph_script,3,3,00:00:04,4,00:00:07,0,12
2017-06-27-ccc_aserv_info_script,2017/06/27,ccc_aserv_info_script,0,0,00:00:00,0,00:00:00,0,0
2017-06-29-ccc_cty_online_script,2017/06/29,ccc_cty_online_script,0,0,00:00:00,0,00:00:00,0,0
2017-06-29-ccc_feedback_script,2017/06/29,ccc_feedback_script,0,0,00:00:00,0,00:00:00,0,0
2017-06-29-ccc_fpb_script,2017/06/29,ccc_fpb_script,3,3,00:01:28,88,00:02:30,0,264
2017-06-29-ccc_help_script,2017/06/29,ccc_help_script,18,18,00:00:11,11,00:00:29,0,198
2017-06-29-ccc_link_script,2017/06/29,ccc_link_script,0,0,00:00:00,0,00:00:00,0,0
2017-06-29-ccc_media_line_script,2017/06/29,ccc_media_line_script,1,1,00:00:09,9,00:00:09,0,9
2017-06-29-ccc_priority_script,2017/06/29,ccc_priority_script,20,20,00:00:14,14,00:00:54,0,280
2017-06-29-ccc_tax_script,2017/06/29,ccc_tax_script,22,22,00:00:49,49,00:03:28,0,1078
2017-06-29-ccc_waste_recycling_script,2017/06/29,ccc_waste_recycling_script,0,0,00:00:00,0,00:00:00,0,0
2017-06-30-ccc_311_calgary_script,2017/06/30,ccc_311_calgary_script,4349,4166,00:00:35,35,00:09:59,179,145810
2017-06-30-ccc_311_lobby_ph_script,2017/06/30,ccc_311_lobby_ph_script,0,0,00:00:00,0,00:00:00,0,0
2017-06-30-ccc_aserv_info_script,2017/06/30,ccc_aserv_info_script,0,0,00:00:00,0,00:00:00,0,0
2017-06-30-ccc_bylaw_script,2017/06/30,ccc_bylaw_script,0,0,00:00:00,0,00:00:00,0,0
2017-06-30-ccc_link_script,2017/06/30,ccc_link_script,0,0,00:00:00,0,00:00:00,0,0
2017-06-30-ccc_waste_recycling_script,2017/06/30,ccc_waste_recycling_script,0,0,00:00:00,0,00:00:00,0,0
2017-07-01-ccc_311_calgary_script,2017/07/01,ccc_311_calgary_script,1358,1338,00:00:15,15,00:07:43,24,20070
2017-07-01-ccc_311_lobby_ph_script,2017/07/01,ccc_311_lobby_ph_script,0,0,00:00:00,0,00:00:00,0,0
2017-07-01-ccc_aserv_info_script,2017/07/01,ccc_aserv_info_script,0,0,00:00:00,0,00:00:00,0,0
2017-07-01-ccc_bylaw_script,2017/07/01,ccc_bylaw_script,0,0,00:00:00,0,00:00:00,0,0
2017-07-01-ccc_city_script,2017/07/01,ccc_city_script,0,0,00:00:00,0,00:00:00,0,0
2017-07-01-ccc_cty_online_script,2017/07/01,ccc_cty_online_script,0,0,00:00:00,0,00:00:00,0,0
2017-07-01-ccc_feedback_script,2017/07/01,ccc_feedback_script,0,0,00:00:00,0,00:00:00,0,0
2017-07-01-ccc_fpb_script,2017/07/01,ccc_fpb_script,3,2,00:00:04,4,00:00:06,1,8
2017-07-01-ccc_help_script,2017/07/01,ccc_help_script,7,7,00:00:10,10,00:00:40,0,70
2017-07-01-ccc_link_script,2017/07/01,ccc_link_script,0,0,00:00:00,0,00:00:00,0,0
2017-07-01-ccc_media_line_script,2017/07/01,ccc_media_line_script,3,3,00:00:04,4,00:00:05,0,12
2017-07-01-ccc_priority_script,2017/07/01,ccc_priority_script,23,23,00:00:07,7,00:00:14,0,161
2017-07-02-ccc_fpb_script,2017/07/02,ccc_fpb_script,5,4,00:00:18,18,00:01:06,1,72
2017-07-02-ccc_help_script,2017/07/02,ccc_help_script,7,7,00:00:18,18,00:00:49,0,126
2017-07-02-ccc_link_script,2017/07/02,ccc_link_script,0,0,00:00:00,0,00:00:00,0,0
2017-07-02-ccc_media_line_script,2017/07/02,ccc_media_line_script,2,2,00:00:14,14,00:00:22,0,28
2017-07-02-ccc_priority_script,2017/07/02,ccc_priority_script,31,30,00:00:09,9,00:00:33,1,270
2017-07-02-ccc_tax_script,2017/07/02,ccc_tax_script,0,0,00:00:00,0,00:00:00,0,0
2017-07-02-ccc_waste_recycling_script,2017/07/02,ccc_waste_recycling_script,0,0,00:00:00,0,00:00:00,0,0
2017-07-03-ccc_311_calgary_script,2017/07/03,ccc_311_calgary_script,2251,2208,00:00:15,15,00:10:54,43,33120
2017-07-03-ccc_311_lobby_ph_script,2017/07/03,ccc_311_lobby_ph_script,2,2,00:00:09,9,00:00:12,0,18
2017-07-03-ccc_aserv_info_script,2017/07/03,ccc_aserv_info_script,0,0,00:00:00,0,00:00:00,0,0
2017-07-03-ccc_bylaw_script,2017/07/03,ccc_bylaw_script,0,0,00:00:00,0,00:00:00,0,0
2017-07-03-ccc_city_script,2017/07/03,ccc_city_script,3,3,00:00:21,21,00:00:50,0,63
2017-07-03-ccc_cty_online_script,2017/07/03,ccc_cty_online_script,0,0,00:00:00,0,00:00:00,0,0
2017-07-03-ccc_feedback_script,2017/07/03,ccc_feedback_script,0,0,00:00:00,0,00:00:00,0,0
2017-07-04-ccc_311_calgary_script,2017/07/04,ccc_311_calgary_script,4459,4092,00:01:09,69,00:06:08,367,282348
2017-07-04-ccc_311_lobby_ph_script,2017/07/04,ccc_311_lobby_ph_script,1,1,00:00:02,2,00:00:02,0,2
2017-07-04-ccc_aserv_info_script,2017/07/04,ccc_aserv_info_script,0,0,00:00:00,0,00:00:00,0,0
2017-07-04-ccc_bylaw_script,2017/07/04,ccc_bylaw_script,0,0,00:00:00,0,00:00:00,0,0
2017-07-04-ccc_city_script,2017/07/04,ccc_city_script,34,34,00:00:20,20,00:02:05,0,680
2017-07-04-ccc_cty_online_script,2017/07/04,ccc_cty_online_script,0,0,00:00:00,0,00:00:00,0,0
2017-07-04-ccc_feedback_script,2017/07/04,ccc_feedback_script,0,0,00:00:00,0,00:00:00,0,0
2017-07-04-ccc_fpb_script,2017/07/04,ccc_fpb_script,3,1,00:03:08,188,00:03:08,2,188
2017-07-04-ccc_help_script,2017/07/04,ccc_help_script,29,28,00:00:14,14,00:00:38,1,392
2017-07-04-ccc_link_script,2017/07/04,ccc_link_script,0,0,00:00:00,0,00:00:00,0,0
2017-07-04-ccc_media_line_script,2017/07/04,ccc_media_line_script,0,0,00:00:00,0,00:00:00,0,0
2017-07-04-ccc_priority_script,2017/07/04,ccc_priority_script,40,38,00:00:11,11,00:01:30,2,418
2017-07-04-ccc_tax_script,2017/07/04,ccc_tax_script,19,18,00:01:34,94,00:05:48,1,1692
2017-07-08-ccc_311_calgary_script,2017/07/08,ccc_311_calgary_script,1549,1494,00:00:24,24,00:05:23,55,35856
2017-07-08-ccc_311_lobby_ph_script,2017/07/08,ccc_311_lobby_ph_script,0,0,00:00:00,0,00:00:00,0,0
2017-07-08-ccc_aserv_info_script,2017/07/08,ccc_aserv_info_script,0,0,00:00:00,0,00:00:00,0,0
2017-07-08-ccc_bylaw_script,2017/07/08,ccc_bylaw_script,0,0,00:00:00,0,00:00:00,0,0
2017-07-08-ccc_city_script,2017/07/08,ccc_city_script,0,0,00:00:00,0,00:00:00,0,0
2017-07-08-ccc_cty_online_script,2017/07/08,ccc_cty_online_script,0,0,00:00:00,0,00:00:00,0,0
2017-07-08-ccc_feedback_script,2017/07/08,ccc_feedback_script,0,0,00:00:00,0,00:00:00,0,0
2017-07-08-ccc_fpb_script,2017/07/08,ccc_fpb_script,3,2,00:00:06,6,00:00:06,1,12
2017-07-08-ccc_help_script,2017/07/08,ccc_help_script,3,3,00:00:09,9,00:00:12,0,27
2017-07-08-ccc_link_script,2017/07/08,ccc_link_script,0,0,00:00:00,0,00:00:00,0,0
2017-07-08-ccc_media_line_script,2017/07/08,ccc_media_line_script,0,0,00:00:00,0,00:00:00,0,0
2017-07-08-ccc_priority_script,2017/07/08,ccc_priority_script,32,31,00:00:11,11,00:00:45,1,341
2017-07-08-ccc_tax_script,2017/07/08,ccc_tax_script,0,0,00:00:00,0,00:00:00,0,0
2017-07-08-ccc_waste_recycling_script,2017/07/08,ccc_waste_recycling_script,0,0,00:00:00,0,00:00:00,0,0
2017-07-09-ccc_311_calgary_script,2017/07/09,ccc_311_calgary_script,1274,1211,00:00:28,28,00:08:07,63,33908
2017-07-09-ccc_311_lobby_ph_script,2017/07/09,ccc_311_lobby_ph_script,0,0,00:00:00,0,00:00:00,0,0
2017-07-09-ccc_aserv_info_script,2017/07/09,ccc_aserv_info_script,0,0,00:00:00,0,00:00:00,0,0
2017-07-09-ccc_bylaw_script,2017/07/09,ccc_bylaw_script,0,0,00:00:00,0,00:00:00,0,0
2017-07-09-ccc_city_script,2017/07/09,ccc_city_script,0,0,00:00:00,0,00:00:00,0,0
2017-07-09-ccc_cty_online_script,2017/07/09,ccc_cty_online_script,0,0,00:00:00,0,00:00:00,0,0
2017-07-09-ccc_feedback_script,2017/07/09,ccc_feedback_script,0,0,00:00:00,0,00:00:00,0,0
2017-07-09-ccc_fpb_script,2017/07/09,ccc_fpb_script,4,4,00:00:03,3,00:00:04,0,12
2017-07-09-ccc_help_script,2017/07/09,ccc_help_script,2,1,00:01:44,104,00:01:44,1,104
2017-07-09-ccc_link_script,2017/07/09,ccc_link_script,0,0,00:00:00,0,00:00:00,0,0
2017-07-09-ccc_media_line_script,2017/07/09,ccc_media_line_script,2,2,00:00:02,2,00:00:02,0,4
2017-07-09-ccc_priority_script,2017/07/09,ccc_priority_script,35,33,00:00:13,13,00:01:38,2,429
2017-07-09-ccc_tax_script,2017/07/09,ccc_tax_script,0,0,00:00:00,0,00:00:00,0,0
2017-07-09-ccc_waste_recycling_script,2017/07/09,ccc_waste_recycling_script,0,0,00:00:00,0,00:00:00,0,0
2017-07-10-ccc_311_calgary_script,2017/07/10,ccc_311_calgary_script,3825,3617,00:00:46,46,00:07:59,208,166382
2017-07-10-ccc_311_lobby_ph_script,2017/07/10,ccc_311_lobby_ph_script,0,0,00:00:00,0,00:00:00,0,0
2017-07-10-ccc_aserv_info_script,2017/07/10,ccc_aserv_info_script,0,0,00:00:00,0,00:00:00,0,0
2017-07-10-ccc_bylaw_script,2017/07/10,ccc_bylaw_script,0,0,00:00:00,0,00:00:00,0,0
2017-07-10-ccc_city_script,2017/07/10,ccc_city_script,10,10,00:00:14,14,00:00:40,0,140
2017-07-10-ccc_cty_online_script,2017/07/10,ccc_cty_online_script,0,0,00:00:00,0,00:00:00,0,0
2017-07-10-ccc_feedback_script,2017/07/10,ccc_feedback_script,0,0,00:00:00,0,00:00:00,0,0
2017-07-10-ccc_fpb_script,2017/07/10,ccc_fpb_script,7,7,00:00:51,51,00:02:09,0,357
2017-07-10-ccc_help_script,2017/07/10,ccc_help_script,13,12,00:00:14,14,00:00:46,1,168
2017-07-10-ccc_link_script,2017/07/10,ccc_link_script,0,0,00:00:00,0,00:00:00,0,0
2017-07-10-ccc_media_line_script,2017/07/10,ccc_media_line_script,0,0,00:00:00,0,00:00:00,0,0
2017-07-10-ccc_priority_script,2017/07/10,ccc_priority_script,50,48,00:00:09,9,00:00:58,2,432
2017-07-10-ccc_tax_script,2017/07/10,ccc_tax_script,29,27,00:00:50,50,00:03:15,2,1350
2017-07-10-ccc_waste_recycling_script,2017/07/10,ccc_waste_recycling_script,0,0,00:00:00,0,00:00:00,0,0
2017-07-11-ccc_311_calgary_script,2017/07/11,ccc_311_calgary_script,3627,3167,00:01:54,114,00:10:57,460,361038
2017-07-11-ccc_311_lobby_ph_script,2017/07/11,ccc_311_lobby_ph_script,0,0,00:00:00,0,00:00:00,0,0
2017-07-11-ccc_link_script,2017/07/11,ccc_link_script,0,0,00:00:00,0,00:00:00,0,0
2017-07-11-ccc_aserv_info_script,2017/07/11,ccc_aserv_info_script,0,0,00:00:00,0,00:00:00,0,0
2017-07-11-ccc_bylaw_script,2017/07/11,ccc_bylaw_script,0,0,00:00:00,0,00:00:00,0,0
2017-07-11-ccc_city_script,2017/07/11,ccc_city_script,11,10,00:00:22,22,00:01:15,1,220
2017-07-11-ccc_cty_online_script,2017/07/11,ccc_cty_online_script,0,0,00:00:00,0,00:00:00,0,0
2017-07-11-ccc_feedback_script,2017/07/11,ccc_feedback_script,0,0,00:00:00,0,00:00:00,0,0
2017-07-11-ccc_fpb_script,2017/07/11,ccc_fpb_script,4,3,00:00:52,52,00:01:55,1,156
2017-07-11-ccc_help_script,2017/07/11,ccc_help_script,22,20,00:00:11,11,00:00:25,2,220
2017-07-11-ccc_media_line_script,2017/07/11,ccc_media_line_script,2,2,00:00:06,6,00:00:07,0,12
2017-07-11-ccc_priority_script,2017/07/11,ccc_priority_script,64,62,00:00:11,11,00:00:46,2,682
2017-07-11-ccc_tax_script,2017/07/11,ccc_tax_script,22,18,00:03:02,182,00:10:20,4,3276
2017-07-11-ccc_waste_recycling_script,2017/07/11,ccc_waste_recycling_script,0,0,00:00:00,0,00:00:00,0,0
2017-07-12-ccc_311_calgary_script,2017/07/12,ccc_311_calgary_script,3303,2843,00:02:09,129,00:10:46,460,366747
2017-07-12-ccc_311_lobby_ph_script,2017/07/12,ccc_311_lobby_ph_script,2,2,00:00:07,7,00:00:11,0,14
2017-07-12-ccc_aserv_info_script,2017/07/12,ccc_aserv_info_script,0,0,00:00:00,0,00:00:00,0,0
2017-07-12-ccc_bylaw_script,2017/07/12,ccc_bylaw_script,0,0,00:00:00,0,00:00:00,0,0
2017-07-12-ccc_city_script,2017/07/12,ccc_city_script,6,5,00:00:21,21,00:00:56,1,105
2017-07-12-ccc_cty_online_script,2017/07/12,ccc_cty_online_script,0,0,00:00:00,0,00:00:00,0,0
2017-07-12-ccc_feedback_script,2017/07/12,ccc_feedback_script,0,0,00:00:00,0,00:00:00,0,0
2017-07-12-ccc_fpb_script,2017/07/12,ccc_fpb_script,6,5,00:02:38,158,00:04:04,1,790
2017-07-12-ccc_help_script,2017/07/12,ccc_help_script,17,17,00:00:12,12,00:00:27,0,204
2017-07-12-ccc_link_script,2017/07/12,ccc_link_script,0,0,00:00:00,0,00:00:00,0,0
2017-07-12-ccc_media_line_script,2017/07/12,ccc_media_line_script,0,0,00:00:00,0,00:00:00,0,0
2017-07-12-ccc_priority_script,2017/07/12,ccc_priority_script,30,29,00:00:11,11,00:00:34,1,319
2017-07-12-ccc_tax_script,2017/07/12,ccc_tax_script,16,14,00:01:33,93,00:03:36,2,1302
2017-07-12-ccc_waste_recycling_script,2017/07/12,ccc_waste_recycling_script,0,0,00:00:00,0,00:00:00,0,0
2017-07-13-ccc_311_calgary_script,2017/07/13,ccc_311_calgary_script,3711,3269,00:01:52,112,00:08:19,442,366128
2017-07-13-ccc_311_lobby_ph_script,2017/07/13,ccc_311_lobby_ph_script,2,2,00:00:30,30,00:00:42,0,60
2017-07-13-ccc_aserv_info_script,2017/07/13,ccc_aserv_info_script,0,0,00:00:00,0,00:00:00,0,0
2017-07-13-ccc_bylaw_script,2017/07/13,ccc_bylaw_script,0,0,00:00:00,0,00:00:00,0,0
2017-07-13-ccc_city_script,2017/07/13,ccc_city_script,5,5,00:00:09,9,00:00:17,0,45
2017-07-13-ccc_cty_online_script,2017/07/13,ccc_cty_online_script,0,0,00:00:00,0,00:00:00,0,0
2017-07-13-ccc_feedback_script,2017/07/13,ccc_feedback_script,0,0,00:00:00,0,00:00:00,0,0
2017-07-13-ccc_fpb_script,2017/07/13,ccc_fpb_script,7,3,00:00:22,22,00:00:53,4,66
2017-07-13-ccc_help_script,2017/07/13,ccc_help_script,41,35,00:00:17,17,00:01:01,6,595
2017-07-13-ccc_link_script,2017/07/13,ccc_link_script,0,0,00:00:00,0,00:00:00,0,0
2017-07-13-ccc_media_line_script,2017/07/13,ccc_media_line_script,1,1,00:01:12,72,00:01:12,0,72
2017-07-13-ccc_priority_script,2017/07/13,ccc_priority_script,34,32,00:00:13,13,00:01:01,1,416
2017-07-13-ccc_tax_script,2017/07/13,ccc_tax_script,18,14,00:02:38,158,00:06:45,4,2212
2017-07-13-ccc_waste_recycling_script,2017/07/13,ccc_waste_recycling_script,0,0,00:00:00,0,00:00:00,0,0
2017-07-14-ccc_311_calgary_script,2017/07/14,ccc_311_calgary_script,2309,1951,00:02:30,150,00:07:32,355,292650
2017-07-14-ccc_311_lobby_ph_script,2017/07/14,ccc_311_lobby_ph_script,1,1,00:00:07,7,00:00:07,0,7
2017-07-14-ccc_aserv_info_script,2017/07/14,ccc_aserv_info_script,0,0,00:00:00,0,00:00:00,0,0
2017-07-14-ccc_bylaw_script,2017/07/14,ccc_bylaw_script,0,0,00:00:00,0,00:00:00,0,0
2017-07-14-ccc_city_script,2017/07/14,ccc_city_script,11,11,00:00:42,42,00:03:39,0,462
2017-07-14-ccc_cty_online_script,2017/07/14,ccc_cty_online_script,0,0,00:00:00,0,00:00:00,0,0
2017-07-14-ccc_feedback_script,2017/07/14,ccc_feedback_script,0,0,00:00:00,0,00:00:00,0,0
2017-07-14-ccc_fpb_script,2017/07/14,ccc_fpb_script,0,0,00:00:00,0,00:00:00,0,0
2017-07-14-ccc_help_script,2017/07/14,ccc_help_script,15,13,00:00:17,17,00:01:02,2,221
2017-07-14-ccc_link_script,2017/07/14,ccc_link_script,0,0,00:00:00,0,00:00:00,0,0
2017-07-14-ccc_media_line_script,2017/07/14,ccc_media_line_script,2,1,00:00:08,8,00:00:08,1,8
2017-07-14-ccc_priority_script,2017/07/14,ccc_priority_script,41,39,00:00:14,14,00:03:28,0,546
2017-07-14-ccc_tax_script,2017/07/14,ccc_tax_script,20,11,00:01:32,92,00:04:59,2,1012
2017-07-14-ccc_waste_recycling_script,2017/07/14,ccc_waste_recycling_script,0,0,00:00:00,0,00:00:00,0,0
2017-07-15-ccc_311_calgary_script,2017/07/15,ccc_311_calgary_script,1397,1353,00:00:26,26,00:05:59,44,35178
2017-07-15-ccc_311_lobby_ph_script,2017/07/15,ccc_311_lobby_ph_script,0,0,00:00:00,0,00:00:00,0,0
2017-07-15-ccc_aserv_info_script,2017/07/15,ccc_aserv_info_script,0,0,00:00:00,0,00:00:00,0,0
2017-07-15-ccc_bylaw_script,2017/07/15,ccc_bylaw_script,0,0,00:00:00,0,00:00:00,0,0
2017-07-15-ccc_city_script,2017/07/15,ccc_city_script,0,0,00:00:00,0,00:00:00,0,0
2017-07-15-ccc_cty_online_script,2017/07/15,ccc_cty_online_script,0,0,00:00:00,0,00:00:00,0,0
2017-07-15-ccc_feedback_script,2017/07/15,ccc_feedback_script,0,0,00:00:00,0,00:00:00,0,0
2017-07-15-ccc_fpb_script,2017/07/15,ccc_fpb_script,1,1,00:00:18,18,00:00:18,0,18
2017-07-15-ccc_help_script,2017/07/15,ccc_help_script,2,2,00:00:46,46,00:01:30,0,92
2017-07-15-ccc_link_script,2017/07/15,ccc_link_script,0,0,00:00:00,0,00:00:00,0,0
2017-07-15-ccc_media_line_script,2017/07/15,ccc_media_line_script,1,1,00:00:05,5,00:00:05,0,5
2017-07-15-ccc_priority_script,2017/07/15,ccc_priority_script,31,30,00:00:07,7,00:00:36,1,210
2017-07-15-ccc_tax_script,2017/07/15,ccc_tax_script,3,3,00:00:11,11,00:00:14,0,33
2017-07-15-ccc_waste_recycling_script,2017/07/15,ccc_waste_recycling_script,0,0,00:00:00,0,00:00:00,0,0
2017-07-16-ccc_311_lobby_ph_script,2017/07/16,ccc_311_lobby_ph_script,0,0,00:00:00,0,00:00:00,0,0
2017-07-17-ccc_link_script,2017/07/17,ccc_link_script,0,0,00:00:00,0,00:00:00,0,0
2017-07-17-ccc_media_line_script,2017/07/17,ccc_media_line_script,1,1,00:00:06,6,00:00:06,0,6
2017-07-17-ccc_priority_script,2017/07/17,ccc_priority_script,27,27,00:00:09,9,00:01:01,0,243
2017-07-17-ccc_tax_script,2017/07/17,ccc_tax_script,12,12,00:01:54,114,00:07:06,0,1368
2017-07-17-ccc_waste_recycling_script,2017/07/17,ccc_waste_recycling_script,0,0,00:00:00,0,00:00:00,0,0
2017-07-19-ccc_fpb_script,2017/07/19,ccc_fpb_script,11,9,00:01:10,70,00:03:41,2,630
2017-07-19-ccc_help_script,2017/07/19,ccc_help_script,22,22,00:00:18,18,00:02:52,0,396
2017-07-19-ccc_link_script,2017/07/19,ccc_link_script,0,0,00:00:00,0,00:00:00,0,0
2017-07-19-ccc_media_line_script,2017/07/19,ccc_media_line_script,1,1,00:00:03,3,00:00:03,0,3
2017-07-19-ccc_priority_script,2017/07/19,ccc_priority_script,23,22,00:00:16,16,00:01:38,1,352
2017-07-19-ccc_tax_script,2017/07/19,ccc_tax_script,35,33,00:01:09,69,00:03:34,2,2277
2017-07-19-ccc_waste_recycling_script,2017/07/19,ccc_waste_recycling_script,0,0,00:00:00,0,00:00:00,0,0
2017-07-16-ccc_311_calgary_script,2017/07/16,ccc_311_calgary_script,1139,1097,00:00:29,29,00:07:38,42,31813
2017-07-16-ccc_aserv_info_script,2017/07/16,ccc_aserv_info_script,0,0,00:00:00,0,00:00:00,0,0
2017-07-16-ccc_bylaw_script,2017/07/16,ccc_bylaw_script,0,0,00:00:00,0,00:00:00,0,0
2017-07-16-ccc_city_script,2017/07/16,ccc_city_script,0,0,00:00:00,0,00:00:00,0,0
2017-07-16-ccc_cty_online_script,2017/07/16,ccc_cty_online_script,0,0,00:00:00,0,00:00:00,0,0
2017-07-16-ccc_feedback_script,2017/07/16,ccc_feedback_script,0,0,00:00:00,0,00:00:00,0,0
2017-07-16-ccc_fpb_script,2017/07/16,ccc_fpb_script,0,0,00:00:00,0,00:00:00,0,0
2017-07-16-ccc_help_script,2017/07/16,ccc_help_script,8,3,00:00:31,31,00:01:28,5,93
2017-07-16-ccc_link_script,2017/07/16,ccc_link_script,0,0,00:00:00,0,00:00:00,0,0
2017-07-16-ccc_media_line_script,2017/07/16,ccc_media_line_script,0,0,00:00:00,0,00:00:00,0,0
2017-07-16-ccc_priority_script,2017/07/16,ccc_priority_script,25,23,00:00:08,8,00:00:41,2,184
2017-07-16-ccc_tax_script,2017/07/16,ccc_tax_script,0,0,00:00:00,0,00:00:00,0,0
2017-07-16-ccc_waste_recycling_script,2017/07/16,ccc_waste_recycling_script,0,0,00:00:00,0,00:00:00,0,0
2017-07-17-ccc_311_calgary_script,2017/07/17,ccc_311_calgary_script,4302,3743,00:02:19,139,00:11:02,559,520277
2017-07-17-ccc_311_lobby_ph_script,2017/07/17,ccc_311_lobby_ph_script,3,2,00:00:08,8,00:00:10,1,16
2017-07-17-ccc_aserv_info_script,2017/07/17,ccc_aserv_info_script,0,0,00:00:00,0,00:00:00,0,0
2017-07-17-ccc_bylaw_script,2017/07/17,ccc_bylaw_script,0,0,00:00:00,0,00:00:00,0,0
2017-07-17-ccc_city_script,2017/07/17,ccc_city_script,33,33,00:00:18,18,00:01:39,0,594
2017-07-17-ccc_cty_online_script,2017/07/17,ccc_cty_online_script,0,0,00:00:00,0,00:00:00,0,0
2017-07-17-ccc_feedback_script,2017/07/17,ccc_feedback_script,0,0,00:00:00,0,00:00:00,0,0
2017-07-17-ccc_fpb_script,2017/07/17,ccc_fpb_script,3,3,00:03:50,230,00:10:19,0,690
2017-07-17-ccc_help_script,2017/07/17,ccc_help_script,8,7,00:00:09,9,00:00:21,1,63
2017-07-18-ccc_311_calgary_script,2017/07/18,ccc_311_calgary_script,4608,3961,00:02:24,144,00:08:20,647,570384
2017-07-18-ccc_311_lobby_ph_script,2017/07/18,ccc_311_lobby_ph_script,6,4,00:00:13,13,00:00:16,2,52
2017-07-18-ccc_aserv_info_script,2017/07/18,ccc_aserv_info_script,0,0,00:00:00,0,00:00:00,0,0
2017-07-18-ccc_bylaw_script,2017/07/18,ccc_bylaw_script,0,0,00:00:00,0,00:00:00,0,0
2017-07-18-ccc_city_script,2017/07/18,ccc_city_script,37,35,00:00:43,43,00:05:48,2,1505
2017-07-18-ccc_cty_online_script,2017/07/18,ccc_cty_online_script,0,0,00:00:00,0,00:00:00,0,0
2017-07-18-ccc_feedback_script,2017/07/18,ccc_feedback_script,0,0,00:00:00,0,00:00:00,0,0
2017-07-18-ccc_fpb_script,2017/07/18,ccc_fpb_script,10,10,00:01:27,87,00:05:00,0,870
2017-07-18-ccc_help_script,2017/07/18,ccc_help_script,25,25,00:00:21,21,00:00:59,0,525
2017-07-18-ccc_link_script,2017/07/18,ccc_link_script,0,0,00:00:00,0,00:00:00,0,0
2017-07-18-ccc_media_line_script,2017/07/18,ccc_media_line_script,1,1,00:00:11,11,00:00:11,0,11
2017-07-18-ccc_priority_script,2017/07/18,ccc_priority_script,32,30,00:00:09,9,00:00:24,2,270
2017-07-18-ccc_tax_script,2017/07/18,ccc_tax_script,28,27,00:03:00,180,00:06:33,1,4860
2017-07-18-ccc_waste_recycling_script,2017/07/18,ccc_waste_recycling_script,0,0,00:00:00,0,00:00:00,0,0
2017-07-19-ccc_311_calgary_script,2017/07/19,ccc_311_calgary_script,4197,3770,00:01:37,97,00:13:48,427,365690
2017-07-19-ccc_311_lobby_ph_script,2017/07/19,ccc_311_lobby_ph_script,1,1,00:00:13,13,00:00:13,0,13
2017-07-19-ccc_aserv_info_script,2017/07/19,ccc_aserv_info_script,0,0,00:00:00,0,00:00:00,0,0
2017-07-19-ccc_bylaw_script,2017/07/19,ccc_bylaw_script,0,0,00:00:00,0,00:00:00,0,0
2017-07-19-ccc_city_script,2017/07/19,ccc_city_script,22,19,00:00:33,33,00:02:02,3,627
2017-07-19-ccc_cty_online_script,2017/07/19,ccc_cty_online_script,0,0,00:00:00,0,00:00:00,0,0
2017-07-19-ccc_feedback_script,2017/07/19,ccc_feedback_script,0,0,00:00:00,0,00:00:00,0,0
2017-07-20-ccc_311_calgary_script,2017/07/20,ccc_311_calgary_script,3764,3444,00:01:25,85,00:12:27,320,292740
2017-07-20-ccc_311_lobby_ph_script,2017/07/20,ccc_311_lobby_ph_script,5,4,00:00:17,17,00:00:35,1,68
2017-07-20-ccc_aserv_info_script,2017/07/20,ccc_aserv_info_script,0,0,00:00:00,0,00:00:00,0,0
2017-07-20-ccc_bylaw_script,2017/07/20,ccc_bylaw_script,0,0,00:00:00,0,00:00:00,0,0
2017-07-20-ccc_city_script,2017/07/20,ccc_city_script,21,21,00:00:30,30,00:05:01,0,630
2017-07-20-ccc_cty_online_script,2017/07/20,ccc_cty_online_script,0,0,00:00:00,0,00:00:00,0,0
2017-07-20-ccc_feedback_script,2017/07/20,ccc_feedback_script,1,0,00:00:00,0,00:00:00,0,0
2017-07-20-ccc_fpb_script,2017/07/20,ccc_fpb_script,5,2,00:03:09,189,00:04:02,3,378
2017-07-20-ccc_help_script,2017/07/20,ccc_help_script,20,20,00:00:13,13,00:00:59,0,260
2017-07-20-ccc_link_script,2017/07/20,ccc_link_script,0,0,00:00:00,0,00:00:00,0,0
2017-07-20-ccc_media_line_script,2017/07/20,ccc_media_line_script,0,0,00:00:00,0,00:00:00,0,0
2017-07-20-ccc_priority_script,2017/07/20,ccc_priority_script,25,24,00:00:09,9,00:00:44,1,216
2017-07-20-ccc_tax_script,2017/07/20,ccc_tax_script,24,24,00:01:35,95,00:05:09,0,2280
2017-07-20-ccc_waste_recycling_script,2017/07/20,ccc_waste_recycling_script,0,0,00:00:00,0,00:00:00,0,0
2017-07-21-ccc_311_calgary_script,2017/07/21,ccc_311_calgary_script,3422,2932,00:02:25,145,00:17:31,490,425140
2017-07-21-ccc_311_lobby_ph_script,2017/07/21,ccc_311_lobby_ph_script,3,3,00:00:44,44,00:01:39,0,132
2017-07-21-ccc_aserv_info_script,2017/07/21,ccc_aserv_info_script,0,0,00:00:00,0,00:00:00,0,0
2017-07-21-ccc_bylaw_script,2017/07/21,ccc_bylaw_script,0,0,00:00:00,0,00:00:00,0,0
2017-07-21-ccc_city_script,2017/07/21,ccc_city_script,23,23,00:00:47,47,00:04:18,0,1081
2017-07-21-ccc_cty_online_script,2017/07/21,ccc_cty_online_script,0,0,00:00:00,0,00:00:00,0,0
2017-07-21-ccc_feedback_script,2017/07/21,ccc_feedback_script,0,0,00:00:00,0,00:00:00,0,0
2017-07-21-ccc_fpb_script,2017/07/21,ccc_fpb_script,5,4,00:02:22,142,00:08:34,1,568
2017-07-21-ccc_help_script,2017/07/21,ccc_help_script,41,35,00:00:16,16,00:00:50,6,560
2017-07-21-ccc_link_script,2017/07/21,ccc_link_script,0,0,00:00:00,0,00:00:00,0,0
2017-07-21-ccc_media_line_script,2017/07/21,ccc_media_line_script,4,4,00:00:11,11,00:00:24,0,44
2017-07-21-ccc_priority_script,2017/07/21,ccc_priority_script,32,31,00:00:17,17,00:02:13,1,527
2017-07-21-ccc_tax_script,2017/07/21,ccc_tax_script,13,11,00:02:28,148,00:04:45,2,1628
2017-07-21-ccc_waste_recycling_script,2017/07/21,ccc_waste_recycling_script,0,0,00:00:00,0,00:00:00,0,0
2017-07-22-ccc_311_calgary_script,2017/07/22,ccc_311_calgary_script,1385,1300,00:00:41,41,00:08:09,85,53300
2017-07-22-ccc_311_lobby_ph_script,2017/07/22,ccc_311_lobby_ph_script,0,0,00:00:00,0,00:00:00,0,0
2017-07-22-ccc_aserv_info_script,2017/07/22,ccc_aserv_info_script,0,0,00:00:00,0,00:00:00,0,0
2017-07-22-ccc_bylaw_script,2017/07/22,ccc_bylaw_script,0,0,00:00:00,0,00:00:00,0,0
2017-07-22-ccc_city_script,2017/07/22,ccc_city_script,0,0,00:00:00,0,00:00:00,0,0
2017-07-22-ccc_cty_online_script,2017/07/22,ccc_cty_online_script,0,0,00:00:00,0,00:00:00,0,0
2017-07-22-ccc_feedback_script,2017/07/22,ccc_feedback_script,0,0,00:00:00,0,00:00:00,0,0
2017-07-22-ccc_fpb_script,2017/07/22,ccc_fpb_script,3,3,00:00:32,32,00:01:11,0,96
2017-07-22-ccc_help_script,2017/07/22,ccc_help_script,6,4,00:00:09,9,00:00:22,2,36
2017-07-22-ccc_link_script,2017/07/22,ccc_link_script,0,0,00:00:00,0,00:00:00,0,0
2017-07-22-ccc_media_line_script,2017/07/22,ccc_media_line_script,0,0,00:00:00,0,00:00:00,0,0
2017-07-22-ccc_priority_script,2017/07/22,ccc_priority_script,35,33,00:00:12,12,00:01:57,2,396
2017-07-22-ccc_tax_script,2017/07/22,ccc_tax_script,0,0,00:00:00,0,00:00:00,0,0
2017-07-22-ccc_waste_recycling_script,2017/07/22,ccc_waste_recycling_script,0,0,00:00:00,0,00:00:00,0,0
2017-07-23-ccc_311_calgary_script,2017/07/23,ccc_311_calgary_script,1578,1201,00:02:28,148,00:29:03,377,177748
2017-07-23-ccc_311_lobby_ph_script,2017/07/23,ccc_311_lobby_ph_script,0,0,00:00:00,0,00:00:00,0,0
2017-07-23-ccc_aserv_info_script,2017/07/23,ccc_aserv_info_script,0,0,00:00:00,0,00:00:00,0,0
2017-07-23-ccc_bylaw_script,2017/07/23,ccc_bylaw_script,0,0,00:00:00,0,00:00:00,0,0
2017-07-23-ccc_city_script,2017/07/23,ccc_city_script,0,0,00:00:00,0,00:00:00,0,0
2017-07-23-ccc_cty_online_script,2017/07/23,ccc_cty_online_script,0,0,00:00:00,0,00:00:00,0,0
2017-07-23-ccc_feedback_script,2017/07/23,ccc_feedback_script,0,0,00:00:00,0,00:00:00,0,0
2017-07-23-ccc_fpb_script,2017/07/23,ccc_fpb_script,2,0,00:00:00,0,00:00:00,2,0
2017-07-23-ccc_help_script,2017/07/23,ccc_help_script,13,9,00:00:12,12,00:00:43,4,108
2017-07-23-ccc_link_script,2017/07/23,ccc_link_script,0,0,00:00:00,0,00:00:00,0,0
2017-07-23-ccc_media_line_script,2017/07/23,ccc_media_line_script,1,1,00:00:05,5,00:00:05,0,5
2017-07-23-ccc_priority_script,2017/07/23,ccc_priority_script,38,34,00:00:20,20,00:01:26,4,680
2017-07-23-ccc_tax_script,2017/07/23,ccc_tax_script,0,0,00:00:00,0,00:00:00,0,0
2017-07-23-ccc_waste_recycling_script,2017/07/23,ccc_waste_recycling_script,0,0,00:00:00,0,00:00:00,0,0
2017-07-24-ccc_311_calgary_script,2017/07/24,ccc_311_calgary_script,4466,4004,00:01:46,106,00:09:29,462,424424
2017-07-24-ccc_311_lobby_ph_script,2017/07/24,ccc_311_lobby_ph_script,2,2,00:00:11,11,00:00:17,0,22
2017-07-24-ccc_aserv_info_script,2017/07/24,ccc_aserv_info_script,0,0,00:00:00,0,00:00:00,0,0
2017-07-24-ccc_bylaw_script,2017/07/24,ccc_bylaw_script,0,0,00:00:00,0,00:00:00,0,0
2017-07-24-ccc_city_script,2017/07/24,ccc_city_script,15,15,00:00:38,38,00:03:21,0,570
2017-07-24-ccc_cty_online_script,2017/07/24,ccc_cty_online_script,0,0,00:00:00,0,00:00:00,0,0
2017-07-24-ccc_feedback_script,2017/07/24,ccc_feedback_script,0,0,00:00:00,0,00:00:00,0,0
2017-07-24-ccc_fpb_script,2017/07/24,ccc_fpb_script,4,3,00:03:19,199,00:05:12,1,597
2017-07-24-ccc_help_script,2017/07/24,ccc_help_script,24,21,00:00:11,11,00:01:05,3,231
2017-07-24-ccc_link_script,2017/07/24,ccc_link_script,0,0,00:00:00,0,00:00:00,0,0
2017-07-24-ccc_media_line_script,2017/07/24,ccc_media_line_script,1,1,00:00:04,4,00:00:04,0,4
2017-07-24-ccc_priority_script,2017/07/24,ccc_priority_script,31,28,00:00:09,9,00:00:35,3,252
2017-07-24-ccc_tax_script,2017/07/24,ccc_tax_script,24,19,00:01:20,80,00:07:52,5,1520
2017-07-24-ccc_waste_recycling_script,2017/07/24,ccc_waste_recycling_script,0,0,00:00:00,0,00:00:00,0,0
2017-07-25-ccc_311_calgary_script,2017/07/25,ccc_311_calgary_script,4389,3950,00:01:41,101,00:11:41,439,398950
2017-07-25-ccc_311_lobby_ph_script,2017/07/25,ccc_311_lobby_ph_script,2,1,00:00:18,18,00:00:18,1,18
2017-07-25-ccc_aserv_info_script,2017/07/25,ccc_aserv_info_script,0,0,00:00:00,0,00:00:00,0,0
2017-07-25-ccc_bylaw_script,2017/07/25,ccc_bylaw_script,0,0,00:00:00,0,00:00:00,0,0
2017-07-25-ccc_city_script,2017/07/25,ccc_city_script,18,17,00:00:40,40,00:03:46,1,680
2017-07-25-ccc_cty_online_script,2017/07/25,ccc_cty_online_script,0,0,00:00:00,0,00:00:00,0,0
2017-07-25-ccc_feedback_script,2017/07/25,ccc_feedback_script,0,0,00:00:00,0,00:00:00,0,0
2017-07-25-ccc_fpb_script,2017/07/25,ccc_fpb_script,5,5,00:02:56,176,00:05:14,0,880
2017-07-25-ccc_help_script,2017/07/25,ccc_help_script,23,21,00:00:14,14,00:01:42,2,294
2017-07-25-ccc_link_script,2017/07/25,ccc_link_script,0,0,00:00:00,0,00:00:00,0,0
2017-07-25-ccc_media_line_script,2017/07/25,ccc_media_line_script,0,0,00:00:00,0,00:00:00,0,0
2017-07-25-ccc_priority_script,2017/07/25,ccc_priority_script,49,49,00:00:15,15,00:01:55,0,735
2017-07-25-ccc_tax_script,2017/07/25,ccc_tax_script,14,14,00:02:31,151,00:05:18,0,2114
2017-07-25-ccc_waste_recycling_script,2017/07/25,ccc_waste_recycling_script,0,0,00:00:00,0,00:00:00,0,0
2017-07-26-ccc_311_calgary_script,2017/07/26,ccc_311_calgary_script,4351,3655,00:02:29,149,00:13:56,696,544595
2017-07-26-ccc_311_lobby_ph_script,2017/07/26,ccc_311_lobby_ph_script,4,3,00:00:12,12,00:00:16,1,36
2017-07-26-ccc_aserv_info_script,2017/07/26,ccc_aserv_info_script,0,0,00:00:00,0,00:00:00,0,0
2017-07-26-ccc_bylaw_script,2017/07/26,ccc_bylaw_script,0,0,00:00:00,0,00:00:00,0,0
2017-07-26-ccc_city_script,2017/07/26,ccc_city_script,15,15,00:00:43,43,00:02:58,0,645
2017-07-26-ccc_cty_online_script,2017/07/26,ccc_cty_online_script,0,0,00:00:00,0,00:00:00,0,0
2017-07-26-ccc_feedback_script,2017/07/26,ccc_feedback_script,0,0,00:00:00,0,00:00:00,0,0
2017-07-26-ccc_fpb_script,2017/07/26,ccc_fpb_script,2,1,00:02:22,142,00:02:22,1,142
2017-07-26-ccc_help_script,2017/07/26,ccc_help_script,30,28,00:00:16,16,00:00:53,2,448
2017-07-26-ccc_link_script,2017/07/26,ccc_link_script,0,0,00:00:00,0,00:00:00,0,0
2017-07-26-ccc_media_line_script,2017/07/26,ccc_media_line_script,0,0,00:00:00,0,00:00:00,0,0
2017-07-26-ccc_priority_script,2017/07/26,ccc_priority_script,26,26,00:00:09,9,00:00:21,0,234
2017-07-26-ccc_tax_script,2017/07/26,ccc_tax_script,24,19,00:01:58,118,00:05:03,5,2242
2017-07-26-ccc_waste_recycling_script,2017/07/26,ccc_waste_recycling_script,0,0,00:00:00,0,00:00:00,0,0
2017-07-27-ccc_311_calgary_script,2017/07/27,ccc_311_calgary_script,3943,3623,00:01:21,81,00:07:31,320,293463
2017-07-27-ccc_311_lobby_ph_script,2017/07/27,ccc_311_lobby_ph_script,3,2,00:00:09,9,00:00:16,1,18
2017-07-27-ccc_aserv_info_script,2017/07/27,ccc_aserv_info_script,0,0,00:00:00,0,00:00:00,0,0
2017-07-27-ccc_bylaw_script,2017/07/27,ccc_bylaw_script,0,0,00:00:00,0,00:00:00,0,0
2017-07-27-ccc_city_script,2017/07/27,ccc_city_script,7,7,00:00:16,16,00:00:22,0,112
2017-07-27-ccc_cty_online_script,2017/07/27,ccc_cty_online_script,0,0,00:00:00,0,00:00:00,0,0
2017-07-27-ccc_feedback_script,2017/07/27,ccc_feedback_script,0,0,00:00:00,0,00:00:00,0,0
2017-07-27-ccc_fpb_script,2017/07/27,ccc_fpb_script,8,6,00:01:35,95,00:05:05,2,570
2017-07-27-ccc_help_script,2017/07/27,ccc_help_script,16,16,00:00:08,8,00:00:48,0,128
2017-07-27-ccc_link_script,2017/07/27,ccc_link_script,0,0,00:00:00,0,00:00:00,0,0
2017-07-27-ccc_media_line_script,2017/07/27,ccc_media_line_script,0,0,00:00:00,0,00:00:00,0,0
2017-07-27-ccc_priority_script,2017/07/27,ccc_priority_script,32,32,00:00:06,6,00:00:13,0,192
2017-07-27-ccc_tax_script,2017/07/27,ccc_tax_script,17,17,00:02:06,126,00:06:50,0,2142
2017-07-27-ccc_waste_recycling_script,2017/07/27,ccc_waste_recycling_script,0,0,00:00:00,0,00:00:00,0,0
2017-07-28-ccc_311_calgary_script,2017/07/28,ccc_311_calgary_script,3431,3307,00:00:29,29,00:06:40,124,95903
2017-07-28-ccc_311_lobby_ph_script,2017/07/28,ccc_311_lobby_ph_script,0,0,00:00:00,0,00:00:00,0,0
2017-07-28-ccc_aserv_info_script,2017/07/28,ccc_aserv_info_script,0,0,00:00:00,0,00:00:00,0,0
2017-07-28-ccc_bylaw_script,2017/07/28,ccc_bylaw_script,0,0,00:00:00,0,00:00:00,0,0
2017-07-28-ccc_city_script,2017/07/28,ccc_city_script,9,9,00:00:12,12,00:00:29,0,108
2017-07-28-ccc_cty_online_script,2017/07/28,ccc_cty_online_script,0,0,00:00:00,0,00:00:00,0,0
2017-07-28-ccc_feedback_script,2017/07/28,ccc_feedback_script,0,0,00:00:00,0,00:00:00,0,0
2017-07-28-ccc_fpb_script,2017/07/28,ccc_fpb_script,5,5,00:00:22,22,00:01:43,0,110
2017-07-28-ccc_help_script,2017/07/28,ccc_help_script,11,11,00:00:06,6,00:00:24,0,66
2017-07-28-ccc_link_script,2017/07/28,ccc_link_script,0,0,00:00:00,0,00:00:00,0,0
2017-07-28-ccc_media_line_script,2017/07/28,ccc_media_line_script,0,0,00:00:00,0,00:00:00,0,0
2017-07-28-ccc_priority_script,2017/07/28,ccc_priority_script,42,42,00:00:15,15,00:04:08,0,630
2017-07-28-ccc_tax_script,2017/07/28,ccc_tax_script,20,18,00:00:34,34,00:02:22,2,612
2017-07-28-ccc_waste_recycling_script,2017/07/28,ccc_waste_recycling_script,0,0,00:00:00,0,00:00:00,0,0
2017-07-29-ccc_311_calgary_script,2017/07/29,ccc_311_calgary_script,1418,1348,00:00:45,45,00:10:21,70,60660
2017-07-29-ccc_311_lobby_ph_script,2017/07/29,ccc_311_lobby_ph_script,0,0,00:00:00,0,00:00:00,0,0
2017-07-29-ccc_aserv_info_script,2017/07/29,ccc_aserv_info_script,0,0,00:00:00,0,00:00:00,0,0
2017-07-29-ccc_bylaw_script,2017/07/29,ccc_bylaw_script,0,0,00:00:00,0,00:00:00,0,0
2017-07-29-ccc_city_script,2017/07/29,ccc_city_script,0,0,00:00:00,0,00:00:00,0,0
2017-07-29-ccc_cty_online_script,2017/07/29,ccc_cty_online_script,0,0,00:00:00,0,00:00:00,0,0
2017-07-29-ccc_feedback_script,2017/07/29,ccc_feedback_script,0,0,00:00:00,0,00:00:00,0,0
2017-07-29-ccc_fpb_script,2017/07/29,ccc_fpb_script,0,0,00:00:00,0,00:00:00,0,0
2017-07-29-ccc_help_script,2017/07/29,ccc_help_script,6,5,00:00:07,7,00:00:16,1,35
2017-07-29-ccc_link_script,2017/07/29,ccc_link_script,0,0,00:00:00,0,00:00:00,0,0
2017-07-29-ccc_media_line_script,2017/07/29,ccc_media_line_script,1,1,00:00:02,2,00:00:02,0,2
2017-07-29-ccc_priority_script,2017/07/29,ccc_priority_script,21,21,00:00:11,11,00:01:01,0,231
2017-07-29-ccc_tax_script,2017/07/29,ccc_tax_script,0,0,00:00:00,0,00:00:00,0,0
2017-07-29-ccc_waste_recycling_script,2017/07/29,ccc_waste_recycling_script,0,0,00:00:00,0,00:00:00,0,0
2017-07-30-ccc_311_calgary_script,2017/07/30,ccc_311_calgary_script,1334,1197,00:01:03,63,00:10:07,137,75411
2017-07-30-ccc_311_lobby_ph_script,2017/07/30,ccc_311_lobby_ph_script,0,0,00:00:00,0,00:00:00,0,0
2017-07-30-ccc_aserv_info_script,2017/07/30,ccc_aserv_info_script,0,0,00:00:00,0,00:00:00,0,0
2017-07-30-ccc_bylaw_script,2017/07/30,ccc_bylaw_script,0,0,00:00:00,0,00:00:00,0,0
2017-07-30-ccc_city_script,2017/07/30,ccc_city_script,0,0,00:00:00,0,00:00:00,0,0
2017-07-30-ccc_cty_online_script,2017/07/30,ccc_cty_online_script,0,0,00:00:00,0,00:00:00,0,0
2017-07-30-ccc_feedback_script,2017/07/30,ccc_feedback_script,0,0,00:00:00,0,00:00:00,0,0
2017-07-30-ccc_fpb_script,2017/07/30,ccc_fpb_script,2,2,00:00:13,13,00:00:18,0,26
2017-07-30-ccc_help_script,2017/07/30,ccc_help_script,14,11,00:00:12,12,00:00:43,3,132
2017-07-30-ccc_link_script,2017/07/30,ccc_link_script,0,0,00:00:00,0,00:00:00,0,0
2017-07-30-ccc_media_line_script,2017/07/30,ccc_media_line_script,0,0,00:00:00,0,00:00:00,0,0
2017-07-30-ccc_priority_script,2017/07/30,ccc_priority_script,20,20,00:00:34,34,00:02:33,0,680
2017-07-30-ccc_tax_script,2017/07/30,ccc_tax_script,0,0,00:00:00,0,00:00:00,0,0
2017-07-30-ccc_waste_recycling_script,2017/07/30,ccc_waste_recycling_script,0,0,00:00:00,0,00:00:00,0,0
2017-07-31-ccc_311_calgary_script,2017/07/31,ccc_311_calgary_script,4125,3662,00:01:52,112,00:11:08,463,410144
2017-07-31-ccc_311_lobby_ph_script,2017/07/31,ccc_311_lobby_ph_script,0,0,00:00:00,0,00:00:00,0,0
2017-07-31-ccc_aserv_info_script,2017/07/31,ccc_aserv_info_script,0,0,00:00:00,0,00:00:00,0,0
2017-07-31-ccc_bylaw_script,2017/07/31,ccc_bylaw_script,0,0,00:00:00,0,00:00:00,0,0
2017-07-31-ccc_city_script,2017/07/31,ccc_city_script,19,19,00:00:24,24,00:01:15,0,456
2017-07-31-ccc_cty_online_script,2017/07/31,ccc_cty_online_script,0,0,00:00:00,0,00:00:00,0,0
2017-07-31-ccc_feedback_script,2017/07/31,ccc_feedback_script,0,0,00:00:00,0,00:00:00,0,0
2017-07-31-ccc_fpb_script,2017/07/31,ccc_fpb_script,3,2,00:00:44,44,00:01:24,1,88
2017-07-31-ccc_help_script,2017/07/31,ccc_help_script,15,15,00:00:11,11,00:00:48,0,165
2017-07-31-ccc_link_script,2017/07/31,ccc_link_script,0,0,00:00:00,0,00:00:00,0,0
2017-07-31-ccc_media_line_script,2017/07/31,ccc_media_line_script,0,0,00:00:00,0,00:00:00,0,0
2017-07-31-ccc_priority_script,2017/07/31,ccc_priority_script,33,31,00:00:08,8,00:00:27,2,248
2017-07-31-ccc_tax_script,2017/07/31,ccc_tax_script,21,20,00:01:12,72,00:05:44,1,1440
2017-07-31-ccc_waste_recycling_script,2017/07/31,ccc_waste_recycling_script,0,0,00:00:00,0,00:00:00,0,0
2017-08-03-ccc_link_script,2017/08/03,ccc_link_script,0,0,00:00:00,0,00:00:00,0,0
2017-08-08-ccc_311_calgary_script,2017/08/08,ccc_311_calgary_script,4037,3658,00:01:35,95,00:07:33,379,347510
2017-08-08-ccc_311_lobby_ph_script,2017/08/08,ccc_311_lobby_ph_script,3,2,00:00:20,20,00:00:29,1,40
2017-08-08-ccc_aserv_info_script,2017/08/08,ccc_aserv_info_script,0,0,00:00:00,0,00:00:00,0,0
2017-08-08-ccc_bylaw_script,2017/08/08,ccc_bylaw_script,0,0,00:00:00,0,00:00:00,0,0
2017-08-08-ccc_city_script,2017/08/08,ccc_city_script,24,22,00:00:29,29,00:03:22,2,638
2017-08-08-ccc_cty_online_script,2017/08/08,ccc_cty_online_script,0,0,00:00:00,0,00:00:00,0,0
2017-08-08-ccc_feedback_script,2017/08/08,ccc_feedback_script,0,0,00:00:00,0,00:00:00,0,0
2017-08-08-ccc_fpb_script,2017/08/08,ccc_fpb_script,2,1,00:00:04,4,00:00:04,1,4
2017-08-08-ccc_help_script,2017/08/08,ccc_help_script,28,28,00:00:11,11,00:00:39,0,308
2017-08-08-ccc_link_script,2017/08/08,ccc_link_script,0,0,00:00:00,0,00:00:00,0,0
2017-08-08-ccc_media_line_script,2017/08/08,ccc_media_line_script,0,0,00:00:00,0,00:00:00,0,0
2017-08-08-ccc_priority_script,2017/08/08,ccc_priority_script,36,35,00:00:07,7,00:00:36,1,245
2017-08-08-ccc_tax_script,2017/08/08,ccc_tax_script,20,18,00:01:53,113,00:04:33,2,2034
2017-08-08-ccc_waste_recycling_script,2017/08/08,ccc_waste_recycling_script,0,0,00:00:00,0,00:00:00,0,0
2017-08-09-ccc_fpb_script,2017/08/09,ccc_fpb_script,3,2,00:02:23,143,00:04:19,1,286
2017-08-09-ccc_help_script,2017/08/09,ccc_help_script,31,30,00:00:13,13,00:00:39,1,390
2017-08-09-ccc_link_script,2017/08/09,ccc_link_script,0,0,00:00:00,0,00:00:00,0,0
2017-08-09-ccc_media_line_script,2017/08/09,ccc_media_line_script,0,0,00:00:00,0,00:00:00,0,0
2017-08-09-ccc_priority_script,2017/08/09,ccc_priority_script,29,28,00:00:15,15,00:00:54,1,420
2017-08-09-ccc_tax_script,2017/08/09,ccc_tax_script,25,22,00:02:25,145,00:06:20,3,3190
2017-08-09-ccc_waste_recycling_script,2017/08/09,ccc_waste_recycling_script,0,0,00:00:00,0,00:00:00,0,0
2017-08-10-ccc_311_calgary_script,2017/08/10,ccc_311_calgary_script,3519,3280,00:01:09,69,00:09:31,239,226320
2017-08-10-ccc_311_lobby_ph_script,2017/08/10,ccc_311_lobby_ph_script,2,2,00:00:06,6,00:00:08,0,12
2017-08-10-ccc_aserv_info_script,2017/08/10,ccc_aserv_info_script,0,0,00:00:00,0,00:00:00,0,0
2017-08-10-ccc_bylaw_script,2017/08/10,ccc_bylaw_script,0,0,00:00:00,0,00:00:00,0,0
2017-08-10-ccc_city_script,2017/08/10,ccc_city_script,12,12,00:00:24,24,00:02:01,0,288
2017-08-10-ccc_cty_online_script,2017/08/10,ccc_cty_online_script,0,0,00:00:00,0,00:00:00,0,0
2017-08-10-ccc_feedback_script,2017/08/10,ccc_feedback_script,0,0,00:00:00,0,00:00:00,0,0
2017-08-11-ccc_311_calgary_script,2017/08/11,ccc_311_calgary_script,3317,3095,00:00:56,56,00:18:15,222,173320
2017-08-11-ccc_311_lobby_ph_script,2017/08/11,ccc_311_lobby_ph_script,2,2,00:00:03,3,00:00:04,0,6
2017-08-11-ccc_aserv_info_script,2017/08/11,ccc_aserv_info_script,0,0,00:00:00,0,00:00:00,0,0
2017-08-11-ccc_bylaw_script,2017/08/11,ccc_bylaw_script,0,0,00:00:00,0,00:00:00,0,0
2017-08-11-ccc_city_script,2017/08/11,ccc_city_script,9,8,00:00:14,14,00:00:47,1,112
2017-08-11-ccc_cty_online_script,2017/08/11,ccc_cty_online_script,0,0,00:00:00,0,00:00:00,0,0
2017-08-11-ccc_feedback_script,2017/08/11,ccc_feedback_script,0,0,00:00:00,0,00:00:00,0,0
2017-08-11-ccc_fpb_script,2017/08/11,ccc_fpb_script,4,2,00:00:04,4,00:00:05,2,8
2017-08-11-ccc_help_script,2017/08/11,ccc_help_script,14,13,00:00:13,13,00:01:06,1,169
2017-08-11-ccc_link_script,2017/08/11,ccc_link_script,0,0,00:00:00,0,00:00:00,0,0
2017-08-11-ccc_media_line_script,2017/08/11,ccc_media_line_script,0,0,00:00:00,0,00:00:00,0,0
2017-08-11-ccc_priority_script,2017/08/11,ccc_priority_script,33,32,00:00:08,8,00:01:24,1,256
2017-08-11-ccc_tax_script,2017/08/11,ccc_tax_script,22,22,00:00:44,44,00:03:49,0,968
2017-08-12-ccc_help_script,2017/08/12,ccc_help_script,4,2,00:00:18,18,00:00:25,2,36
2017-08-12-ccc_link_script,2017/08/12,ccc_link_script,0,0,00:00:00,0,00:00:00,0,0
2017-08-12-ccc_media_line_script,2017/08/12,ccc_media_line_script,2,2,00:00:06,6,00:00:08,0,12
2017-08-12-ccc_priority_script,2017/08/12,ccc_priority_script,22,22,00:00:09,9,00:00:21,0,198
2017-08-12-ccc_tax_script,2017/08/12,ccc_tax_script,0,0,00:00:00,0,00:00:00,0,0
2017-08-12-ccc_waste_recycling_script,2017/08/12,ccc_waste_recycling_script,0,0,00:00:00,0,00:00:00,0,0
2017-08-13-ccc_311_calgary_script,2017/08/13,ccc_311_calgary_script,1080,1025,00:00:31,31,00:05:54,55,31775
2017-08-13-ccc_311_lobby_ph_script,2017/08/13,ccc_311_lobby_ph_script,0,0,00:00:00,0,00:00:00,0,0
2017-08-13-ccc_aserv_info_script,2017/08/13,ccc_aserv_info_script,0,0,00:00:00,0,00:00:00,0,0
2017-08-13-ccc_bylaw_script,2017/08/13,ccc_bylaw_script,0,0,00:00:00,0,00:00:00,0,0
2017-08-13-ccc_city_script,2017/08/13,ccc_city_script,0,0,00:00:00,0,00:00:00,0,0
2017-08-13-ccc_cty_online_script,2017/08/13,ccc_cty_online_script,0,0,00:00:00,0,00:00:00,0,0
2017-08-13-ccc_feedback_script,2017/08/13,ccc_feedback_script,0,0,00:00:00,0,00:00:00,0,0
2017-08-13-ccc_fpb_script,2017/08/13,ccc_fpb_script,1,1,00:02:06,126,00:02:06,0,126
2017-08-19-ccc_aserv_info_script,2017/08/19,ccc_aserv_info_script,0,0,00:00:00,0,00:00:00,0,0
2017-08-19-ccc_bylaw_script,2017/08/19,ccc_bylaw_script,0,0,00:00:00,0,00:00:00,0,0
2017-08-19-ccc_city_script,2017/08/19,ccc_city_script,0,0,00:00:00,0,00:00:00,0,0
2017-08-19-ccc_cty_online_script,2017/08/19,ccc_cty_online_script,0,0,00:00:00,0,00:00:00,0,0
2017-08-19-ccc_feedback_script,2017/08/19,ccc_feedback_script,0,0,00:00:00,0,00:00:00,0,0
2017-08-19-ccc_fpb_script,2017/08/19,ccc_fpb_script,3,2,00:00:11,11,00:00:14,1,22
2017-08-19-ccc_help_script,2017/08/19,ccc_help_script,7,6,00:00:08,8,00:00:16,1,48
2017-08-19-ccc_link_script,2017/08/19,ccc_link_script,0,0,00:00:00,0,00:00:00,0,0
2017-08-19-ccc_media_line_script,2017/08/19,ccc_media_line_script,5,5,00:00:04,4,00:00:05,0,20
2017-08-19-ccc_priority_script,2017/08/19,ccc_priority_script,21,21,00:00:12,12,00:02:12,0,252
2017-08-22-ccc_311_calgary_script,2017/08/22,ccc_311_calgary_script,3840,3552,00:01:04,64,00:08:35,288,227328
2017-08-22-ccc_311_lobby_ph_script,2017/08/22,ccc_311_lobby_ph_script,0,0,00:00:00,0,00:00:00,0,0
2017-08-22-ccc_aserv_info_script,2017/08/22,ccc_aserv_info_script,0,0,00:00:00,0,00:00:00,0,0
2017-08-22-ccc_bylaw_script,2017/08/22,ccc_bylaw_script,0,0,00:00:00,0,00:00:00,0,0
2017-08-25-ccc_311_calgary_script,2017/08/25,ccc_311_calgary_script,3327,2877,00:02:15,135,00:07:56,450,388395
2017-08-25-ccc_311_lobby_ph_script,2017/08/25,ccc_311_lobby_ph_script,2,2,00:00:08,8,00:00:12,0,16
2017-08-25-ccc_aserv_info_script,2017/08/25,ccc_aserv_info_script,0,0,00:00:00,0,00:00:00,0,0
2017-08-25-ccc_bylaw_script,2017/08/25,ccc_bylaw_script,0,0,00:00:00,0,00:00:00,0,0
2017-08-25-ccc_city_script,2017/08/25,ccc_city_script,19,19,00:01:06,66,00:06:09,0,1254
2017-08-25-ccc_cty_online_script,2017/08/25,ccc_cty_online_script,0,0,00:00:00,0,00:00:00,0,0
2017-08-25-ccc_feedback_script,2017/08/25,ccc_feedback_script,0,0,00:00:00,0,00:00:00,0,0
2017-08-25-ccc_fpb_script,2017/08/25,ccc_fpb_script,6,4,00:02:07,127,00:04:22,2,508
2017-08-25-ccc_help_script,2017/08/25,ccc_help_script,11,10,00:00:16,16,00:00:45,1,160
2017-08-25-ccc_link_script,2017/08/25,ccc_link_script,0,0,00:00:00,0,00:00:00,0,0
2017-08-25-ccc_media_line_script,2017/08/25,ccc_media_line_script,0,0,00:00:00,0,00:00:00,0,0
2017-08-25-ccc_priority_script,2017/08/25,ccc_priority_script,33,32,00:00:08,8,00:00:38,1,256
2017-08-25-ccc_tax_script,2017/08/25,ccc_tax_script,23,20,00:02:06,126,00:05:38,3,2520
2017-08-25-ccc_waste_recycling_script,2017/08/25,ccc_waste_recycling_script,0,0,00:00:00,0,00:00:00,0,0
2017-08-26-ccc_311_calgary_script,2017/08/26,ccc_311_calgary_script,1434,1346,00:00:42,42,00:07:08,87,56532
2017-08-26-ccc_311_lobby_ph_script,2017/08/26,ccc_311_lobby_ph_script,0,0,00:00:00,0,00:00:00,0,0
2017-08-26-ccc_aserv_info_script,2017/08/26,ccc_aserv_info_script,0,0,00:00:00,0,00:00:00,0,0
2017-08-26-ccc_bylaw_script,2017/08/26,ccc_bylaw_script,0,0,00:00:00,0,00:00:00,0,0
2017-08-26-ccc_city_script,2017/08/26,ccc_city_script,0,0,00:00:00,0,00:00:00,0,0
2017-08-26-ccc_cty_online_script,2017/08/26,ccc_cty_online_script,0,0,00:00:00,0,00:00:00,0,0
2017-08-26-ccc_feedback_script,2017/08/26,ccc_feedback_script,0,0,00:00:00,0,00:00:00,0,0
2017-08-26-ccc_fpb_script,2017/08/26,ccc_fpb_script,4,4,00:01:53,113,00:05:19,0,452
2017-08-26-ccc_help_script,2017/08/26,ccc_help_script,10,7,00:00:42,42,00:03:40,3,294
2017-08-26-ccc_link_script,2017/08/26,ccc_link_script,0,0,00:00:00,0,00:00:00,0,0
2017-08-26-ccc_media_line_script,2017/08/26,ccc_media_line_script,1,1,00:00:12,12,00:00:12,0,12
2017-08-26-ccc_priority_script,2017/08/26,ccc_priority_script,25,23,00:00:08,8,00:00:47,2,184
2017-08-26-ccc_tax_script,2017/08/26,ccc_tax_script,0,0,00:00:00,0,00:00:00,0,0
2017-08-26-ccc_waste_recycling_script,2017/08/26,ccc_waste_recycling_script,0,0,00:00:00,0,00:00:00,0,0
2014-01-01-ccc_311_calgary_combined,2014/01/01,ccc_311_calgary_combined,2353,1782,0:02:40,160,,571,285120
2014-01-01-ccc_priority_script,2014/01/01,ccc_priority_script,35,35,0:00:15,15,,0,525
2014-01-02-ccc_311_calgary_combined,2014/01/02,ccc_311_calgary_combined,4283,3450,0:02:41,161,,833,555450
2014-01-02-ccc_priority_script,2014/01/02,ccc_priority_script,22,21,0:00:13,13,,1,273
2014-01-02-ccc_tax_script,2014/01/02,ccc_tax_script,17,17,0:02:32,152,,0,2584
2014-01-03-ccc_311_calgary_combined,2014/01/03,ccc_311_calgary_combined,4963,3707,0:03:44,224,,1256,830368
2014-01-03-ccc_priority_script,2014/01/03,ccc_priority_script,72,69,0:00:15,15,,3,1035
2014-01-03-ccc_tax_script,2014/01/03,ccc_tax_script,5,3,0:06:32,392,,2,1176
2014-01-04-ccc_311_calgary_combined,2014/01/04,ccc_311_calgary_combined,2793,1562,0:09:23,563,,1231,879406
2014-01-04-ccc_priority_script,2014/01/04,ccc_priority_script,44,44,0:00:37,37,,0,1628
2014-01-04-ccc_tax_script,2014/01/04,ccc_tax_script,1,0,0:00:00,0,,1,0
2014-01-05-ccc_311_calgary_combined,2014/01/05,ccc_311_calgary_combined,1379,1067,0:03:02,182,,312,194194
2014-01-05-ccc_priority_script,2014/01/05,ccc_priority_script,28,28,0:00:28,28,,0,784
2014-01-06-ccc_311_calgary_combined,2014/01/06,ccc_311_calgary_combined,5177,3600,0:05:49,349,,1577,1256400
2014-01-06-ccc_priority_script,2014/01/06,ccc_priority_script,19,19,0:00:18,18,,0,342
2014-01-06-ccc_tax_script,2014/01/06,ccc_tax_script,29,21,0:08:27,507,,8,10647
2014-01-07-ccc_311_calgary_combined,2014/01/07,ccc_311_calgary_combined,5056,3609,0:04:54,294,,1447,1061046
2014-01-07-ccc_priority_script,2014/01/07,ccc_priority_script,38,37,0:00:20,20,,1,740
2014-01-07-ccc_tax_script,2014/01/07,ccc_tax_script,18,14,0:06:43,403,,4,5642
2014-01-08-ccc_311_calgary_combined,2014/01/08,ccc_311_calgary_combined,4611,3918,0:02:15,135,,693,528930
2014-01-08-ccc_priority_script,2014/01/08,ccc_priority_script,46,45,0:00:11,11,,1,495
2014-01-08-ccc_tax_script,2014/01/08,ccc_tax_script,26,25,0:02:57,177,,1,4425
2014-01-09-ccc_311_calgary_combined,2014/01/09,ccc_311_calgary_combined,4688,3531,0:04:02,242,,1157,854502
2014-01-09-ccc_priority_script,2014/01/09,ccc_priority_script,45,42,0:00:20,20,,3,840
2014-01-09-ccc_tax_script,2014/01/09,ccc_tax_script,29,21,0:04:29,269,,8,5649
2014-01-10-ccc_311_calgary_combined,2014/01/10,ccc_311_calgary_combined,4627,3273,0:04:51,291,,1354,952443
2014-01-10-ccc_priority_script,2014/01/10,ccc_priority_script,39,37,0:00:37,37,,2,1369
2014-01-10-ccc_tax_script,2014/01/10,ccc_tax_script,25,19,0:05:31,331,,6,6289
2014-01-11-ccc_311_calgary_combined,2014/01/11,ccc_311_calgary_combined,2027,1508,0:03:13,193,,519,291044
2014-01-11-ccc_priority_script,2014/01/11,ccc_priority_script,26,24,0:00:31,31,,2,744
2014-01-12-ccc_311_calgary_combined,2014/01/12,ccc_311_calgary_combined,1412,1132,0:02:30,150,,280,169800
2014-01-12-ccc_priority_script,2014/01/12,ccc_priority_script,28,26,0:00:27,27,,2,702
2014-01-12-ccc_tax_script,2014/01/12,ccc_tax_script,1,1,0:02:53,173,,0,173
2014-01-13-ccc_311_calgary_combined,2014/01/13,ccc_311_calgary_combined,5162,3627,0:04:58,298,,1535,1080846
2014-01-13-ccc_priority_script,2014/01/13,ccc_priority_script,57,54,0:00:19,19,,3,1026
2014-01-13-ccc_tax_script,2014/01/13,ccc_tax_script,11,8,0:04:04,244,,3,1952
2014-01-14-ccc_311_calgary_combined,2014/01/14,ccc_311_calgary_combined,5563,3381,0:07:49,469,,2182,1585689
2014-01-14-ccc_priority_script,2014/01/14,ccc_priority_script,50,47,0:00:14,14,,3,658
2014-01-14-ccc_tax_script,2014/01/14,ccc_tax_script,10,5,0:10:29,629,,5,3145
2014-01-15-ccc_311_calgary_combined,2014/01/15,ccc_311_calgary_combined,8418,3150,0:21:15,1275,,5268,4016250
2014-01-15-ccc_priority_script,2014/01/15,ccc_priority_script,42,39,0:00:17,17,,3,663
2014-01-15-ccc_tax_script,2014/01/15,ccc_tax_script,27,11,0:21:13,1273,,16,14003
2014-01-16-ccc_311_calgary_combined,2014/01/16,ccc_311_calgary_combined,6344,3526,0:10:45,645,,2818,2274270
2014-01-16-ccc_priority_script,2014/01/16,ccc_priority_script,38,33,0:00:28,28,,5,924
2014-01-16-ccc_tax_script,2014/01/16,ccc_tax_script,25,9,0:14:51,891,,16,8019
2014-01-17-ccc_311_calgary_combined,2014/01/17,ccc_311_calgary_combined,4525,3249,0:04:05,245,,1276,796005
2014-01-17-ccc_priority_script,2014/01/17,ccc_priority_script,34,34,0:00:14,14,,0,476
2014-01-17-ccc_tax_script,2014/01/17,ccc_tax_script,20,16,0:03:24,204,,4,3264
2014-01-18-ccc_311_calgary_combined,2014/01/18,ccc_311_calgary_combined,2041,1881,0:00:43,43,,160,80883
2014-01-18-ccc_priority_script,2014/01/18,ccc_priority_script,28,24,0:00:18,18,,4,432
2014-01-18-ccc_tax_script,2014/01/18,ccc_tax_script,1,1,0:01:39,99,,0,99
2014-01-19-ccc_311_calgary_combined,2014/01/19,ccc_311_calgary_combined,1903,1629,0:01:33,93,,274,151497
2014-01-19-ccc_priority_script,2014/01/19,ccc_priority_script,31,30,0:00:31,31,,1,930
2014-01-19-ccc_tax_script,2014/01/19,ccc_tax_script,2,2,0:00:49,49,,0,98
2014-01-20-ccc_311_calgary_combined,2014/01/20,ccc_311_calgary_combined,5679,3295,0:09:22,562,,2384,1851790
2014-01-20-ccc_priority_script,2014/01/20,ccc_priority_script,37,34,0:00:39,39,,3,1326
2014-01-20-ccc_tax_script,2014/01/20,ccc_tax_script,22,11,0:06:55,415,,11,4565
2014-01-21-ccc_311_calgary_combined,2014/01/21,ccc_311_calgary_combined,5761,3172,0:11:14,674,,2589,2137928
2014-01-21-ccc_priority_script,2014/01/21,ccc_priority_script,75,71,0:00:25,25,,4,1775
2014-01-21-ccc_tax_script,2014/01/21,ccc_tax_script,36,18,0:09:28,568,,18,10224
2014-01-22-ccc_311_calgary_combined,2014/01/22,ccc_311_calgary_combined,4617,3476,0:04:31,271,,1141,941996
2014-01-22-ccc_priority_script,2014/01/22,ccc_priority_script,55,54,0:00:11,11,,1,594
2014-01-22-ccc_tax_script,2014/01/22,ccc_tax_script,20,17,0:01:18,78,,3,1326
2014-01-23-ccc_311_calgary_combined,2014/01/23,ccc_311_calgary_combined,5499,3361,0:08:25,505,,2138,1697305
2014-01-23-ccc_priority_script,2014/01/23,ccc_priority_script,39,36,0:00:17,17,,3,612
2014-01-23-ccc_tax_script,2014/01/23,ccc_tax_script,29,18,0:09:32,572,,11,10296
2014-01-24-ccc_311_calgary_combined,2014/01/24,ccc_311_calgary_combined,5369,3337,0:02:04,124,,2032,413788
2014-01-24-ccc_priority_script,2014/01/24,ccc_priority_script,44,42,0:00:12,12,,2,504
2014-01-24-ccc_tax_script,2014/01/24,ccc_tax_script,19,16,0:00:02,2,,3,32
2014-01-25-ccc_311_calgary_combined,2014/01/25,ccc_311_calgary_combined,2558,1413,0:09:37,577,,1145,815301
2014-01-25-ccc_priority_script,2014/01/25,ccc_priority_script,28,24,0:00:35,35,,4,840
2014-01-26-ccc_311_calgary_combined,2014/01/26,ccc_311_calgary_combined,1526,1295,0:02:04,124,,231,160580
2014-01-26-ccc_priority_script,2014/01/26,ccc_priority_script,22,21,0:00:12,12,,1,252
2014-01-26-ccc_tax_script,2014/01/26,ccc_tax_script,4,1,0:00:02,2,,3,2
2014-01-27-ccc_311_calgary_combined,2014/01/27,ccc_311_calgary_combined,4806,3828,0:03:32,212,,978,811536
2014-01-27-ccc_priority_script,2014/01/27,ccc_priority_script,31,28,0:00:14,14,,3,392
2014-01-27-ccc_tax_script,2014/01/27,ccc_tax_script,27,18,0:03:11,191,,9,3438
2014-01-28-ccc_311_calgary_combined,2014/01/28,ccc_311_calgary_combined,4597,3691,0:03:00,180,,906,664380
2014-01-28-ccc_priority_script,2014/01/28,ccc_priority_script,31,28,0:00:13,13,,3,364
2014-01-28-ccc_tax_script,2014/01/28,ccc_tax_script,16,12,0:03:29,209,,4,2508
2014-01-29-ccc_311_calgary_combined,2014/01/29,ccc_311_calgary_combined,3949,3514,0:01:25,85,,435,298690
2014-01-29-ccc_priority_script,2014/01/29,ccc_priority_script,51,49,0:00:13,13,,2,637
2014-01-29-ccc_tax_script,2014/01/29,ccc_tax_script,22,19,0:01:34,94,,3,1786
2014-01-30-ccc_311_calgary_combined,2014/01/30,ccc_311_calgary_combined,3404,3307,0:00:20,20,,97,66140
2014-01-30-ccc_priority_script,2014/01/30,ccc_priority_script,31,31,0:00:10,10,,0,310
2014-01-30-ccc_tax_script,2014/01/30,ccc_tax_script,11,10,0:00:38,38,,1,380
2014-01-31-ccc_311_calgary_combined,2014/01/31,ccc_311_calgary_combined,3131,2985,0:00:33,33,,146,98505
2014-01-31-ccc_priority_script,2014/01/31,ccc_priority_script,34,33,0:00:11,11,,1,363
2014-01-31-ccc_tax_script,2014/01/31,ccc_tax_script,27,25,0:00:33,33,,2,825
2014-02-01-ccc_311_calgary_combined,2014/02/01,ccc_311_calgary_combined,1299,1243,0:00:17,17,,56,21131
2014-02-01-ccc_priority_script,2014/02/01,ccc_priority_script,12,12,0:00:11,11,,0,132
2014-02-01-ccc_tax_script,2014/02/01,ccc_tax_script,2,2,0:02:29,149,,0,298
2014-02-02-ccc_311_calgary_combined,2014/02/02,ccc_311_calgary_combined,896,882,0:00:11,11,,14,9702
2014-02-02-ccc_priority_script,2014/02/02,ccc_priority_script,8,8,0:00:05,5,,0,40
2014-02-03-ccc_311_calgary_combined,2014/02/03,ccc_311_calgary_combined,3370,3235,0:00:26,26,,135,84110
2014-02-03-ccc_priority_script,2014/02/03,ccc_priority_script,26,23,0:00:07,7,,3,161
2014-02-03-ccc_tax_script,2014/02/03,ccc_tax_script,17,16,0:00:21,21,,1,336
2014-02-04-ccc_311_calgary_combined,2014/02/04,ccc_311_calgary_combined,3292,3172,0:00:25,25,,120,79300
2014-02-04-ccc_priority_script,2014/02/04,ccc_priority_script,27,27,0:00:11,11,,0,297
2014-02-04-ccc_tax_script,2014/02/04,ccc_tax_script,16,16,0:00:29,29,,0,464
2014-02-05-ccc_311_calgary_combined,2014/02/05,ccc_311_calgary_combined,3269,3193,0:00:13,13,,76,41509
2014-02-05-ccc_priority_script,2014/02/05,ccc_priority_script,47,45,0:00:06,6,,2,270
2014-02-05-ccc_tax_script,2014/02/05,ccc_tax_script,17,17,0:00:15,15,,0,255
2014-02-06-ccc_311_calgary_combined,2014/02/06,ccc_311_calgary_combined,3231,3203,0:00:08,8,,28,25624
2014-02-06-ccc_priority_script,2014/02/06,ccc_priority_script,39,37,0:00:09,9,,2,333
2014-02-06-ccc_tax_script,2014/02/06,ccc_tax_script,16,16,0:00:10,10,,0,160
2014-02-07-ccc_311_calgary_combined,2014/02/07,ccc_311_calgary_combined,2945,2885,0:00:17,17,,60,49045
2014-02-07-ccc_priority_script,2014/02/07,ccc_priority_script,30,29,0:00:07,7,,1,203
2014-02-07-ccc_tax_script,2014/02/07,ccc_tax_script,15,15,0:00:13,13,,0,195
2014-02-08-ccc_311_calgary_combined,2014/02/08,ccc_311_calgary_combined,1279,1262,0:00:07,7,,17,8834
2014-02-08-ccc_priority_script,2014/02/08,ccc_priority_script,27,25,0:00:15,15,,2,375
2014-02-08-ccc_tax_script,2014/02/08,ccc_tax_script,1,1,0:00:05,5,,0,5
2014-02-09-ccc_311_calgary_combined,2014/02/09,ccc_311_calgary_combined,835,830,0:00:06,6,,5,4980
2014-02-09-ccc_priority_script,2014/02/09,ccc_priority_script,15,14,0:00:11,11,,1,154
2014-02-09-ccc_tax_script,2014/02/09,ccc_tax_script,1,1,0:00:04,4,,0,4
2014-02-10-ccc_311_calgary_combined,2014/02/10,ccc_311_calgary_combined,3411,3359,0:00:12,12,,52,40308
2014-02-10-ccc_priority_script,2014/02/10,ccc_priority_script,23,21,0:00:09,9,,2,189
2014-02-10-ccc_tax_script,2014/02/10,ccc_tax_script,15,13,0:00:16,16,,2,208
2014-02-11-ccc_311_calgary_combined,2014/02/11,ccc_311_calgary_combined,3287,3225,0:00:13,13,,62,41925
2014-02-11-ccc_priority_script,2014/02/11,ccc_priority_script,32,32,0:00:08,8,,0,256
2014-02-11-ccc_tax_script,2014/02/11,ccc_tax_script,16,16,0:00:17,17,,0,272
2014-02-12-ccc_311_calgary_combined,2014/02/12,ccc_311_calgary_combined,3164,3119,0:00:09,9,,45,28071
2014-02-12-ccc_priority_script,2014/02/12,ccc_priority_script,29,28,0:00:09,9,,1,252
2014-02-12-ccc_tax_script,2014/02/12,ccc_tax_script,17,17,0:00:06,6,,0,102
2014-02-13-ccc_311_calgary_combined,2014/02/13,ccc_311_calgary_combined,3064,3003,0:00:10,10,,61,30030
2014-02-13-ccc_priority_script,2014/02/13,ccc_priority_script,36,35,0:00:06,6,,1,210
2014-02-13-ccc_tax_script,2014/02/13,ccc_tax_script,17,17,0:00:11,11,,0,187
2014-02-14-ccc_311_calgary_combined,2014/02/14,ccc_311_calgary_combined,2755,2726,0:00:09,9,,29,24534
2014-02-14-ccc_priority_script,2014/02/14,ccc_priority_script,29,28,0:00:09,9,,1,252
2014-02-14-ccc_tax_script,2014/02/14,ccc_tax_script,13,13,0:00:06,6,,0,78
2014-02-15-ccc_311_calgary_combined,2014/02/15,ccc_311_calgary_combined,1239,1208,0:00:09,9,,31,10872
2014-02-15-ccc_priority_script,2014/02/15,ccc_priority_script,23,23,0:00:05,5,,0,115
2014-02-15-ccc_tax_script,2014/02/15,ccc_tax_script,1,1,0:00:26,26,,0,26
2014-02-16-ccc_311_calgary_combined,2014/02/16,ccc_311_calgary_combined,1250,1182,0:00:24,24,,68,28368
2014-02-16-ccc_priority_script,2014/02/16,ccc_priority_script,24,24,0:00:21,21,,0,504
2014-02-17-ccc_311_calgary_combined,2014/02/17,ccc_311_calgary_combined,1775,1725,0:00:13,13,,50,22425
2014-02-17-ccc_priority_script,2014/02/17,ccc_priority_script,11,11,0:00:07,7,,0,77
2014-02-17-ccc_tax_script,2014/02/17,ccc_tax_script,8,6,0:00:16,16,,2,96
2014-02-18-ccc_311_calgary_combined,2014/02/18,ccc_311_calgary_combined,4099,3379,0:02:29,149,,720,503471
2014-02-18-ccc_priority_script,2014/02/18,ccc_priority_script,31,28,0:00:12,12,,3,336
2014-02-18-ccc_tax_script,2014/02/18,ccc_tax_script,24,21,0:01:49,109,,3,2289
2014-02-19-ccc_311_calgary_combined,2014/02/19,ccc_311_calgary_combined,3602,3069,0:02:08,128,,533,392832
2014-02-19-ccc_priority_script,2014/02/19,ccc_priority_script,38,36,0:00:19,19,,2,684
2014-02-19-ccc_tax_script,2014/02/19,ccc_tax_script,21,16,0:02:29,149,,5,2384
2014-02-20-ccc_311_calgary_combined,2014/02/20,ccc_311_calgary_combined,3611,3258,0:01:13,73,,353,237834
2014-02-20-ccc_priority_script,2014/02/20,ccc_priority_script,20,20,0:00:21,21,,0,420
2014-02-20-ccc_tax_script,2014/02/20,ccc_tax_script,33,26,0:01:08,68,,7,1768
2014-02-21-ccc_311_calgary_combined,2014/02/21,ccc_311_calgary_combined,3215,2920,0:01:08,68,,295,198560
2014-02-21-ccc_priority_script,2014/02/21,ccc_priority_script,26,25,0:00:27,27,,1,675
2014-02-21-ccc_tax_script,2014/02/21,ccc_tax_script,25,21,0:01:01,61,,4,1281
2014-02-22-ccc_311_calgary_combined,2014/02/22,ccc_311_calgary_combined,1188,1154,0:00:18,18,,34,20772
2014-02-22-ccc_priority_script,2014/02/22,ccc_priority_script,19,19,0:01:35,95,,0,1805
2014-02-22-ccc_tax_script,2014/02/22,ccc_tax_script,2,2,0:00:06,6,,0,12
2014-02-23-ccc_311_calgary_combined,2014/02/23,ccc_311_calgary_combined,805,799,0:00:07,7,,6,5593
2014-02-23-ccc_priority_script,2014/02/23,ccc_priority_script,30,29,0:00:19,19,,1,551
2014-02-23-ccc_tax_script,2014/02/23,ccc_tax_script,1,1,0:00:06,6,,0,6
2014-02-24-ccc_311_calgary_combined,2014/02/24,ccc_311_calgary_combined,3600,3265,0:01:07,67,,335,218755
2014-02-24-ccc_priority_script,2014/02/24,ccc_priority_script,43,43,0:00:17,17,,0,731
2014-02-24-ccc_tax_script,2014/02/24,ccc_tax_script,23,20,0:01:38,98,,3,1960
2014-02-25-ccc_311_calgary_combined,2014/02/25,ccc_311_calgary_combined,3202,3111,0:00:23,23,,91,71553
2014-02-25-ccc_priority_script,2014/02/25,ccc_priority_script,29,28,0:00:09,9,,1,252
2014-02-25-ccc_tax_script,2014/02/25,ccc_tax_script,17,17,0:00:13,13,,0,221
2014-02-26-ccc_311_calgary_combined,2014/02/26,ccc_311_calgary_combined,3318,3197,0:00:28,28,,121,89516
2014-02-26-ccc_priority_script,2014/02/26,ccc_priority_script,24,24,0:00:07,7,,0,168
2014-02-26-ccc_tax_script,2014/02/26,ccc_tax_script,10,10,0:00:23,23,,0,230
2014-02-27-ccc_311_calgary_combined,2014/02/27,ccc_311_calgary_combined,3160,3082,0:00:17,17,,78,52394
2014-02-27-ccc_priority_script,2014/02/27,ccc_priority_script,26,26,0:00:09,9,,0,234
2014-02-27-ccc_tax_script,2014/02/27,ccc_tax_script,10,9,0:00:22,22,,1,198
2014-02-28-ccc_311_calgary_combined,2014/02/28,ccc_311_calgary_combined,2943,2850,0:00:16,16,,93,45600
2014-02-28-ccc_priority_script,2014/02/28,ccc_priority_script,31,31,0:00:06,6,,0,186
2014-02-28-ccc_tax_script,2014/02/28,ccc_tax_script,12,11,0:00:07,7,,1,77
2014-03-01-ccc_311_calgary_combined,2014/03/01,ccc_311_calgary_combined,1234,1184,0:00:15,15,,50,17760
2014-03-01-ccc_priority_script,2014/03/01,ccc_priority_script,31,30,0:00:19,19,,1,570
2014-03-01-ccc_tax_script,2014/03/01,ccc_tax_script,2,2,0:00:07,7,,0,14
2014-03-02-ccc_311_calgary_combined,2014/03/02,ccc_311_calgary_combined,1024,1004,0:00:09,9,,20,9036
2014-03-02-ccc_priority_script,2014/03/02,ccc_priority_script,22,22,0:00:07,7,,0,154
2014-03-02-ccc_tax_script,2014/03/02,ccc_tax_script,1,1,0:00:06,6,,0,6
2014-03-03-ccc_311_calgary_combined,2014/03/03,ccc_311_calgary_combined,3542,3220,0:01:05,65,,322,209300
2014-03-03-ccc_priority_script,2014/03/03,ccc_priority_script,31,29,0:00:09,9,,2,261
2014-03-03-ccc_tax_script,2014/03/03,ccc_tax_script,22,18,0:02:01,121,,4,2178
2014-03-04-ccc_311_calgary_combined,2014/03/04,ccc_311_calgary_combined,3343,3093,0:00:58,58,,250,179394
2014-03-04-ccc_priority_script,2014/03/04,ccc_priority_script,27,26,0:00:09,9,,1,234
2014-03-04-ccc_tax_script,2014/03/04,ccc_tax_script,20,20,0:01:11,71,,0,1420
2014-03-05-ccc_311_calgary_combined,2014/03/05,ccc_311_calgary_combined,3290,3235,0:00:13,13,,55,42055
2014-03-05-ccc_priority_script,2014/03/05,ccc_priority_script,37,37,0:00:06,6,,0,222
2014-03-05-ccc_tax_script,2014/03/05,ccc_tax_script,27,26,0:00:15,15,,1,390
2014-03-06-ccc_311_calgary_combined,2014/03/06,ccc_311_calgary_combined,2963,2925,0:00:10,10,,38,29250
2014-03-06-ccc_priority_script,2014/03/06,ccc_priority_script,24,23,0:00:05,5,,1,115
2014-03-06-ccc_tax_script,2014/03/06,ccc_tax_script,22,22,0:00:08,8,,0,176
2014-03-07-ccc_311_calgary_combined,2014/03/07,ccc_311_calgary_combined,2881,2819,0:00:19,19,,62,53561
2014-03-07-ccc_priority_script,2014/03/07,ccc_priority_script,27,27,0:00:08,8,,0,216
2014-03-07-ccc_tax_script,2014/03/07,ccc_tax_script,19,19,0:00:06,6,,0,114
2014-03-08-ccc_311_calgary_combined,2014/03/08,ccc_311_calgary_combined,1942,1651,0:02:30,150,,291,247650
2014-03-08-ccc_priority_script,2014/03/08,ccc_priority_script,25,22,0:00:41,41,,3,902
2014-03-09-ccc_311_calgary_combined,2014/03/09,ccc_311_calgary_combined,2883,1534,0:01:38,98,,1349,150332
2014-03-09-ccc_priority_script,2014/03/09,ccc_priority_script,68,59,0:00:25,25,,9,1475
2014-03-10-ccc_311_calgary_combined,2014/03/10,ccc_311_calgary_combined,4878,3803,0:04:02,242,,1075,920326
2014-03-10-ccc_priority_script,2014/03/10,ccc_priority_script,50,45,0:00:24,24,,5,1080
2014-03-10-ccc_tax_script,2014/03/10,ccc_tax_script,26,21,0:04:38,278,,5,5838
2014-03-11-ccc_311_calgary_combined,2014/03/11,ccc_311_calgary_combined,4113,3686,0:01:19,79,,427,291194
2014-03-11-ccc_priority_script,2014/03/11,ccc_priority_script,46,45,0:00:17,17,,1,765
2014-03-11-ccc_tax_script,2014/03/11,ccc_tax_script,10,9,0:00:39,39,,1,351
2014-03-12-ccc_311_calgary_combined,2014/03/12,ccc_311_calgary_combined,4282,3646,0:02:02,122,,636,444812
2014-03-12-ccc_priority_script,2014/03/12,ccc_priority_script,46,43,0:00:20,20,,3,860
2014-03-12-ccc_tax_script,2014/03/12,ccc_tax_script,13,10,0:02:02,122,,3,1220
2014-03-13-ccc_311_calgary_combined,2014/03/13,ccc_311_calgary_combined,3867,3186,0:02:19,139,,681,442854
2014-03-13-ccc_priority_script,2014/03/13,ccc_priority_script,30,27,0:00:21,21,,3,567
2014-03-13-ccc_tax_script,2014/03/13,ccc_tax_script,21,14,0:02:34,154,,7,2156
2014-03-14-ccc_311_calgary_combined,2014/03/14,ccc_311_calgary_combined,3580,3126,0:01:45,105,,454,328230
2014-03-14-ccc_priority_script,2014/03/14,ccc_priority_script,54,51,0:00:18,18,,3,918
2014-03-14-ccc_tax_script,2014/03/14,ccc_tax_script,22,20,0:01:55,115,,2,2300
2014-03-15-ccc_311_calgary_combined,2014/03/15,ccc_311_calgary_combined,1621,1567,0:00:16,16,,54,25072
2014-03-15-ccc_priority_script,2014/03/15,ccc_priority_script,39,36,0:00:07,7,,3,252
2014-03-15-ccc_tax_script,2014/03/15,ccc_tax_script,1,1,0:00:05,5,,0,5
2014-03-16-ccc_311_calgary_combined,2014/03/16,ccc_311_calgary_combined,1394,1334,0:00:27,27,,60,36018
2014-03-16-ccc_priority_script,2014/03/16,ccc_priority_script,23,22,0:00:09,9,,1,198
2014-03-17-ccc_311_calgary_combined,2014/03/17,ccc_311_calgary_combined,4025,3467,0:02:11,131,,558,454177
2014-03-17-ccc_priority_script,2014/03/17,ccc_priority_script,27,27,0:00:14,14,,0,378
2014-03-17-ccc_tax_script,2014/03/17,ccc_tax_script,9,8,0:02:33,153,,1,1224
2014-03-18-ccc_311_calgary_combined,2014/03/18,ccc_311_calgary_combined,3678,3250,0:01:29,89,,428,289250
2014-03-18-ccc_priority_script,2014/03/18,ccc_priority_script,44,44,0:00:22,22,,0,968
2014-03-18-ccc_tax_script,2014/03/18,ccc_tax_script,16,15,0:02:26,146,,1,2190
2014-03-19-ccc_311_calgary_combined,2014/03/19,ccc_311_calgary_combined,3577,3098,0:01:57,117,,479,362466
2014-03-19-ccc_priority_script,2014/03/19,ccc_priority_script,31,29,0:00:08,8,,2,232
2014-03-19-ccc_tax_script,2014/03/19,ccc_tax_script,18,14,0:04:05,245,,4,3430
2014-03-20-ccc_311_calgary_combined,2014/03/20,ccc_311_calgary_combined,3064,2993,0:00:11,11,,71,32923
2014-03-20-ccc_priority_script,2014/03/20,ccc_priority_script,63,61,0:00:07,7,,2,427
2014-03-20-ccc_tax_script,2014/03/20,ccc_tax_script,23,19,0:00:08,8,,4,152
2014-03-21-ccc_311_calgary_combined,2014/03/21,ccc_311_calgary_combined,2806,2747,0:00:14,14,,59,38458
2014-03-21-ccc_priority_script,2014/03/21,ccc_priority_script,39,37,0:00:07,7,,2,259
2014-03-21-ccc_tax_script,2014/03/21,ccc_tax_script,21,20,0:00:09,9,,1,180
2014-03-22-ccc_311_calgary_combined,2014/03/22,ccc_311_calgary_combined,945,927,0:00:09,9,,18,8343
2014-03-22-ccc_priority_script,2014/03/22,ccc_priority_script,17,16,0:00:06,6,,1,96
2014-03-22-ccc_tax_script,2014/03/22,ccc_tax_script,3,3,0:00:03,3,,0,9
2014-03-23-ccc_311_calgary_combined,2014/03/23,ccc_311_calgary_combined,757,751,0:00:07,7,,6,5257
2014-03-23-ccc_priority_script,2014/03/23,ccc_priority_script,12,12,0:00:15,15,,0,180
2014-03-24-ccc_311_calgary_combined,2014/03/24,ccc_311_calgary_combined,3306,3132,0:00:38,38,,174,119016
2014-03-24-ccc_priority_script,2014/03/24,ccc_priority_script,15,15,0:00:07,7,,0,105
2014-03-24-ccc_tax_script,2014/03/24,ccc_tax_script,27,24,0:00:44,44,,3,1056
2014-03-25-ccc_311_calgary_combined,2014/03/25,ccc_311_calgary_combined,2955,2835,0:00:28,28,,120,79380
2014-03-25-ccc_priority_script,2014/03/25,ccc_priority_script,22,21,0:00:07,7,,1,147
2014-03-25-ccc_tax_script,2014/03/25,ccc_tax_script,19,18,0:00:23,23,,1,414
2014-03-26-ccc_311_calgary_combined,2014/03/26,ccc_311_calgary_combined,2922,2859,0:00:10,10,,63,28590
2014-03-26-ccc_priority_script,2014/03/26,ccc_priority_script,43,42,0:00:06,6,,1,252
2014-03-26-ccc_tax_script,2014/03/26,ccc_tax_script,23,23,0:00:09,9,,0,207
2014-03-27-ccc_311_calgary_combined,2014/03/27,ccc_311_calgary_combined,2863,2833,0:00:08,8,,30,22664
2014-03-27-ccc_priority_script,2014/03/27,ccc_priority_script,16,16,0:00:07,7,,0,112
2014-03-27-ccc_tax_script,2014/03/27,ccc_tax_script,20,20,0:00:10,10,,0,200
2014-03-28-ccc_311_calgary_combined,2014/03/28,ccc_311_calgary_combined,2752,2698,0:00:12,12,,54,32376
2014-03-28-ccc_priority_script,2014/03/28,ccc_priority_script,19,19,0:00:17,17,,0,323
2014-03-28-ccc_tax_script,2014/03/28,ccc_tax_script,25,24,0:00:17,17,,1,408
2014-03-29-ccc_311_calgary_combined,2014/03/29,ccc_311_calgary_combined,1116,1082,0:00:12,12,,34,12984
2014-03-29-ccc_priority_script,2014/03/29,ccc_priority_script,28,28,0:00:08,8,,0,224
2014-03-29-ccc_tax_script,2014/03/29,ccc_tax_script,3,3,0:00:06,6,,0,18
2014-03-30-ccc_311_calgary_combined,2014/03/30,ccc_311_calgary_combined,806,788,0:00:09,9,,18,7092
2014-03-30-ccc_priority_script,2014/03/30,ccc_priority_script,15,14,0:00:14,14,,1,196
2014-03-31-ccc_311_calgary_combined,2014/03/31,ccc_311_calgary_combined,3242,3182,0:00:11,11,,60,35002
2014-03-31-ccc_priority_script,2014/03/31,ccc_priority_script,22,21,0:00:09,9,,1,189
2014-03-31-ccc_tax_script,2014/03/31,ccc_tax_script,21,21,0:00:07,7,,0,147
2014-04-01-ccc_311_calgary_combined,2014/04/01,ccc_311_calgary_combined,3540,3268,0:00:51,51,,272,166668
2014-04-01-ccc_priority_script,2014/04/01,ccc_priority_script,28,28,0:00:13,13,,0,364
2014-04-01-ccc_tax_script,2014/04/01,ccc_tax_script,29,26,0:00:28,28,,3,728
2014-04-02-ccc_311_calgary_combined,2014/04/02,ccc_311_calgary_combined,3388,3268,0:00:16,16,,120,52288
2014-04-02-ccc_priority_script,2014/04/02,ccc_priority_script,23,21,0:00:06,6,,2,126
2014-04-02-ccc_tax_script,2014/04/02,ccc_tax_script,22,22,0:00:14,14,,0,308
2014-04-03-ccc_311_calgary_combined,2014/04/03,ccc_311_calgary_combined,3072,3005,0:00:11,11,,67,33055
2014-04-03-ccc_priority_script,2014/04/03,ccc_priority_script,26,24,0:00:06,6,,2,144
2014-04-03-ccc_tax_script,2014/04/03,ccc_tax_script,24,23,0:00:05,5,,1,115
2014-04-04-ccc_311_calgary_combined,2014/04/04,ccc_311_calgary_combined,3276,3105,0:00:40,40,,171,124200
2014-04-04-ccc_priority_script,2014/04/04,ccc_priority_script,26,25,0:00:15,15,,1,375
2014-04-04-ccc_tax_script,2014/04/04,ccc_tax_script,15,14,0:00:39,39,,1,546
2014-04-05-ccc_311_calgary_combined,2014/04/05,ccc_311_calgary_combined,1440,1391,0:00:16,16,,49,22256
2014-04-05-ccc_priority_script,2014/04/05,ccc_priority_script,16,16,0:00:07,7,,0,112
2014-04-05-ccc_tax_script,2014/04/05,ccc_tax_script,3,3,0:00:04,4,,0,12
2014-04-06-ccc_311_calgary_combined,2014/04/06,ccc_311_calgary_combined,1211,1196,0:00:08,8,,15,9568
2014-04-06-ccc_priority_script,2014/04/06,ccc_priority_script,13,13,0:00:05,5,,0,65
2014-04-07-ccc_311_calgary_combined,2014/04/07,ccc_311_calgary_combined,4566,3225,0:04:41,281,,1341,906225
2014-04-07-ccc_priority_script,2014/04/07,ccc_priority_script,36,32,0:00:15,15,,4,480
2014-04-07-ccc_tax_script,2014/04/07,ccc_tax_script,20,14,0:05:14,314,,6,4396
2014-04-08-ccc_311_calgary_combined,2014/04/08,ccc_311_calgary_combined,4126,3748,0:01:16,76,,378,284848
2014-04-08-ccc_priority_script,2014/04/08,ccc_priority_script,34,34,0:00:12,12,,0,408
2014-04-08-ccc_tax_script,2014/04/08,ccc_tax_script,15,14,0:01:44,104,,1,1456
2014-04-09-ccc_311_calgary_combined,2014/04/09,ccc_311_calgary_combined,3925,3625,0:01:02,62,,300,224750
2014-04-09-ccc_priority_script,2014/04/09,ccc_priority_script,34,34,0:00:12,12,,0,408
2014-04-09-ccc_tax_script,2014/04/09,ccc_tax_script,17,15,0:00:40,40,,2,600
2014-04-10-ccc_311_calgary_combined,2014/04/10,ccc_311_calgary_combined,3731,3425,0:01:15,75,,306,256875
2014-04-10-ccc_priority_script,2014/04/10,ccc_priority_script,29,29,0:00:20,20,,0,580
2014-04-10-ccc_tax_script,2014/04/10,ccc_tax_script,19,17,0:01:20,80,,2,1360
2014-04-11-ccc_311_calgary_combined,2014/04/11,ccc_311_calgary_combined,3562,3265,0:01:06,66,,297,215490
2014-04-11-ccc_priority_script,2014/04/11,ccc_priority_script,25,23,0:00:17,17,,2,391
2014-04-11-ccc_tax_script,2014/04/11,ccc_tax_script,17,15,0:00:54,54,,2,810
2014-04-12-ccc_311_calgary_combined,2014/04/12,ccc_311_calgary_combined,1537,1430,0:00:37,37,,107,52910
2014-04-12-ccc_priority_script,2014/04/12,ccc_priority_script,26,24,0:00:07,7,,2,168
2014-04-12-ccc_tax_script,2014/04/12,ccc_tax_script,1,1,0:00:07,7,,0,7
2014-04-13-ccc_311_calgary_combined,2014/04/13,ccc_311_calgary_combined,1263,1175,0:00:34,34,,88,39950
2014-04-13-ccc_priority_script,2014/04/13,ccc_priority_script,24,23,0:00:14,14,,1,322
2014-04-14-ccc_311_calgary_combined,2014/04/14,ccc_311_calgary_combined,4238,3836,0:01:06,66,,402,253176
2014-04-14-ccc_priority_script,2014/04/14,ccc_priority_script,18,17,0:00:17,17,,1,289
2014-04-14-ccc_tax_script,2014/04/14,ccc_tax_script,22,18,0:00:54,54,,4,972
2014-04-15-ccc_311_calgary_combined,2014/04/15,ccc_311_calgary_combined,3999,3394,0:01:57,117,,605,397098
2014-04-15-ccc_priority_script,2014/04/15,ccc_priority_script,48,47,0:00:11,11,,1,517
2014-04-15-ccc_tax_script,2014/04/15,ccc_tax_script,15,14,0:03:47,227,,1,3178
2014-04-16-ccc_311_calgary_combined,2014/04/16,ccc_311_calgary_combined,3326,3169,0:00:38,38,,157,120422
2014-04-16-ccc_priority_script,2014/04/16,ccc_priority_script,43,39,0:00:09,9,,4,351
2014-04-16-ccc_tax_script,2014/04/16,ccc_tax_script,17,16,0:00:30,30,,1,480
2014-04-17-ccc_311_calgary_combined,2014/04/17,ccc_311_calgary_combined,3691,3567,0:00:17,17,,124,60639
2014-04-17-ccc_priority_script,2014/04/17,ccc_priority_script,30,29,0:00:08,8,,1,232
2014-04-17-ccc_tax_script,2014/04/17,ccc_tax_script,14,13,0:00:12,12,,1,156
2014-04-18-ccc_311_calgary_combined,2014/04/18,ccc_311_calgary_combined,1507,1484,0:00:09,9,,23,13356
2014-04-18-ccc_priority_script,2014/04/18,ccc_priority_script,18,18,0:00:11,11,,0,198
2014-04-18-ccc_tax_script,2014/04/18,ccc_tax_script,1,1,0:00:03,3,,0,3
2014-04-19-ccc_311_calgary_combined,2014/04/19,ccc_311_calgary_combined,1375,1312,0:00:22,22,,63,28864
2014-04-19-ccc_priority_script,2014/04/19,ccc_priority_script,20,19,0:00:13,13,,1,247
2014-04-19-ccc_tax_script,2014/04/19,ccc_tax_script,1,1,0:00:03,3,,0,3
2014-04-20-ccc_311_calgary_combined,2014/04/20,ccc_311_calgary_combined,1023,996,0:00:13,13,,27,12948
2014-04-20-ccc_priority_script,2014/04/20,ccc_priority_script,24,22,0:00:05,5,,2,110
2014-04-20-ccc_tax_script,2014/04/20,ccc_tax_script,1,1,0:00:11,11,,0,11
2014-04-21-ccc_311_calgary_combined,2014/04/21,ccc_311_calgary_combined,3911,3451,0:01:25,85,,460,293335
2014-04-21-ccc_priority_script,2014/04/21,ccc_priority_script,29,28,0:00:18,18,,1,504
2014-04-21-ccc_tax_script,2014/04/21,ccc_tax_script,11,8,0:00:35,35,,3,280
2014-04-22-ccc_311_calgary_combined,2014/04/22,ccc_311_calgary_combined,4408,3670,0:02:21,141,,738,517470
2014-04-22-ccc_priority_script,2014/04/22,ccc_priority_script,41,39,0:00:11,11,,2,429
2014-04-22-ccc_tax_script,2014/04/22,ccc_tax_script,20,16,0:02:49,169,,4,2704
2014-04-23-ccc_311_calgary_combined,2014/04/23,ccc_311_calgary_combined,4328,3835,0:01:43,103,,493,395005
2014-04-23-ccc_priority_script,2014/04/23,ccc_priority_script,37,35,0:00:16,16,,2,560
2014-04-23-ccc_tax_script,2014/04/23,ccc_tax_script,14,11,0:02:03,123,,3,1353
2014-04-24-ccc_311_calgary_combined,2014/04/24,ccc_311_calgary_combined,4098,3693,0:01:19,79,,405,291747
2014-04-24-ccc_priority_script,2014/04/24,ccc_priority_script,36,35,0:00:09,9,,1,315
2014-04-24-ccc_tax_script,2014/04/24,ccc_tax_script,18,15,0:01:46,106,,3,1590
2014-04-25-ccc_311_calgary_combined,2014/04/25,ccc_311_calgary_combined,3686,3526,0:00:31,31,,160,109306
2014-04-25-ccc_priority_script,2014/04/25,ccc_priority_script,28,24,0:00:15,15,,4,360
2014-04-25-ccc_tax_script,2014/04/25,ccc_tax_script,15,14,0:00:08,8,,1,112
2014-04-26-ccc_311_calgary_combined,2014/04/26,ccc_311_calgary_combined,1435,1380,0:00:17,17,,55,23460
2014-04-26-ccc_priority_script,2014/04/26,ccc_priority_script,25,25,0:00:12,12,,0,300
2014-04-26-ccc_tax_script,2014/04/26,ccc_tax_script,2,2,0:00:45,45,,0,90
2014-04-27-ccc_311_calgary_combined,2014/04/27,ccc_311_calgary_combined,1350,1301,0:00:20,20,,49,26020
2014-04-27-ccc_priority_script,2014/04/27,ccc_priority_script,20,20,0:00:11,11,,0,220
2014-04-28-ccc_311_calgary_combined,2014/04/28,ccc_311_calgary_combined,4515,4155,0:00:56,56,,360,232680
2014-04-28-ccc_priority_script,2014/04/28,ccc_priority_script,24,24,0:00:08,8,,0,192
2014-04-28-ccc_tax_script,2014/04/28,ccc_tax_script,14,13,0:00:53,53,,1,689
2014-04-29-ccc_311_calgary_combined,2014/04/29,ccc_311_calgary_combined,4480,3783,0:02:17,137,,697,518271
2014-04-29-ccc_priority_script,2014/04/29,ccc_priority_script,39,34,0:00:11,11,,5,374
2014-04-29-ccc_tax_script,2014/04/29,ccc_tax_script,24,19,0:03:53,233,,5,4427
2014-04-30-ccc_311_calgary_combined,2014/04/30,ccc_311_calgary_combined,4619,3916,0:02:02,122,,703,477752
2014-04-30-ccc_priority_script,2014/04/30,ccc_priority_script,36,35,0:00:11,11,,1,385
2014-04-30-ccc_tax_script,2014/04/30,ccc_tax_script,23,19,0:01:14,74,,4,1406
2014-05-01-ccc_311_calgary_combined,2014/05/01,ccc_311_calgary_combined,4273,3966,0:00:48,48,,307,190368
2014-05-01-ccc_priority_script,2014/05/01,ccc_priority_script,42,39,0:00:11,11,,3,429
2014-05-01-ccc_tax_script,2014/05/01,ccc_tax_script,19,16,0:00:44,44,,3,704
2014-05-02-ccc_311_calgary_combined,2014/05/02,ccc_311_calgary_combined,3903,3785,0:00:20,20,,118,75700
2014-05-02-ccc_priority_script,2014/05/02,ccc_priority_script,53,52,0:00:10,10,,1,520
2014-05-02-ccc_tax_script,2014/05/02,ccc_tax_script,19,19,0:00:07,7,,0,133
2014-05-03-ccc_311_calgary_combined,2014/05/03,ccc_311_calgary_combined,1455,1415,0:00:19,19,,40,26885
2014-05-03-ccc_priority_script,2014/05/03,ccc_priority_script,29,28,0:00:10,10,,1,280
2014-05-03-ccc_tax_script,2014/05/03,ccc_tax_script,2,2,0:00:15,15,,0,30
2014-05-04-ccc_311_calgary_combined,2014/05/04,ccc_311_calgary_combined,1086,1056,0:00:18,18,,30,19008
2014-05-04-ccc_priority_script,2014/05/04,ccc_priority_script,22,22,0:00:16,16,,0,352
2014-05-04-ccc_tax_script,2014/05/04,ccc_tax_script,1,1,0:00:03,3,,0,3
2014-05-05-ccc_311_calgary_combined,2014/05/05,ccc_311_calgary_combined,4087,3876,0:00:39,39,,211,151164
2014-05-05-ccc_priority_script,2014/05/05,ccc_priority_script,27,26,0:00:11,11,,1,286
2014-05-05-ccc_tax_script,2014/05/05,ccc_tax_script,18,16,0:01:03,63,,2,1008
2014-05-06-ccc_311_calgary_combined,2014/05/06,ccc_311_calgary_combined,4067,3910,0:01:17,77,,157,301070
2014-05-06-ccc_priority_script,2014/05/06,ccc_priority_script,37,37,0:00:09,9,,0,333
2014-05-06-ccc_tax_script,2014/05/06,ccc_tax_script,17,15,0:00:27,27,,2,405
2014-05-07-ccc_311_calgary_combined,2014/05/07,ccc_311_calgary_combined,4201,3992,0:00:34,34,,209,135728
2014-05-07-ccc_priority_script,2014/05/07,ccc_priority_script,34,34,0:00:09,9,,0,306
2014-05-07-ccc_tax_script,2014/05/07,ccc_tax_script,21,21,0:00:24,24,,0,504
2014-05-08-ccc_311_calgary_combined,2014/05/08,ccc_311_calgary_combined,3937,3678,0:00:45,45,,259,165510
2014-05-08-ccc_priority_script,2014/05/08,ccc_priority_script,27,22,0:00:09,9,,5,198
2014-05-08-ccc_tax_script,2014/05/08,ccc_tax_script,20,19,0:00:44,44,,1,836
2014-05-09-ccc_311_calgary_combined,2014/05/09,ccc_311_calgary_combined,3536,3323,0:00:42,42,,213,139566
2014-05-09-ccc_priority_script,2014/05/09,ccc_priority_script,40,40,0:00:06,6,,0,240
2014-05-09-ccc_tax_script,2014/05/09,ccc_tax_script,20,16,0:00:57,57,,4,912
2014-05-10-ccc_311_calgary_combined,2014/05/10,ccc_311_calgary_combined,1505,1449,0:00:31,31,,56,44919
2014-05-10-ccc_priority_script,2014/05/10,ccc_priority_script,18,18,0:00:07,7,,0,126
2014-05-10-ccc_tax_script,2014/05/10,ccc_tax_script,1,1,0:00:28,28,,0,28
2014-05-11-ccc_311_calgary_combined,2014/05/11,ccc_311_calgary_combined,1155,1114,0:00:16,16,,41,17824
2014-05-11-ccc_priority_script,2014/05/11,ccc_priority_script,27,26,0:00:10,10,,1,260
2014-05-11-ccc_tax_script,2014/05/11,ccc_tax_script,1,0,0:00:00,0,,1,0
2014-05-12-ccc_311_calgary_combined,2014/05/12,ccc_311_calgary_combined,4715,4012,0:02:24,144,,703,577728
2014-05-12-ccc_priority_script,2014/05/12,ccc_priority_script,30,27,0:00:13,13,,3,351
2014-05-12-ccc_tax_script,2014/05/12,ccc_tax_script,23,21,0:02:21,141,,2,2961
2014-05-13-ccc_311_calgary_combined,2014/05/13,ccc_311_calgary_combined,4380,4019,0:01:06,66,,361,265254
2014-05-13-ccc_priority_script,2014/05/13,ccc_priority_script,30,30,0:00:09,9,,0,270
2014-05-13-ccc_tax_script,2014/05/13,ccc_tax_script,28,24,0:01:26,86,,4,2064
2014-05-14-ccc_311_calgary_combined,2014/05/14,ccc_311_calgary_combined,4234,3909,0:00:59,59,,325,230631
2014-05-14-ccc_priority_script,2014/05/14,ccc_priority_script,26,24,0:00:14,14,,2,336
2014-05-14-ccc_tax_script,2014/05/14,ccc_tax_script,23,20,0:00:35,35,,3,700
2014-05-15-ccc_311_calgary_combined,2014/05/15,ccc_311_calgary_combined,3888,3576,0:02:10,130,,312,464880
2014-05-15-ccc_priority_script,2014/05/15,ccc_priority_script,35,32,0:00:11,11,,3,352
2014-05-15-ccc_tax_script,2014/05/15,ccc_tax_script,12,11,0:01:53,113,,1,1243
2014-05-16-ccc_311_calgary_combined,2014/05/16,ccc_311_calgary_combined,3624,3393,0:00:52,52,,231,176436
2014-05-16-ccc_priority_script,2014/05/16,ccc_priority_script,39,37,0:00:11,11,,2,407
2014-05-16-ccc_tax_script,2014/05/16,ccc_tax_script,17,17,0:01:17,77,,0,1309
2014-05-17-ccc_311_calgary_combined,2014/05/17,ccc_311_calgary_combined,1399,1352,0:00:15,15,,47,20280
2014-05-17-ccc_priority_script,2014/05/17,ccc_priority_script,23,22,0:00:10,10,,1,220
2014-05-18-ccc_311_calgary_combined,2014/05/18,ccc_311_calgary_combined,1166,1152,0:00:09,9,,14,10368
2014-05-18-ccc_priority_script,2014/05/18,ccc_priority_script,25,23,0:00:13,13,,2,299
2014-05-19-ccc_311_calgary_combined,2014/05/19,ccc_311_calgary_combined,1440,1412,0:00:13,13,,28,18356
2014-05-19-ccc_priority_script,2014/05/19,ccc_priority_script,25,23,0:00:06,6,,2,138
2014-05-19-ccc_tax_script,2014/05/19,ccc_tax_script,1,1,0:00:03,3,,0,3
2014-05-20-ccc_311_calgary_combined,2014/05/20,ccc_311_calgary_combined,5260,4514,0:01:56,116,,746,523624
2014-05-20-ccc_priority_script,2014/05/20,ccc_priority_script,52,51,0:00:18,18,,1,918
2014-05-20-ccc_tax_script,2014/05/20,ccc_tax_script,18,16,0:02:12,132,,2,2112
2014-05-21-ccc_311_calgary_combined,2014/05/21,ccc_311_calgary_combined,4650,3984,0:01:53,113,,666,450192
2014-05-21-ccc_priority_script,2014/05/21,ccc_priority_script,38,36,0:00:14,14,,2,504
2014-05-21-ccc_tax_script,2014/05/21,ccc_tax_script,23,19,0:00:38,38,,4,722
2014-05-22-ccc_311_calgary_combined,2014/05/22,ccc_311_calgary_combined,4651,4016,0:01:58,118,,635,473888
2014-05-22-ccc_priority_script,2014/05/22,ccc_priority_script,42,41,0:00:17,17,,1,697
2014-05-22-ccc_tax_script,2014/05/22,ccc_tax_script,25,22,0:01:58,118,,3,2596
2014-05-23-ccc_311_calgary_combined,2014/05/23,ccc_311_calgary_combined,4395,3907,0:01:32,92,,488,359444
2014-05-23-ccc_priority_script,2014/05/23,ccc_priority_script,48,46,0:00:12,12,,2,552
2014-05-23-ccc_tax_script,2014/05/23,ccc_tax_script,11,9,0:01:29,89,,2,801
2014-05-24-ccc_311_calgary_combined,2014/05/24,ccc_311_calgary_combined,1841,1626,0:01:17,77,,215,125202
2014-05-24-ccc_priority_script,2014/05/24,ccc_priority_script,38,37,0:00:17,17,,1,629
2014-05-24-ccc_tax_script,2014/05/24,ccc_tax_script,1,1,0:00:07,7,,0,7
2014-05-25-ccc_311_calgary_combined,2014/05/25,ccc_311_calgary_combined,1418,1342,0:00:28,28,,76,37576
2014-05-25-ccc_priority_script,2014/05/25,ccc_priority_script,14,14,0:00:05,5,,0,70
2014-05-26-ccc_311_calgary_combined,2014/05/26,ccc_311_calgary_combined,6199,4011,0:05:53,353,,2188,1415883
2014-05-26-ccc_priority_script,2014/05/26,ccc_priority_script,26,25,0:00:25,25,,1,625
2014-05-26-ccc_tax_script,2014/05/26,ccc_tax_script,20,13,0:08:23,503,,7,6539
2014-05-27-ccc_311_calgary_combined,2014/05/27,ccc_311_calgary_combined,6306,4523,0:04:58,298,,1783,1347854
2014-05-27-ccc_priority_script,2014/05/27,ccc_priority_script,41,40,0:00:15,15,,1,600
2014-05-27-ccc_tax_script,2014/05/27,ccc_tax_script,15,12,0:05:45,345,,3,4140
2014-05-28-ccc_311_calgary_combined,2014/05/28,ccc_311_calgary_combined,5379,3589,0:06:44,404,,1790,1449956
2014-05-28-ccc_priority_script,2014/05/28,ccc_priority_script,28,28,0:00:19,19,,0,532
2014-05-28-ccc_tax_script,2014/05/28,ccc_tax_script,18,12,0:08:08,488,,6,5856
2014-05-29-ccc_311_calgary_combined,2014/05/29,ccc_311_calgary_combined,5019,4050,0:03:10,190,,969,769500
2014-05-29-ccc_priority_script,2014/05/29,ccc_priority_script,35,33,0:00:16,16,,2,528
2014-05-29-ccc_tax_script,2014/05/29,ccc_tax_script,10,6,0:02:47,167,,4,1002
2014-05-30-ccc_311_calgary_combined,2014/05/30,ccc_311_calgary_combined,4769,3635,0:04:16,256,,1134,930560
2014-05-30-ccc_priority_script,2014/05/30,ccc_priority_script,60,54,0:00:25,25,,6,1350
2014-05-30-ccc_tax_script,2014/05/30,ccc_tax_script,23,14,0:05:23,323,,9,4522
2014-05-31-ccc_311_calgary_combined,2014/05/31,ccc_311_calgary_combined,1901,1691,0:01:09,69,,210,116679
2014-05-31-ccc_priority_script,2014/05/31,ccc_priority_script,27,25,0:00:14,14,,2,350
2014-05-31-ccc_tax_script,2014/05/31,ccc_tax_script,1,1,0:00:04,4,,0,4
2014-06-01-ccc_311_calgary_combined,2014/06/01,ccc_311_calgary_combined,1649,1304,0:02:33,153,,345,199512
2014-06-01-ccc_priority_script,2014/06/01,ccc_priority_script,32,30,0:00:29,29,,2,870
2014-06-01-ccc_tax_script,2014/06/01,ccc_tax_script,2,1,0:07:42,462,,1,462
2014-06-02-ccc_311_calgary_combined,2014/06/02,ccc_311_calgary_combined,6166,3990,0:07:51,471,,2176,1879290
2014-06-02-ccc_priority_script,2014/06/02,ccc_priority_script,41,40,0:00:25,25,,1,1000
2014-06-02-ccc_tax_script,2014/06/02,ccc_tax_script,17,8,0:10:16,616,,9,4928
2014-06-03-ccc_311_calgary_combined,2014/06/03,ccc_311_calgary_combined,5844,3823,0:06:43,403,,2021,1540669
2014-06-03-ccc_help_script,2014/06/03,ccc_help_script,1,1,0:00:37,37,,0,37
2014-06-03-ccc_priority_script,2014/06/03,ccc_priority_script,42,41,0:00:18,18,,1,738
2014-06-03-ccc_tax_script,2014/06/03,ccc_tax_script,32,14,0:06:18,378,,18,5292
2014-06-04-ccc_311_calgary_combined,2014/06/04,ccc_311_calgary_combined,5643,4130,0:04:27,267,,1513,1102710
2014-06-04-ccc_help_script,2014/06/04,ccc_help_script,2,2,0:00:09,9,,0,18
2014-06-04-ccc_priority_script,2014/06/04,ccc_priority_script,50,49,0:00:15,15,,1,735
2014-06-04-ccc_tax_script,2014/06/04,ccc_tax_script,23,13,0:07:23,443,,10,5759
2014-06-05-ccc_311_calgary_combined,2014/06/05,ccc_311_calgary_combined,4714,4043,0:02:10,130,,671,525590
2014-06-05-ccc_help_script,2014/06/05,ccc_help_script,3,3,0:00:22,22,,0,66
2014-06-05-ccc_priority_script,2014/06/05,ccc_priority_script,25,25,0:00:24,24,,0,600
2014-06-06-ccc_311_calgary_combined,2014/06/06,ccc_311_calgary_combined,4378,4029,0:01:21,81,,349,326349
2014-06-06-ccc_help_script,2014/06/06,ccc_help_script,1,1,0:00:04,4,,0,4
2014-06-06-ccc_priority_script,2014/06/06,ccc_priority_script,37,35,0:00:08,8,,2,280
2014-06-07-ccc_311_calgary_combined,2014/06/07,ccc_311_calgary_combined,1643,1602,0:00:20,20,,41,32040
2014-06-07-ccc_priority_script,2014/06/07,ccc_priority_script,24,22,0:00:10,10,,2,220
2014-06-08-ccc_311_calgary_combined,2014/06/08,ccc_311_calgary_combined,1471,1424,0:00:17,17,,47,24208
2014-06-08-ccc_priority_script,2014/06/08,ccc_priority_script,36,34,0:00:09,9,,2,306
2014-06-09-ccc_311_calgary_combined,2014/06/09,ccc_311_calgary_combined,5554,4183,0:04:48,288,,1371,1204704
2014-06-09-ccc_priority_script,2014/06/09,ccc_priority_script,39,34,0:00:13,13,,5,442
2014-06-10-ccc_311_calgary_combined,2014/06/10,ccc_311_calgary_combined,5137,3772,0:05:13,313,,1365,1180636
2014-06-10-ccc_help_script,2014/06/10,ccc_help_script,9,9,0:00:11,11,,0,99
2014-06-10-ccc_priority_script,2014/06/10,ccc_priority_script,47,47,0:00:23,23,,0,1081
2014-06-11-ccc_311_calgary_combined,2014/06/11,ccc_311_calgary_combined,5107,4171,0:03:04,184,,936,767464
2014-06-11-ccc_help_script,2014/06/11,ccc_help_script,4,3,0:00:20,20,,1,60
2014-06-11-ccc_priority_script,2014/06/11,ccc_priority_script,47,46,0:00:15,15,,1,690
2014-06-12-ccc_311_calgary_combined,2014/06/12,ccc_311_calgary_combined,4671,4032,0:02:03,123,,639,495936
2014-06-12-ccc_help_script,2014/06/12,ccc_help_script,3,3,0:00:05,5,,0,15
2014-06-12-ccc_priority_script,2014/06/12,ccc_priority_script,48,44,0:00:14,14,,4,616
2014-06-13-ccc_311_calgary_combined,2014/06/13,ccc_311_calgary_combined,3881,3766,0:00:28,28,,115,105448
2014-06-13-ccc_help_script,2014/06/13,ccc_help_script,3,3,0:00:08,8,,0,24
2014-06-13-ccc_priority_script,2014/06/13,ccc_priority_script,28,28,0:00:09,9,,0,252
2014-06-14-ccc_311_calgary_combined,2014/06/14,ccc_311_calgary_combined,1547,1444,0:00:44,44,,103,63536
2014-06-14-ccc_help_script,2014/06/14,ccc_help_script,2,2,0:00:37,37,,0,74
2014-06-14-ccc_priority_script,2014/06/14,ccc_priority_script,38,37,0:00:10,10,,1,370
2014-06-15-ccc_311_calgary_combined,2014/06/15,ccc_311_calgary_combined,1108,1052,0:00:42,42,,56,44184
2014-06-15-ccc_priority_script,2014/06/15,ccc_priority_script,30,29,0:00:19,19,,1,551
2014-06-16-ccc_311_calgary_combined,2014/06/16,ccc_311_calgary_combined,5371,4311,0:03:14,194,,1060,836334
2014-06-16-ccc_help_script,2014/06/16,ccc_help_script,3,3,0:00:09,9,,0,27
2014-06-16-ccc_priority_script,2014/06/16,ccc_priority_script,35,35,0:00:18,18,,0,630
2014-06-16-ccc_tax_script,2014/06/16,ccc_tax_script,21,17,0:03:59,239,,4,4063
2014-06-17-ccc_311_calgary_combined,2014/06/17,ccc_311_calgary_combined,4850,4167,0:01:54,114,,683,475038
2014-06-17-ccc_help_script,2014/06/17,ccc_help_script,1,1,0:00:06,6,,0,6
2014-06-17-ccc_priority_script,2014/06/17,ccc_priority_script,38,36,0:00:11,11,,2,396
2014-06-17-ccc_tax_script,2014/06/17,ccc_tax_script,22,17,0:01:46,106,,5,1802
2014-06-18-ccc_311_calgary_combined,2014/06/18,ccc_311_calgary_combined,4455,3960,0:01:38,98,,495,388080
2014-06-18-ccc_help_script,2014/06/18,ccc_help_script,3,3,0:00:09,9,,0,27
2014-06-18-ccc_priority_script,2014/06/18,ccc_priority_script,39,36,0:00:25,25,,3,900
2014-06-18-ccc_tax_script,2014/06/18,ccc_tax_script,12,11,0:02:03,123,,1,1353
2014-06-19-ccc_311_calgary_combined,2014/06/19,ccc_311_calgary_combined,4902,4072,0:02:25,145,,830,590440
2014-06-19-ccc_help_script,2014/06/19,ccc_help_script,2,2,0:00:10,10,,0,20
2014-06-19-ccc_priority_script,2014/06/19,ccc_priority_script,44,40,0:00:35,35,,4,1400
2014-06-19-ccc_tax_script,2014/06/19,ccc_tax_script,14,12,0:01:46,106,,2,1272
2014-06-20-ccc_311_calgary_combined,2014/06/20,ccc_311_calgary_combined,4488,3860,0:01:59,119,,628,459340
2014-06-20-ccc_help_script,2014/06/20,ccc_help_script,4,4,0:00:06,6,,0,24
2014-06-20-ccc_priority_script,2014/06/20,ccc_priority_script,55,52,0:00:17,17,,3,884
2014-06-20-ccc_tax_script,2014/06/20,ccc_tax_script,22,21,0:01:26,86,,1,1806
2014-06-21-ccc_311_calgary_combined,2014/06/21,ccc_311_calgary_combined,1676,1579,0:00:33,33,,97,52107
2014-06-21-ccc_priority_script,2014/06/21,ccc_priority_script,35,35,0:00:11,11,,0,385
2014-06-22-ccc_311_calgary_combined,2014/06/22,ccc_311_calgary_combined,1632,1493,0:01:00,60,,139,89580
2014-06-22-ccc_priority_script,2014/06/22,ccc_priority_script,45,43,0:00:24,24,,2,1032
2014-06-23-ccc_311_calgary_combined,2014/06/23,ccc_311_calgary_combined,5981,4422,0:04:41,281,,1559,1242582
2014-06-23-ccc_help_script,2014/06/23,ccc_help_script,1,1,0:00:07,7,,0,7
2014-06-23-ccc_priority_script,2014/06/23,ccc_priority_script,45,43,0:00:15,15,,2,645
2014-06-23-ccc_tax_script,2014/06/23,ccc_tax_script,28,21,0:05:13,313,,7,6573
2014-06-24-ccc_311_calgary_combined,2014/06/24,ccc_311_calgary_combined,5866,3634,0:06:39,399,,2232,1449966
2014-06-24-ccc_help_script,2014/06/24,ccc_help_script,2,2,0:00:19,19,,0,38
2014-06-24-ccc_priority_script,2014/06/24,ccc_priority_script,42,34,0:00:21,21,,8,714
2014-06-24-ccc_tax_script,2014/06/24,ccc_tax_script,43,20,0:09:38,578,,23,11560
2014-06-25-ccc_311_calgary_combined,2014/06/25,ccc_311_calgary_combined,5309,4340,0:02:55,175,,969,759500
2014-06-25-ccc_help_script,2014/06/25,ccc_help_script,3,3,0:00:08,8,,0,24
2014-06-25-ccc_priority_script,2014/06/25,ccc_priority_script,43,43,0:00:19,19,,0,817
2014-06-25-ccc_tax_script,2014/06/25,ccc_tax_script,23,17,0:02:55,175,,6,2975
2014-06-26-ccc_311_calgary_combined,2014/06/26,ccc_311_calgary_combined,5199,4178,0:03:06,186,,1021,777108
2014-06-26-ccc_help_script,2014/06/26,ccc_help_script,5,5,0:00:14,14,,0,70
2014-06-26-ccc_priority_script,2014/06/26,ccc_priority_script,42,39,0:00:19,19,,3,741
2014-06-26-ccc_tax_script,2014/06/26,ccc_tax_script,21,20,0:02:58,178,,1,3560
2014-06-27-ccc_311_calgary_combined,2014/06/27,ccc_311_calgary_combined,5167,4271,0:02:51,171,,896,730341
2014-06-27-ccc_help_script,2014/06/27,ccc_help_script,3,2,0:00:09,9,,1,18
2014-06-27-ccc_priority_script,2014/06/27,ccc_priority_script,37,37,0:00:17,17,,0,629
2014-06-27-ccc_tax_script,2014/06/27,ccc_tax_script,29,23,0:03:43,223,,6,5129
2014-06-28-ccc_311_calgary_combined,2014/06/28,ccc_311_calgary_combined,1653,1590,0:00:19,19,,63,30210
2014-06-28-ccc_help_script,2014/06/28,ccc_help_script,1,1,0:00:02,2,,0,2
2014-06-28-ccc_priority_script,2014/06/28,ccc_priority_script,30,29,0:00:08,8,,1,232
2014-06-29-ccc_311_calgary_combined,2014/06/29,ccc_311_calgary_combined,1464,1430,0:00:15,15,,34,21450
2014-06-29-ccc_help_script,2014/06/29,ccc_help_script,1,1,0:00:05,5,,0,5
2014-06-29-ccc_priority_script,2014/06/29,ccc_priority_script,25,24,0:00:09,9,,1,216
2014-06-30-ccc_311_calgary_combined,2014/06/30,ccc_311_calgary_combined,6510,5326,0:03:04,184,,1184,979984
2014-06-30-ccc_priority_script,2014/06/30,ccc_priority_script,25,24,0:00:15,15,,1,360
2014-06-30-ccc_tax_script,2014/06/30,ccc_tax_script,25,22,0:03:00,180,,3,3960
2014-07-01-ccc_311_calgary_combined,2014/07/01,ccc_311_calgary_combined,2520,2383,0:00:29,29,,137,69107
2014-07-01-ccc_help_script,2014/07/01,ccc_help_script,6,6,0:00:04,4,,0,24
2014-07-01-ccc_priority_script,2014/07/01,ccc_priority_script,35,34,0:00:09,9,,1,306
2014-07-01-ccc_tax_script,2014/07/01,ccc_tax_script,3,3,0:00:05,5,,0,15
2014-07-02-ccc_311_calgary_combined,2014/07/02,ccc_311_calgary_combined,5326,4622,0:02:00,120,,704,554640
2014-07-02-ccc_help_script,2014/07/02,ccc_help_script,3,3,0:00:10,10,,0,30
2014-07-02-ccc_priority_script,2014/07/02,ccc_priority_script,34,34,0:00:12,12,,0,408
2014-07-02-ccc_tax_script,2014/07/02,ccc_tax_script,14,13,0:01:47,107,,1,1391
2014-07-03-ccc_311_calgary_combined,2014/07/03,ccc_311_calgary_combined,4870,4189,0:01:58,118,,681,494302
2014-07-03-ccc_help_script,2014/07/03,ccc_help_script,5,5,0:00:15,15,,0,75
2014-07-03-ccc_priority_script,2014/07/03,ccc_priority_script,42,41,0:00:16,16,,1,656
2014-07-03-ccc_tax_script,2014/07/03,ccc_tax_script,28,20,0:01:37,97,,8,1940
2014-07-04-ccc_311_calgary_combined,2014/07/04,ccc_311_calgary_combined,4077,3677,0:01:09,69,,400,253713
2014-07-04-ccc_help_script,2014/07/04,ccc_help_script,3,3,0:00:04,4,,0,12
2014-07-04-ccc_priority_script,2014/07/04,ccc_priority_script,38,38,0:00:25,25,,0,950
2014-07-04-ccc_tax_script,2014/07/04,ccc_tax_script,24,21,0:00:47,47,,3,987
2014-07-05-ccc_311_calgary_combined,2014/07/05,ccc_311_calgary_combined,1726,1445,0:01:59,119,,281,171955
2014-07-05-ccc_priority_script,2014/07/05,ccc_priority_script,41,40,0:00:41,41,,1,1640
2014-07-06-ccc_311_calgary_combined,2014/07/06,ccc_311_calgary_combined,1389,1170,0:01:43,103,,219,120510
2014-07-06-ccc_priority_script,2014/07/06,ccc_priority_script,29,27,0:00:43,43,,2,1161
2014-07-07-ccc_311_calgary_combined,2014/07/07,ccc_311_calgary_combined,5020,3960,0:03:33,213,,1060,843480
2014-07-07-ccc_help_script,2014/07/07,ccc_help_script,1,1,0:00:03,3,,0,3
2014-07-07-ccc_priority_script,2014/07/07,ccc_priority_script,35,34,0:00:14,14,,1,476
2014-07-07-ccc_tax_script,2014/07/07,ccc_tax_script,15,11,0:05:44,344,,4,3784
2014-07-08-ccc_311_calgary_combined,2014/07/08,ccc_311_calgary_combined,4456,3826,0:02:11,131,,630,501206
2014-07-08-ccc_help_script,2014/07/08,ccc_help_script,4,2,0:00:10,10,,2,20
2014-07-08-ccc_priority_script,2014/07/08,ccc_priority_script,49,49,0:00:19,19,,0,931
2014-07-08-ccc_tax_script,2014/07/08,ccc_tax_script,28,18,0:01:35,95,,10,1710
2014-07-09-ccc_311_calgary_combined,2014/07/09,ccc_311_calgary_combined,4427,3457,0:03:30,210,,970,725970
2014-07-09-ccc_help_script,2014/07/09,ccc_help_script,3,2,0:00:31,31,,1,62
2014-07-09-ccc_priority_script,2014/07/09,ccc_priority_script,46,45,0:00:14,14,,1,630
2014-07-09-ccc_tax_script,2014/07/09,ccc_tax_script,16,12,0:04:24,264,,4,3168
2014-07-10-ccc_311_calgary_combined,2014/07/10,ccc_311_calgary_combined,4690,3179,0:06:01,361,,1511,1147619
2014-07-10-ccc_help_script,2014/07/10,ccc_help_script,4,3,0:00:27,27,,1,81
2014-07-10-ccc_priority_script,2014/07/10,ccc_priority_script,61,57,0:00:17,17,,4,969
2014-07-10-ccc_tax_script,2014/07/10,ccc_tax_script,14,11,0:06:45,405,,3,4455
2014-07-11-ccc_311_calgary_combined,2014/07/11,ccc_311_calgary_combined,3836,3285,0:02:00,120,,551,394200
2014-07-11-ccc_help_script,2014/07/11,ccc_help_script,3,3,0:00:11,11,,0,33
2014-07-11-ccc_priority_script,2014/07/11,ccc_priority_script,52,44,0:00:15,15,,8,660
2014-07-11-ccc_tax_script,2014/07/11,ccc_tax_script,17,15,0:02:28,148,,2,2220
2014-07-12-ccc_311_calgary_combined,2014/07/12,ccc_311_calgary_combined,1608,1465,0:00:50,50,,143,73250
2014-07-12-ccc_help_script,2014/07/12,ccc_help_script,1,1,0:00:13,13,,0,13
2014-07-12-ccc_priority_script,2014/07/12,ccc_priority_script,40,35,0:00:14,14,,5,490
2014-07-12-ccc_tax_script,2014/07/12,ccc_tax_script,1,1,0:01:37,97,,0,97
2014-07-13-ccc_311_calgary_combined,2014/07/13,ccc_311_calgary_combined,1337,1239,0:00:27,27,,98,33453
2014-07-13-ccc_help_script,2014/07/13,ccc_help_script,1,1,0:00:06,6,,0,6
2014-07-13-ccc_priority_script,2014/07/13,ccc_priority_script,27,27,0:00:08,8,,0,216
2014-07-14-ccc_311_calgary_combined,2014/07/14,ccc_311_calgary_combined,4570,3600,0:03:51,231,,970,831600
2014-07-14-ccc_help_script,2014/07/14,ccc_help_script,5,3,0:00:11,11,,2,33
2014-07-14-ccc_priority_script,2014/07/14,ccc_priority_script,53,46,0:00:20,20,,7,920
2014-07-14-ccc_tax_script,2014/07/14,ccc_tax_script,21,14,0:03:44,224,,7,3136
2014-07-15-ccc_311_calgary_combined,2014/07/15,ccc_311_calgary_combined,4541,3177,0:05:27,327,,1364,1038879
2014-07-15-ccc_help_script,2014/07/15,ccc_help_script,5,5,0:00:13,13,,0,65
2014-07-15-ccc_priority_script,2014/07/15,ccc_priority_script,51,50,0:00:20,20,,1,1000
2014-07-15-ccc_tax_script,2014/07/15,ccc_tax_script,24,12,0:08:17,497,,12,5964
2014-07-16-ccc_311_calgary_combined,2014/07/16,ccc_311_calgary_combined,4469,3293,0:04:45,285,,1176,938505
2014-07-16-ccc_help_script,2014/07/16,ccc_help_script,6,6,0:00:13,13,,0,78
2014-07-16-ccc_priority_script,2014/07/16,ccc_priority_script,66,45,0:00:17,17,,21,765
2014-07-16-ccc_tax_script,2014/07/16,ccc_tax_script,17,11,0:06:19,379,,6,4169
2014-07-17-ccc_311_calgary_combined,2014/07/17,ccc_311_calgary_combined,4259,3704,0:01:48,108,,555,400032
2014-07-17-ccc_help_script,2014/07/17,ccc_help_script,5,5,0:00:12,12,,0,60
2014-07-17-ccc_priority_script,2014/07/17,ccc_priority_script,63,59,0:00:16,16,,4,944
2014-07-17-ccc_tax_script,2014/07/17,ccc_tax_script,17,14,0:02:03,123,,3,1722
2014-07-18-ccc_311_calgary_combined,2014/07/18,ccc_311_calgary_combined,3861,3493,0:01:28,88,,368,307384
2014-07-18-ccc_help_script,2014/07/18,ccc_help_script,3,3,0:00:06,6,,0,18
2014-07-18-ccc_priority_script,2014/07/18,ccc_priority_script,35,33,0:00:21,21,,2,693
2014-07-18-ccc_tax_script,2014/07/18,ccc_tax_script,13,12,0:01:24,84,,1,1008
2014-07-19-ccc_311_calgary_combined,2014/07/19,ccc_311_calgary_combined,1517,1490,0:00:14,14,,27,20860
2014-07-19-ccc_help_script,2014/07/19,ccc_help_script,1,1,0:00:10,10,,0,10
2014-07-19-ccc_priority_script,2014/07/19,ccc_priority_script,33,31,0:00:07,7,,2,217
2014-07-19-ccc_tax_script,2014/07/19,ccc_tax_script,1,0,0:00:00,0,,1,0
2014-07-20-ccc_311_calgary_combined,2014/07/20,ccc_311_calgary_combined,1225,1195,0:00:12,12,,30,14340
2014-07-20-ccc_priority_script,2014/07/20,ccc_priority_script,31,30,0:00:07,7,,1,210
2014-07-21-ccc_311_calgary_combined,2014/07/21,ccc_311_calgary_combined,4421,3787,0:02:21,141,,634,533967
2014-07-21-ccc_help_script,2014/07/21,ccc_help_script,7,7,0:00:07,7,,0,49
2014-07-21-ccc_priority_script,2014/07/21,ccc_priority_script,43,41,0:00:13,13,,2,533
2014-07-21-ccc_tax_script,2014/07/21,ccc_tax_script,16,14,0:02:11,131,,2,1834
2014-07-22-ccc_311_calgary_combined,2014/07/22,ccc_311_calgary_combined,4228,3490,0:02:54,174,,738,607260
2014-07-22-ccc_help_script,2014/07/22,ccc_help_script,4,4,0:00:26,26,,0,104
2014-07-22-ccc_priority_script,2014/07/22,ccc_priority_script,28,27,0:00:16,16,,1,432
2014-07-22-ccc_tax_script,2014/07/22,ccc_tax_script,22,19,0:02:51,171,,3,3249
2014-07-23-ccc_311_calgary_combined,2014/07/23,ccc_311_calgary_combined,4303,3630,0:02:40,160,,673,580800
2014-07-23-ccc_help_script,2014/07/23,ccc_help_script,8,8,0:00:13,13,,0,104
2014-07-23-ccc_priority_script,2014/07/23,ccc_priority_script,39,39,0:00:24,24,,0,936
2014-07-23-ccc_tax_script,2014/07/23,ccc_tax_script,24,17,0:03:56,236,,7,4012
2014-07-24-ccc_311_calgary_combined,2014/07/24,ccc_311_calgary_combined,4464,3515,0:03:30,210,,949,738150
2014-07-24-ccc_help_script,2014/07/24,ccc_help_script,10,9,0:00:13,13,,1,117
2014-07-24-ccc_priority_script,2014/07/24,ccc_priority_script,48,48,0:00:18,18,,0,864
2014-07-24-ccc_tax_script,2014/07/24,ccc_tax_script,21,16,0:03:17,197,,5,3152
2014-07-25-ccc_311_calgary_combined,2014/07/25,ccc_311_calgary_combined,3705,3354,0:01:27,87,,351,291798
2014-07-25-ccc_help_script,2014/07/25,ccc_help_script,4,4,0:00:17,17,,0,68
2014-07-25-ccc_priority_script,2014/07/25,ccc_priority_script,26,25,0:00:14,14,,1,350
2014-07-25-ccc_tax_script,2014/07/25,ccc_tax_script,18,16,0:01:32,92,,2,1472
2014-07-26-ccc_311_calgary_combined,2014/07/26,ccc_311_calgary_combined,1495,1401,0:00:36,36,,94,50436
2014-07-26-ccc_priority_script,2014/07/26,ccc_priority_script,25,25,0:00:07,7,,0,175
2014-07-26-ccc_tax_script,2014/07/26,ccc_tax_script,3,2,0:01:51,111,,1,222
2014-07-27-ccc_311_calgary_combined,2014/07/27,ccc_311_calgary_combined,1352,1281,0:00:35,35,,71,44835
2014-07-27-ccc_priority_script,2014/07/27,ccc_priority_script,19,18,0:00:10,10,,1,180
2014-07-27-ccc_tax_script,2014/07/27,ccc_tax_script,1,1,0:00:02,2,,0,2
2014-07-28-ccc_311_calgary_combined,2014/07/28,ccc_311_calgary_combined,4369,3924,0:01:46,106,,445,415944
2014-07-28-ccc_priority_script,2014/07/28,ccc_priority_script,47,45,0:00:14,14,,2,630
2014-07-28-ccc_tax_script,2014/07/28,ccc_tax_script,19,17,0:02:15,135,,2,2295
2014-07-29-ccc_311_calgary_combined,2014/07/29,ccc_311_calgary_combined,4269,3684,0:02:03,123,,585,453132
2014-07-29-ccc_help_script,2014/07/29,ccc_help_script,3,3,0:00:06,6,,0,18
2014-07-29-ccc_priority_script,2014/07/29,ccc_priority_script,41,38,0:00:16,16,,3,608
2014-07-29-ccc_tax_script,2014/07/29,ccc_tax_script,33,30,0:02:39,159,,3,4770
2014-07-30-ccc_311_calgary_combined,2014/07/30,ccc_311_calgary_combined,4441,3323,0:04:11,251,,1118,834073
2014-07-30-ccc_help_script,2014/07/30,ccc_help_script,5,4,0:00:19,19,,1,76
2014-07-30-ccc_priority_script,2014/07/30,ccc_priority_script,60,56,0:00:17,17,,4,952
2014-07-30-ccc_tax_script,2014/07/30,ccc_tax_script,27,18,0:05:01,301,,9,5418
2014-07-31-ccc_311_calgary_combined,2014/07/31,ccc_311_calgary_combined,3866,3530,0:01:24,84,,336,296520
2014-07-31-ccc_help_script,2014/07/31,ccc_help_script,8,8,0:00:15,15,,0,120
2014-07-31-ccc_priority_script,2014/07/31,ccc_priority_script,31,30,0:00:16,16,,1,480
2014-07-31-ccc_tax_script,2014/07/31,ccc_tax_script,12,8,0:02:04,124,,4,992
2014-08-01-ccc_311_calgary_combined,2014/08/01,ccc_311_calgary_combined,3704,3386,0:01:17,77,,318,260722
2014-08-01-ccc_help_script,2014/08/01,ccc_help_script,4,4,0:00:21,21,,0,84
2014-08-01-ccc_priority_script,2014/08/01,ccc_priority_script,44,41,0:00:12,12,,3,492
2014-08-01-ccc_tax_script,2014/08/01,ccc_tax_script,10,9,0:01:04,64,,1,576
2014-08-02-ccc_311_calgary_combined,2014/08/02,ccc_311_calgary_combined,1380,1337,0:00:19,19,,43,25403
2014-08-02-ccc_priority_script,2014/08/02,ccc_priority_script,16,16,0:00:05,5,,0,80
2014-08-02-ccc_tax_script,2014/08/02,ccc_tax_script,1,1,0:00:08,8,,0,8
2014-08-03-ccc_311_calgary_combined,2014/08/03,ccc_311_calgary_combined,1302,1235,0:00:22,22,,67,27170
2014-08-03-ccc_help_script,2014/08/03,ccc_help_script,1,1,0:00:08,8,,0,8
2014-08-03-ccc_priority_script,2014/08/03,ccc_priority_script,28,25,0:00:08,8,,3,200
2014-08-04-ccc_311_calgary_combined,2014/08/04,ccc_311_calgary_combined,1537,1490,0:00:21,21,,47,31290
2014-08-04-ccc_help_script,2014/08/04,ccc_help_script,2,2,0:00:08,8,,0,16
2014-08-04-ccc_priority_script,2014/08/04,ccc_priority_script,32,29,0:00:12,12,,3,348
2014-08-05-ccc_311_calgary_combined,2014/08/05,ccc_311_calgary_combined,4995,3436,0:06:18,378,,1559,1298808
2014-08-05-ccc_help_script,2014/08/05,ccc_help_script,4,4,0:00:13,13,,0,52
2014-08-05-ccc_priority_script,2014/08/05,ccc_priority_script,39,37,0:00:17,17,,2,629
2014-08-05-ccc_tax_script,2014/08/05,ccc_tax_script,25,13,0:08:38,518,,12,6734
2014-08-06-ccc_311_calgary_combined,2014/08/06,ccc_311_calgary_combined,4398,3667,0:02:49,169,,731,619723
2014-08-06-ccc_help_script,2014/08/06,ccc_help_script,5,5,0:00:18,18,,0,90
2014-08-06-ccc_priority_script,2014/08/06,ccc_priority_script,30,30,0:00:23,23,,0,690
2014-08-06-ccc_tax_script,2014/08/06,ccc_tax_script,11,9,0:08:02,482,,2,4338
2014-08-07-ccc_311_calgary_combined,2014/08/07,ccc_311_calgary_combined,3947,3473,0:01:53,113,,474,392449
2014-08-07-ccc_help_script,2014/08/07,ccc_help_script,2,2,0:00:05,5,,0,10
2014-08-07-ccc_priority_script,2014/08/07,ccc_priority_script,37,34,0:00:15,15,,3,510
2014-08-07-ccc_tax_script,2014/08/07,ccc_tax_script,13,13,0:02:22,142,,0,1846
2014-08-08-ccc_311_calgary_combined,2014/08/08,ccc_311_calgary_combined,3764,3628,0:00:30,30,,136,108840
2014-08-08-ccc_help_script,2014/08/08,ccc_help_script,1,1,0:00:46,46,,0,46
2014-08-08-ccc_priority_script,2014/08/08,ccc_priority_script,70,57,0:00:16,16,,13,912
2014-08-08-ccc_tax_script,2014/08/08,ccc_tax_script,14,14,0:00:26,26,,0,364
2014-08-09-ccc_311_calgary_combined,2014/08/09,ccc_311_calgary_combined,1439,1356,0:00:34,34,,83,46104
2014-08-09-ccc_priority_script,2014/08/09,ccc_priority_script,28,28,0:00:18,18,,0,504
2014-08-10-ccc_311_calgary_combined,2014/08/10,ccc_311_calgary_combined,1193,1154,0:00:26,26,,39,30004
2014-08-10-ccc_priority_script,2014/08/10,ccc_priority_script,28,28,0:00:50,50,,0,1400
2014-08-11-ccc_311_calgary_combined,2014/08/11,ccc_311_calgary_combined,4442,3750,0:02:18,138,,692,517500
2014-08-11-ccc_help_script,2014/08/11,ccc_help_script,4,4,0:00:08,8,,0,32
2014-08-11-ccc_priority_script,2014/08/11,ccc_priority_script,34,31,0:00:11,11,,3,341
2014-08-11-ccc_tax_script,2014/08/11,ccc_tax_script,10,9,0:04:31,271,,1,2439
2014-08-12-ccc_311_calgary_combined,2014/08/12,ccc_311_calgary_combined,4166,3685,0:01:51,111,,481,409035
2014-08-12-ccc_help_script,2014/08/12,ccc_help_script,3,1,0:00:02,2,,2,2
2014-08-12-ccc_priority_script,2014/08/12,ccc_priority_script,50,44,0:00:14,14,,6,616
2014-08-12-ccc_tax_script,2014/08/12,ccc_tax_script,11,6,0:01:35,95,,5,570
2014-08-13-ccc_311_calgary_combined,2014/08/13,ccc_311_calgary_combined,3990,3296,0:02:41,161,,694,530656
2014-08-13-ccc_help_script,2014/08/13,ccc_help_script,6,5,0:00:19,19,,1,95
2014-08-13-ccc_priority_script,2014/08/13,ccc_priority_script,48,47,0:00:12,12,,1,564
2014-08-13-ccc_tax_script,2014/08/13,ccc_tax_script,18,15,0:04:29,269,,3,4035
2014-08-14-ccc_311_calgary_combined,2014/08/14,ccc_311_calgary_combined,3966,3124,0:03:29,209,,842,652916
2014-08-14-ccc_help_script,2014/08/14,ccc_help_script,2,2,0:00:22,22,,0,44
2014-08-14-ccc_priority_script,2014/08/14,ccc_priority_script,47,42,0:00:15,15,,5,630
2014-08-14-ccc_tax_script,2014/08/14,ccc_tax_script,17,15,0:03:45,225,,2,3375
2014-08-15-ccc_311_calgary_combined,2014/08/15,ccc_311_calgary_combined,3513,3171,0:01:13,73,,342,231483
2014-08-15-ccc_help_script,2014/08/15,ccc_help_script,5,4,0:00:09,9,,1,36
2014-08-15-ccc_priority_script,2014/08/15,ccc_priority_script,55,38,0:00:14,14,,17,532
2014-08-15-ccc_tax_script,2014/08/15,ccc_tax_script,9,8,0:01:34,94,,1,752
2014-08-16-ccc_311_calgary_combined,2014/08/16,ccc_311_calgary_combined,1178,1134,0:00:20,20,,44,22680
2014-08-16-ccc_help_script,2014/08/16,ccc_help_script,1,1,0:00:05,5,,0,5
2014-08-16-ccc_priority_script,2014/08/16,ccc_priority_script,31,29,0:00:14,14,,2,406
2014-08-17-ccc_311_calgary_combined,2014/08/17,ccc_311_calgary_combined,1025,991,0:00:18,18,,34,17838
2014-08-17-ccc_priority_script,2014/08/17,ccc_priority_script,22,22,0:00:07,7,,0,154
2014-08-18-ccc_311_calgary_combined,2014/08/18,ccc_311_calgary_combined,4222,3369,0:03:27,207,,853,697383
2014-08-18-ccc_priority_script,2014/08/18,ccc_priority_script,23,23,0:00:15,15,,0,345
2014-08-18-ccc_tax_script,2014/08/18,ccc_tax_script,17,14,0:03:57,237,,3,3318
2014-08-19-ccc_311_calgary_combined,2014/08/19,ccc_311_calgary_combined,4167,2931,0:04:44,284,,1236,832404
2014-08-19-ccc_help_script,2014/08/19,ccc_help_script,1,1,0:00:43,43,,0,43
2014-08-19-ccc_priority_script,2014/08/19,ccc_priority_script,41,36,0:00:16,16,,5,576
2014-08-19-ccc_tax_script,2014/08/19,ccc_tax_script,12,9,0:03:18,198,,3,1782
2014-08-20-ccc_311_calgary_combined,2014/08/20,ccc_311_calgary_combined,3882,3195,0:03:02,182,,687,581490
2014-08-20-ccc_help_script,2014/08/20,ccc_help_script,3,3,0:00:11,11,,0,33
2014-08-20-ccc_priority_script,2014/08/20,ccc_priority_script,35,35,0:00:11,11,,0,385
2014-08-20-ccc_tax_script,2014/08/20,ccc_tax_script,12,9,0:05:06,306,,3,2754
2014-08-21-ccc_311_calgary_combined,2014/08/21,ccc_311_calgary_combined,3513,3205,0:01:21,81,,308,259605
2014-08-21-ccc_help_script,2014/08/21,ccc_help_script,11,11,0:00:09,9,,0,99
2014-08-21-ccc_priority_script,2014/08/21,ccc_priority_script,27,25,0:00:11,11,,2,275
2014-08-21-ccc_tax_script,2014/08/21,ccc_tax_script,11,7,0:01:41,101,,4,707
2014-08-22-ccc_311_calgary_combined,2014/08/22,ccc_311_calgary_combined,3173,2937,0:01:06,66,,236,193842
2014-08-22-ccc_help_script,2014/08/22,ccc_help_script,5,5,0:00:04,4,,0,20
2014-08-22-ccc_priority_script,2014/08/22,ccc_priority_script,24,22,0:00:16,16,,2,352
2014-08-22-ccc_tax_script,2014/08/22,ccc_tax_script,25,21,0:01:21,81,,4,1701
2014-08-23-ccc_311_calgary_combined,2014/08/23,ccc_311_calgary_combined,1266,1245,0:00:14,14,,21,17430
2014-08-23-ccc_priority_script,2014/08/23,ccc_priority_script,25,25,0:00:07,7,,0,175
2014-08-24-ccc_311_calgary_combined,2014/08/24,ccc_311_calgary_combined,1045,1023,0:00:18,18,,22,18414
2014-08-24-ccc_priority_script,2014/08/24,ccc_priority_script,23,23,0:00:13,13,,0,299
2014-08-25-ccc_311_calgary_combined,2014/08/25,ccc_311_calgary_combined,4100,3651,0:01:43,103,,449,376053
2014-08-25-ccc_priority_script,2014/08/25,ccc_priority_script,27,26,0:00:12,12,,1,312
2014-08-25-ccc_tax_script,2014/08/25,ccc_tax_script,10,8,0:02:36,156,,2,1248
2014-08-26-ccc_311_calgary_combined,2014/08/26,ccc_311_calgary_combined,4109,3374,0:02:54,174,,735,587076
2014-08-26-ccc_help_script,2014/08/26,ccc_help_script,3,3,0:00:05,5,,0,15
2014-08-26-ccc_priority_script,2014/08/26,ccc_priority_script,36,34,0:00:17,17,,2,578
2014-08-26-ccc_tax_script,2014/08/26,ccc_tax_script,18,15,0:02:56,176,,3,2640
2014-08-27-ccc_311_calgary_combined,2014/08/27,ccc_311_calgary_combined,4609,3186,0:05:55,355,,1423,1131030
2014-08-27-ccc_help_script,2014/08/27,ccc_help_script,7,7,0:00:23,23,,0,161
2014-08-27-ccc_priority_script,2014/08/27,ccc_priority_script,39,39,0:00:19,19,,0,741
2014-08-27-ccc_tax_script,2014/08/27,ccc_tax_script,23,14,0:05:43,343,,9,4802
2014-08-28-ccc_311_calgary_combined,2014/08/28,ccc_311_calgary_combined,4315,3355,0:04:31,271,,960,909205
2014-08-28-ccc_help_script,2014/08/28,ccc_help_script,4,4,0:00:09,9,,0,36
2014-08-28-ccc_priority_script,2014/08/28,ccc_priority_script,26,24,0:00:14,14,,2,336
2014-08-28-ccc_tax_script,2014/08/28,ccc_tax_script,21,13,0:04:23,263,,8,3419
2014-08-29-ccc_311_calgary_combined,2014/08/29,ccc_311_calgary_combined,3737,3406,0:01:28,88,,331,299728
2014-08-29-ccc_help_script,2014/08/29,ccc_help_script,1,1,0:00:09,9,,0,9
2014-08-29-ccc_priority_script,2014/08/29,ccc_priority_script,34,33,0:00:15,15,,1,495
2014-08-29-ccc_tax_script,2014/08/29,ccc_tax_script,10,7,0:00:42,42,,3,294
2014-08-30-ccc_311_calgary_combined,2014/08/30,ccc_311_calgary_combined,1339,1218,0:01:12,72,,121,87696
2014-08-30-ccc_help_script,2014/08/30,ccc_help_script,1,1,0:00:02,2,,0,2
2014-08-30-ccc_priority_script,2014/08/30,ccc_priority_script,24,20,0:00:30,30,,4,600
2014-08-31-ccc_311_calgary_combined,2014/08/31,ccc_311_calgary_combined,1119,1025,0:01:07,67,,94,68675
2014-08-31-ccc_help_script,2014/08/31,ccc_help_script,1,1,0:00:02,2,,0,2
2014-08-31-ccc_priority_script,2014/08/31,ccc_priority_script,38,36,0:00:18,18,,2,648
2014-09-01-ccc_311_calgary_combined,2014/09/01,ccc_311_calgary_combined,1346,1287,0:00:35,35,,59,45045
2014-09-01-ccc_help_script,2014/09/01,ccc_help_script,3,3,0:00:05,5,,0,15
2014-09-01-ccc_priority_script,2014/09/01,ccc_priority_script,30,30,0:00:09,9,,0,270
2014-09-02-ccc_311_calgary_combined,2014/09/02,ccc_311_calgary_combined,4601,3859,0:02:55,175,,742,675325
2014-09-02-ccc_help_script,2014/09/02,ccc_help_script,3,3,0:00:19,19,,0,57
2014-09-02-ccc_priority_script,2014/09/02,ccc_priority_script,28,28,0:00:13,13,,0,364
2014-09-02-ccc_tax_script,2014/09/02,ccc_tax_script,17,14,0:04:06,246,,3,3444
2014-09-03-ccc_311_calgary_combined,2014/09/03,ccc_311_calgary_combined,4102,3859,0:01:04,64,,243,246976
2014-09-03-ccc_help_script,2014/09/03,ccc_help_script,3,3,0:00:02,2,,0,6
2014-09-03-ccc_priority_script,2014/09/03,ccc_priority_script,29,28,0:00:10,10,,1,280
2014-09-03-ccc_tax_script,2014/09/03,ccc_tax_script,17,15,0:02:15,135,,2,2025
2014-09-04-ccc_311_calgary_combined,2014/09/04,ccc_311_calgary_combined,5148,3789,0:03:30,210,,1359,795690
2014-09-04-ccc_help_script,2014/09/04,ccc_help_script,5,5,0:00:22,22,,0,110
2014-09-04-ccc_priority_script,2014/09/04,ccc_priority_script,42,42,0:00:16,16,,0,672
2014-09-04-ccc_tax_script,2014/09/04,ccc_tax_script,11,9,0:04:07,247,,2,2223
2014-09-05-ccc_311_calgary_combined,2014/09/05,ccc_311_calgary_combined,3838,3431,0:01:45,105,,407,360255
2014-09-05-ccc_help_script,2014/09/05,ccc_help_script,8,8,0:00:10,10,,0,80
2014-09-05-ccc_priority_script,2014/09/05,ccc_priority_script,33,31,0:00:21,21,,2,651
2014-09-05-ccc_tax_script,2014/09/05,ccc_tax_script,19,18,0:01:13,73,,1,1314
2014-09-06-ccc_311_calgary_combined,2014/09/06,ccc_311_calgary_combined,1416,1357,0:00:24,24,,59,32568
2014-09-06-ccc_help_script,2014/09/06,ccc_help_script,3,3,0:00:03,3,,0,9
2014-09-06-ccc_priority_script,2014/09/06,ccc_priority_script,29,28,0:00:14,14,,1,392
2014-09-07-ccc_311_calgary_combined,2014/09/07,ccc_311_calgary_combined,1215,1144,0:00:42,42,,71,48048
2014-09-07-ccc_priority_script,2014/09/07,ccc_priority_script,31,28,0:00:14,14,,3,392
2014-09-08-ccc_311_calgary_combined,2014/09/08,ccc_311_calgary_combined,5748,3896,0:05:39,339,,1852,1320744
2014-09-08-ccc_help_script,2014/09/08,ccc_help_script,3,3,0:00:33,33,,0,99
2014-09-08-ccc_priority_script,2014/09/08,ccc_priority_script,90,82,0:00:25,25,,8,2050
2014-09-08-ccc_tax_script,2014/09/08,ccc_tax_script,18,11,0:02:25,145,,7,1595
2014-09-09-ccc_311_calgary_combined,2014/09/09,ccc_311_calgary_combined,5866,4130,0:06:26,386,,1736,1594180
2014-09-09-ccc_help_script,2014/09/09,ccc_help_script,13,12,0:00:07,7,,1,84
2014-09-09-ccc_priority_script,2014/09/09,ccc_priority_script,67,66,0:00:13,13,,1,858
2014-09-09-ccc_tax_script,2014/09/09,ccc_tax_script,18,12,0:06:08,368,,6,4416
2014-09-10-ccc_311_calgary_combined,2014/09/10,ccc_311_calgary_combined,12320,4585,0:19:42,1182,,7735,5419470
2014-09-10-ccc_help_script,2014/09/10,ccc_help_script,38,37,0:00:14,14,,1,518
2014-09-10-ccc_priority_script,2014/09/10,ccc_priority_script,161,158,0:00:20,20,,3,3160
2014-09-10-ccc_tax_script,2014/09/10,ccc_tax_script,10,4,0:21:30,1290,,6,5160
2014-09-11-ccc_311_calgary_combined,2014/09/11,ccc_311_calgary_combined,5764,3778,0:06:07,367,,1986,1386526
2014-09-11-ccc_help_script,2014/09/11,ccc_help_script,46,46,0:00:11,11,,0,506
2014-09-11-ccc_priority_script,2014/09/11,ccc_priority_script,54,52,0:05:20,320,,2,16640
2014-09-11-ccc_tax_script,2014/09/11,ccc_tax_script,24,13,0:05:20,320,,11,4160
2014-09-12-ccc_311_calgary_combined,2014/09/12,ccc_311_calgary_combined,4737,3269,0:05:16,316,,1468,1033004
2014-09-12-ccc_help_script,2014/09/12,ccc_help_script,52,51,0:00:15,15,,1,765
2014-09-12-ccc_priority_script,2014/09/12,ccc_priority_script,49,47,0:00:16,16,,2,752
2014-09-12-ccc_tax_script,2014/09/12,ccc_tax_script,19,13,0:05:47,347,,6,4511
2014-09-13-ccc_311_calgary_combined,2014/09/13,ccc_311_calgary_combined,2683,1586,0:09:24,564,,1097,894504
2014-09-13-ccc_help_script,2014/09/13,ccc_help_script,25,25,0:00:30,30,,0,750
2014-09-13-ccc_priority_script,2014/09/13,ccc_priority_script,30,28,0:00:32,32,,2,896
2014-09-13-ccc_tax_script,2014/09/13,ccc_tax_script,1,0,0:00:00,0,,1,0
2014-09-14-ccc_311_calgary_combined,2014/09/14,ccc_311_calgary_combined,1955,1563,0:02:15,135,,392,211005
2014-09-14-ccc_help_script,2014/09/14,ccc_help_script,21,21,0:00:26,26,,0,546
2014-09-14-ccc_priority_script,2014/09/14,ccc_priority_script,27,25,0:00:28,28,,2,700
2014-09-15-ccc_311_calgary_combined,2014/09/15,ccc_311_calgary_combined,5682,3500,0:09:11,551,,2182,1928500
2014-09-15-ccc_help_script,2014/09/15,ccc_help_script,6,5,0:00:46,46,,1,230
2014-09-15-ccc_priority_script,2014/09/15,ccc_priority_script,34,32,0:00:15,15,,2,480
2014-09-15-ccc_tax_script,2014/09/15,ccc_tax_script,25,16,0:13:11,791,,9,12656
2014-09-16-ccc_311_calgary_combined,2014/09/16,ccc_311_calgary_combined,5140,3230,0:08:03,483,,1910,1560090
2014-09-16-ccc_help_script,2014/09/16,ccc_help_script,6,6,0:00:16,16,,0,96
2014-09-16-ccc_priority_script,2014/09/16,ccc_priority_script,50,49,0:00:19,19,,1,931
2014-09-16-ccc_tax_script,2014/09/16,ccc_tax_script,18,11,0:08:59,539,,7,5929
2014-09-17-ccc_311_calgary_combined,2014/09/17,ccc_311_calgary_combined,4812,3313,0:06:17,377,,1499,1249001
2014-09-17-ccc_help_script,2014/09/17,ccc_help_script,5,5,0:00:22,22,,0,110
2014-09-17-ccc_priority_script,2014/09/17,ccc_priority_script,58,52,0:00:18,18,,6,936
2014-09-17-ccc_tax_script,2014/09/17,ccc_tax_script,23,12,0:08:29,509,,11,6108
2014-09-18-ccc_311_calgary_combined,2014/09/18,ccc_311_calgary_combined,4318,3098,0:05:19,319,,1220,988262
2014-09-18-ccc_help_script,2014/09/18,ccc_help_script,7,6,0:00:10,10,,1,60
2014-09-18-ccc_priority_script,2014/09/18,ccc_priority_script,43,42,0:00:23,23,,1,966
2014-09-18-ccc_tax_script,2014/09/18,ccc_tax_script,19,14,0:05:13,313,,5,4382
2014-09-19-ccc_311_calgary_combined,2014/09/19,ccc_311_calgary_combined,3662,3362,0:00:58,58,,300,194996
2014-09-19-ccc_help_script,2014/09/19,ccc_help_script,5,5,0:00:10,10,,0,50
2014-09-19-ccc_priority_script,2014/09/19,ccc_priority_script,32,31,0:00:09,9,,1,279
2014-09-19-ccc_tax_script,2014/09/19,ccc_tax_script,16,11,0:01:16,76,,5,836
2014-09-20-ccc_311_calgary_combined,2014/09/20,ccc_311_calgary_combined,1647,1446,0:01:18,78,,201,112788
2014-09-20-ccc_help_script,2014/09/20,ccc_help_script,3,3,0:00:25,25,,0,75
2014-09-20-ccc_priority_script,2014/09/20,ccc_priority_script,32,30,0:00:23,23,,2,690
2014-09-21-ccc_311_calgary_combined,2014/09/21,ccc_311_calgary_combined,1342,1219,0:00:59,59,,123,71921
2014-09-21-ccc_priority_script,2014/09/21,ccc_priority_script,35,29,0:00:15,15,,6,435
2014-09-22-ccc_311_calgary_combined,2014/09/22,ccc_311_calgary_combined,4810,2948,0:09:02,542,,1862,1597816
2014-09-22-ccc_help_script,2014/09/22,ccc_help_script,5,4,0:00:16,16,,1,64
2014-09-22-ccc_priority_script,2014/09/22,ccc_priority_script,44,43,0:00:21,21,,1,903
2014-09-22-ccc_tax_script,2014/09/22,ccc_tax_script,28,15,0:10:48,648,,13,9720
2014-09-23-ccc_311_calgary_combined,2014/09/23,ccc_311_calgary_combined,4189,3027,0:05:10,310,,1162,938370
2014-09-23-ccc_help_script,2014/09/23,ccc_help_script,7,7,0:00:17,17,,0,119
2014-09-23-ccc_priority_script,2014/09/23,ccc_priority_script,36,36,0:00:16,16,,0,576
2014-09-23-ccc_tax_script,2014/09/23,ccc_tax_script,22,12,0:04:03,243,,10,2916
2014-09-24-ccc_311_calgary_combined,2014/09/24,ccc_311_calgary_combined,4086,3332,0:02:42,162,,754,539784
2014-09-24-ccc_help_script,2014/09/24,ccc_help_script,6,4,0:00:11,11,,2,44
2014-09-24-ccc_priority_script,2014/09/24,ccc_priority_script,41,41,0:00:14,14,,0,574
2014-09-24-ccc_tax_script,2014/09/24,ccc_tax_script,17,13,0:20:30,1230,,4,15990
2014-09-25-ccc_311_calgary_combined,2014/09/25,ccc_311_calgary_combined,4595,3267,0:05:01,301,,1328,983367
2014-09-25-ccc_help_script,2014/09/25,ccc_help_script,4,3,0:00:19,19,,1,57
2014-09-25-ccc_priority_script,2014/09/25,ccc_priority_script,30,30,0:00:09,9,,0,270
2014-09-25-ccc_tax_script,2014/09/25,ccc_tax_script,21,16,0:05:38,338,,5,5408
2014-09-26-ccc_311_calgary_combined,2014/09/26,ccc_311_calgary_combined,3530,2911,0:02:47,167,,619,486137
2014-09-26-ccc_priority_script,2014/09/26,ccc_priority_script,27,27,0:00:18,18,,0,486
2014-09-26-ccc_tax_script,2014/09/26,ccc_tax_script,15,12,0:03:32,212,,3,2544
2014-09-27-ccc_311_calgary_combined,2014/09/27,ccc_311_calgary_combined,1358,1284,0:00:40,40,,74,51360
2014-09-27-ccc_help_script,2014/09/27,ccc_help_script,2,2,0:00:37,37,,0,74
2014-09-27-ccc_priority_script,2014/09/27,ccc_priority_script,23,23,0:00:22,22,,0,506
2014-09-28-ccc_311_calgary_combined,2014/09/28,ccc_311_calgary_combined,1158,1123,0:00:19,19,,35,21337
2014-09-28-ccc_priority_script,2014/09/28,ccc_priority_script,11,11,0:00:09,9,,0,99
2014-09-29-ccc_311_calgary_combined,2014/09/29,ccc_311_calgary_combined,4576,3259,0:05:57,357,,1317,1163463
2014-09-29-ccc_help_script,2014/09/29,ccc_help_script,5,5,0:00:13,13,,0,65
2014-09-29-ccc_priority_script,2014/09/29,ccc_priority_script,32,28,0:00:20,20,,4,560
2014-09-29-ccc_tax_script,2014/09/29,ccc_tax_script,23,15,0:06:30,390,,8,5850
2014-09-30-ccc_311_calgary_combined,2014/09/30,ccc_311_calgary_combined,3772,3236,0:02:06,126,,536,407736
2014-09-30-ccc_help_script,2014/09/30,ccc_help_script,3,3,0:00:09,9,,0,27
2014-09-30-ccc_priority_script,2014/09/30,ccc_priority_script,46,42,0:00:27,27,,4,1134
2014-09-30-ccc_tax_script,2014/09/30,ccc_tax_script,15,14,0:02:04,124,,1,1736
2014-10-01-ccc_311_calgary_combined,2014/10/01,ccc_311_calgary_combined,4139,3312,0:03:13,193,,827,639216
2014-10-01-ccc_help_script,2014/10/01,ccc_help_script,4,3,0:00:23,23,,1,69
2014-10-01-ccc_priority_script,2014/10/01,ccc_priority_script,37,36,0:00:20,20,,1,720
2014-10-01-ccc_tax_script,2014/10/01,ccc_tax_script,18,8,0:02:50,170,,10,1360
2014-10-02-ccc_311_calgary_combined,2014/10/02,ccc_311_calgary_combined,3504,3302,0:00:50,50,,202,165100
2014-10-02-ccc_help_script,2014/10/02,ccc_help_script,1,1,0:00:02,2,,0,2
2014-10-02-ccc_priority_script,2014/10/02,ccc_priority_script,37,36,0:00:10,10,,1,360
2014-10-02-ccc_tax_script,2014/10/02,ccc_tax_script,29,26,0:00:37,37,,3,962
2014-10-03-ccc_311_calgary_combined,2014/10/03,ccc_311_calgary_combined,3182,2998,0:00:51,51,,184,152898
2014-10-03-ccc_help_script,2014/10/03,ccc_help_script,8,8,0:00:06,6,,0,48
2014-10-03-ccc_priority_script,2014/10/03,ccc_priority_script,25,23,0:00:10,10,,2,230
2014-10-03-ccc_tax_script,2014/10/03,ccc_tax_script,15,13,0:01:10,70,,2,910
2014-10-04-ccc_311_calgary_combined,2014/10/04,ccc_311_calgary_combined,1347,1288,0:00:22,22,,59,28336
2014-10-04-ccc_help_script,2014/10/04,ccc_help_script,1,1,0:00:01,1,,0,1
2014-10-04-ccc_priority_script,2014/10/04,ccc_priority_script,13,13,0:00:04,4,,0,52
2014-10-05-ccc_311_calgary_combined,2014/10/05,ccc_311_calgary_combined,1096,1069,0:00:17,17,,27,18173
2014-10-05-ccc_priority_script,2014/10/05,ccc_priority_script,16,16,0:00:16,16,,0,256
2014-10-06-ccc_311_calgary_combined,2014/10/06,ccc_311_calgary_combined,3978,3294,0:02:54,174,,684,573156
2014-10-06-ccc_help_script,2014/10/06,ccc_help_script,3,3,0:00:06,6,,0,18
2014-10-06-ccc_priority_script,2014/10/06,ccc_priority_script,33,33,0:00:18,18,,0,594
2014-10-06-ccc_tax_script,2014/10/06,ccc_tax_script,15,11,0:04:53,293,,4,3223
2014-10-07-ccc_311_calgary_combined,2014/10/07,ccc_311_calgary_combined,3928,2948,0:04:36,276,,980,813648
2014-10-07-ccc_help_script,2014/10/07,ccc_help_script,3,3,0:00:15,15,,0,45
2014-10-07-ccc_priority_script,2014/10/07,ccc_priority_script,46,43,0:00:24,24,,3,1032
2014-10-07-ccc_tax_script,2014/10/07,ccc_tax_script,14,10,0:04:41,281,,4,2810
2014-10-08-ccc_311_calgary_combined,2014/10/08,ccc_311_calgary_combined,3791,2963,0:03:28,208,,828,616304
2014-10-08-ccc_help_script,2014/10/08,ccc_help_script,8,8,0:00:22,22,,0,176
2014-10-08-ccc_priority_script,2014/10/08,ccc_priority_script,43,41,0:00:15,15,,2,615
2014-10-08-ccc_tax_script,2014/10/08,ccc_tax_script,16,13,0:04:27,267,,3,3471
2014-10-09-ccc_311_calgary_combined,2014/10/09,ccc_311_calgary_combined,3574,3304,0:01:03,63,,270,208152
2014-10-09-ccc_help_script,2014/10/09,ccc_help_script,6,6,0:00:17,17,,0,102
2014-10-09-ccc_priority_script,2014/10/09,ccc_priority_script,33,33,0:00:12,12,,0,396
2014-10-09-ccc_tax_script,2014/10/09,ccc_tax_script,10,10,0:00:53,53,,0,530
2014-10-10-ccc_311_calgary_combined,2014/10/10,ccc_311_calgary_combined,3206,2979,0:00:57,57,,227,169803
2014-10-10-ccc_help_script,2014/10/10,ccc_help_script,2,2,0:00:43,43,,0,86
2014-10-10-ccc_priority_script,2014/10/10,ccc_priority_script,31,28,0:00:10,10,,3,280
2014-10-10-ccc_tax_script,2014/10/10,ccc_tax_script,8,8,0:01:01,61,,0,488
2014-10-11-ccc_311_calgary_combined,2014/10/11,ccc_311_calgary_combined,1251,1180,0:00:35,35,,71,41300
2014-10-11-ccc_priority_script,2014/10/11,ccc_priority_script,36,35,0:00:31,31,,1,1085
2014-10-11-ccc_tax_script,2014/10/11,ccc_tax_script,1,1,0:04:01,241,,0,241
2014-10-12-ccc_311_calgary_combined,2014/10/12,ccc_311_calgary_combined,1363,1303,0:00:19,19,,60,24757
2014-10-12-ccc_help_script,2014/10/12,ccc_help_script,2,2,0:00:16,16,,0,32
2014-10-12-ccc_priority_script,2014/10/12,ccc_priority_script,27,26,0:00:16,16,,1,416
2014-10-13-ccc_311_calgary_combined,2014/10/13,ccc_311_calgary_combined,1411,1389,0:00:08,8,,22,11112
2014-10-13-ccc_priority_script,2014/10/13,ccc_priority_script,24,23,0:00:05,5,,1,115
2014-10-14-ccc_311_calgary_combined,2014/10/14,ccc_311_calgary_combined,4073,3692,0:01:06,66,,381,243672
2014-10-14-ccc_help_script,2014/10/14,ccc_help_script,6,6,0:00:06,6,,0,36
2014-10-14-ccc_priority_script,2014/10/14,ccc_priority_script,41,40,0:00:14,14,,1,560
2014-10-14-ccc_tax_script,2014/10/14,ccc_tax_script,9,8,0:02:30,150,,1,1200
2014-10-15-ccc_311_calgary_combined,2014/10/15,ccc_311_calgary_combined,3576,3285,0:00:58,58,,291,190530
2014-10-15-ccc_help_script,2014/10/15,ccc_help_script,4,3,0:00:14,14,,1,42
2014-10-15-ccc_priority_script,2014/10/15,ccc_priority_script,21,20,0:00:11,11,,1,220
2014-10-15-ccc_tax_script,2014/10/15,ccc_tax_script,20,18,0:01:24,84,,2,1512
2014-10-16-ccc_311_calgary_combined,2014/10/16,ccc_311_calgary_combined,3394,3150,0:00:45,45,,244,141750
2014-10-16-ccc_help_script,2014/10/16,ccc_help_script,3,3,0:00:11,11,,0,33
2014-10-16-ccc_priority_script,2014/10/16,ccc_priority_script,32,32,0:00:09,9,,0,288
2014-10-16-ccc_tax_script,2014/10/16,ccc_tax_script,13,12,0:01:31,91,,1,1092
2014-10-17-ccc_311_calgary_combined,2014/10/17,ccc_311_calgary_combined,3386,3175,0:00:48,48,,211,152400
2014-10-17-ccc_help_script,2014/10/17,ccc_help_script,2,2,0:00:17,17,,0,34
2014-10-17-ccc_priority_script,2014/10/17,ccc_priority_script,21,21,0:00:08,8,,0,168
2014-10-17-ccc_tax_script,2014/10/17,ccc_tax_script,10,10,0:01:35,95,,0,950
2014-10-18-ccc_311_calgary_combined,2014/10/18,ccc_311_calgary_combined,1415,1128,0:01:52,112,,287,126336
2014-10-18-ccc_help_script,2014/10/18,ccc_help_script,1,1,0:00:12,12,,0,12
2014-10-18-ccc_priority_script,2014/10/18,ccc_priority_script,31,30,0:00:29,29,,1,870
2014-10-19-ccc_311_calgary_combined,2014/10/19,ccc_311_calgary_combined,941,836,0:00:56,56,,105,46816
2014-10-19-ccc_help_script,2014/10/19,ccc_help_script,1,1,0:00:13,13,,0,13
2014-10-19-ccc_priority_script,2014/10/19,ccc_priority_script,34,28,0:00:26,26,,6,728
2014-10-20-ccc_311_calgary_combined,2014/10/20,ccc_311_calgary_combined,3987,3289,0:02:51,171,,698,562419
2014-10-20-ccc_help_script,2014/10/20,ccc_help_script,4,4,0:00:11,11,,0,44
2014-10-20-ccc_priority_script,2014/10/20,ccc_priority_script,24,24,0:00:10,10,,0,240
2014-10-20-ccc_tax_script,2014/10/20,ccc_tax_script,14,9,0:03:57,237,,5,2133
2014-10-21-ccc_311_calgary_combined,2014/10/21,ccc_311_calgary_combined,3777,2976,0:03:22,202,,801,601152
2014-10-21-ccc_help_script,2014/10/21,ccc_help_script,4,4,0:00:15,15,,0,60
2014-10-21-ccc_priority_script,2014/10/21,ccc_priority_script,38,38,0:00:13,13,,0,494
2014-10-21-ccc_tax_script,2014/10/21,ccc_tax_script,18,11,0:06:54,414,,7,4554
2014-10-22-ccc_311_calgary_combined,2014/10/22,ccc_311_calgary_combined,3420,2708,0:03:25,205,,712,555140
2014-10-22-ccc_help_script,2014/10/22,ccc_help_script,3,3,0:00:12,12,,0,36
2014-10-22-ccc_priority_script,2014/10/22,ccc_priority_script,26,23,0:00:16,16,,3,368
2014-10-22-ccc_tax_script,2014/10/22,ccc_tax_script,14,11,0:02:54,174,,3,1914
2014-10-23-ccc_311_calgary_combined,2014/10/23,ccc_311_calgary_combined,3634,2846,0:03:23,203,,788,577738
2014-10-23-ccc_help_script,2014/10/23,ccc_help_script,6,6,0:00:26,26,,0,156
2014-10-23-ccc_priority_script,2014/10/23,ccc_priority_script,40,38,0:00:17,17,,2,646
2014-10-23-ccc_tax_script,2014/10/23,ccc_tax_script,15,12,0:04:26,266,,3,3192
2014-10-24-ccc_311_calgary_combined,2014/10/24,ccc_311_calgary_combined,3459,3019,0:01:49,109,,440,329071
2014-10-24-ccc_help_script,2014/10/24,ccc_help_script,3,3,0:00:13,13,,0,39
2014-10-24-ccc_priority_script,2014/10/24,ccc_priority_script,39,38,0:00:15,15,,1,570
2014-10-24-ccc_tax_script,2014/10/24,ccc_tax_script,16,9,0:01:52,112,,7,1008
2014-10-25-ccc_311_calgary_combined,2014/10/25,ccc_311_calgary_combined,1376,1152,0:02:02,122,,224,140544
2014-10-25-ccc_priority_script,2014/10/25,ccc_priority_script,31,30,0:00:15,15,,1,450
2014-10-26-ccc_311_calgary_combined,2014/10/26,ccc_311_calgary_combined,1148,1122,0:00:13,13,,26,14586
2014-10-26-ccc_priority_script,2014/10/26,ccc_priority_script,16,16,0:00:15,15,,0,240
2014-10-26-ccc_tax_script,2014/10/26,ccc_tax_script,1,1,0:00:09,9,,0,9
2014-10-27-ccc_311_calgary_combined,2014/10/27,ccc_311_calgary_combined,3821,3448,0:01:32,92,,373,317216
2014-10-27-ccc_help_script,2014/10/27,ccc_help_script,1,1,0:00:09,9,,0,9
2014-10-27-ccc_priority_script,2014/10/27,ccc_priority_script,18,17,0:00:09,9,,1,153
2014-10-27-ccc_tax_script,2014/10/27,ccc_tax_script,26,23,0:02:27,147,,3,3381
2014-10-28-ccc_311_calgary_combined,2014/10/28,ccc_311_calgary_combined,3638,2637,0:05:06,306,,1001,806922
2014-10-28-ccc_help_script,2014/10/28,ccc_help_script,5,5,0:00:13,13,,0,65
2014-10-28-ccc_priority_script,2014/10/28,ccc_priority_script,24,23,0:00:11,11,,1,253
2014-10-28-ccc_tax_script,2014/10/28,ccc_tax_script,26,18,0:03:36,216,,8,3888
2014-10-29-ccc_311_calgary_combined,2014/10/29,ccc_311_calgary_combined,3395,2782,0:03:01,181,,613,503542
2014-10-29-ccc_help_script,2014/10/29,ccc_help_script,1,1,0:00:05,5,,0,5
2014-10-29-ccc_priority_script,2014/10/29,ccc_priority_script,36,34,0:00:16,16,,2,544
2014-10-29-ccc_tax_script,2014/10/29,ccc_tax_script,13,8,0:04:45,285,,5,2280
2014-10-30-ccc_311_calgary_combined,2014/10/30,ccc_311_calgary_combined,3001,2567,0:00:29,29,,434,74443
2014-10-30-ccc_help_script,2014/10/30,ccc_help_script,3,3,0:00:05,5,,0,15
2014-10-30-ccc_priority_script,2014/10/30,ccc_priority_script,28,27,0:00:13,13,,1,351
2014-10-30-ccc_tax_script,2014/10/30,ccc_tax_script,15,10,0:00:26,26,,5,260
2014-10-31-ccc_311_calgary_combined,2014/10/31,ccc_311_calgary_combined,2894,2610,0:01:26,86,,284,224460
2014-10-31-ccc_help_script,2014/10/31,ccc_help_script,3,3,0:00:06,6,,0,18
2014-10-31-ccc_priority_script,2014/10/31,ccc_priority_script,30,27,0:00:11,11,,3,297
2014-10-31-ccc_tax_script,2014/10/31,ccc_tax_script,19,16,0:01:00,60,,3,960
2014-11-01-ccc_311_calgary_combined,2014/11/01,ccc_311_calgary_combined,1114,1036,0:00:37,37,,78,38332
2014-11-01-ccc_priority_script,2014/11/01,ccc_priority_script,21,21,0:00:07,7,,0,147
2014-11-02-ccc_311_calgary_combined,2014/11/02,ccc_311_calgary_combined,1098,1052,0:00:25,25,,46,26300
2014-11-02-ccc_priority_script,2014/11/02,ccc_priority_script,51,49,0:00:16,16,,2,784
2014-11-03-ccc_311_calgary_combined,2014/11/03,ccc_311_calgary_combined,3609,3465,0:00:29,29,,144,100485
2014-11-03-ccc_priority_script,2014/11/03,ccc_priority_script,28,27,0:00:13,13,,1,351
2014-11-03-ccc_tax_script,2014/11/03,ccc_tax_script,20,20,0:00:26,26,,0,520
2014-11-04-ccc_311_calgary_combined,2014/11/04,ccc_311_calgary_combined,3620,3113,0:02:00,120,,507,373560
2014-11-04-ccc_help_script,2014/11/04,ccc_help_script,4,4,0:00:12,12,,0,48
2014-11-04-ccc_priority_script,2014/11/04,ccc_priority_script,28,28,0:00:13,13,,0,364
2014-11-04-ccc_tax_script,2014/11/04,ccc_tax_script,16,13,0:02:28,148,,3,1924
2014-11-05-ccc_311_calgary_combined,2014/11/05,ccc_311_calgary_combined,3550,2715,0:03:54,234,,835,635310
2014-11-05-ccc_help_script,2014/11/05,ccc_help_script,10,10,0:00:16,16,,0,160
2014-11-05-ccc_priority_script,2014/11/05,ccc_priority_script,31,29,0:00:21,21,,2,609
2014-11-05-ccc_tax_script,2014/11/05,ccc_tax_script,20,11,0:03:44,224,,9,2464
2014-11-06-ccc_311_calgary_combined,2014/11/06,ccc_311_calgary_combined,3370,2826,0:02:32,152,,544,429552
2014-11-06-ccc_help_script,2014/11/06,ccc_help_script,6,6,0:00:04,4,,0,24
2014-11-06-ccc_priority_script,2014/11/06,ccc_priority_script,33,31,0:00:13,13,,2,403
2014-11-06-ccc_tax_script,2014/11/06,ccc_tax_script,19,12,0:02:33,153,,7,1836
2014-11-07-ccc_311_calgary_combined,2014/11/07,ccc_311_calgary_combined,3132,2630,0:02:37,157,,502,412910
2014-11-07-ccc_help_script,2014/11/07,ccc_help_script,8,7,0:00:07,7,,1,49
2014-11-07-ccc_priority_script,2014/11/07,ccc_priority_script,19,18,0:00:15,15,,1,270
2014-11-07-ccc_tax_script,2014/11/07,ccc_tax_script,16,15,0:02:13,133,,1,1995
2014-11-08-ccc_311_calgary_combined,2014/11/08,ccc_311_calgary_combined,1260,1224,0:00:19,19,,36,23256
2014-11-08-ccc_help_script,2014/11/08,ccc_help_script,2,2,0:00:13,13,,0,26
2014-11-08-ccc_priority_script,2014/11/08,ccc_priority_script,23,23,0:00:06,6,,0,138
2014-11-09-ccc_311_calgary_combined,2014/11/09,ccc_311_calgary_combined,1020,994,0:00:12,12,,26,11928
2014-11-09-ccc_help_script,2014/11/09,ccc_help_script,4,4,0:00:39,39,,0,156
2014-11-09-ccc_priority_script,2014/11/09,ccc_priority_script,50,49,0:00:08,8,,1,392
2014-11-09-ccc_tax_script,2014/11/09,ccc_tax_script,1,1,0:00:06,6,,0,6
2014-11-10-ccc_311_calgary_combined,2014/11/10,ccc_311_calgary_combined,3459,3409,0:00:11,11,,50,37499
2014-11-10-ccc_help_script,2014/11/10,ccc_help_script,10,10,0:00:06,6,,0,60
2014-11-10-ccc_priority_script,2014/11/10,ccc_priority_script,44,41,0:00:07,7,,3,287
2014-11-10-ccc_tax_script,2014/11/10,ccc_tax_script,17,17,0:00:16,16,,0,272
2014-11-11-ccc_311_calgary_combined,2014/11/11,ccc_311_calgary_combined,1685,1653,0:00:11,11,,32,18183
2014-11-11-ccc_help_script,2014/11/11,ccc_help_script,4,4,0:00:06,6,,0,24
2014-11-11-ccc_priority_script,2014/11/11,ccc_priority_script,33,30,0:00:08,8,,3,240
2014-11-11-ccc_tax_script,2014/11/11,ccc_tax_script,7,6,0:00:06,6,,1,36
2014-11-12-ccc_311_calgary_combined,2014/11/12,ccc_311_calgary_combined,3222,2739,0:02:07,127,,483,347853
2014-11-12-ccc_help_script,2014/11/12,ccc_help_script,7,6,0:00:21,21,,1,126
2014-11-12-ccc_priority_script,2014/11/12,ccc_priority_script,29,27,0:00:13,13,,2,351
2014-11-12-ccc_tax_script,2014/11/12,ccc_tax_script,27,23,0:02:31,151,,4,3473
2014-11-13-ccc_311_calgary_combined,2014/11/13,ccc_311_calgary_combined,3115,2376,0:04:30,270,,739,641520
2014-11-13-ccc_help_script,2014/11/13,ccc_help_script,7,7,0:00:11,11,,0,77
2014-11-13-ccc_priority_script,2014/11/13,ccc_priority_script,44,41,0:00:18,18,,3,738
2014-11-13-ccc_tax_script,2014/11/13,ccc_tax_script,20,15,0:06:22,382,,5,5730
2014-11-14-ccc_311_calgary_combined,2014/11/14,ccc_311_calgary_combined,2965,2557,0:02:10,130,,408,332410
2014-11-14-ccc_help_script,2014/11/14,ccc_help_script,5,5,0:00:12,12,,0,60
2014-11-14-ccc_priority_script,2014/11/14,ccc_priority_script,39,39,0:00:11,11,,0,429
2014-11-14-ccc_tax_script,2014/11/14,ccc_tax_script,9,7,0:03:05,185,,2,1295
2014-11-15-ccc_311_calgary_combined,2014/11/15,ccc_311_calgary_combined,1028,1001,0:00:19,19,,27,19019
2014-11-15-ccc_help_script,2014/11/15,ccc_help_script,1,1,0:00:05,5,,0,5
2014-11-15-ccc_priority_script,2014/11/15,ccc_priority_script,18,17,0:00:06,6,,1,102
2014-11-15-ccc_tax_script,2014/11/15,ccc_tax_script,1,1,0:00:06,6,,0,6
2014-11-16-ccc_311_calgary_combined,2014/11/16,ccc_311_calgary_combined,870,856,0:00:11,11,,14,9416
2014-11-16-ccc_priority_script,2014/11/16,ccc_priority_script,25,24,0:00:11,11,,1,264
2014-11-16-ccc_tax_script,2014/11/16,ccc_tax_script,1,1,0:00:03,3,,0,3
2014-11-17-ccc_311_calgary_combined,2014/11/17,ccc_311_calgary_combined,3329,3281,0:00:08,8,,48,26248
2014-11-17-ccc_help_script,2014/11/17,ccc_help_script,1,1,0:00:04,4,,0,4
2014-11-17-ccc_priority_script,2014/11/17,ccc_priority_script,25,25,0:00:11,11,,0,275
2014-11-17-ccc_tax_script,2014/11/17,ccc_tax_script,20,20,0:00:12,12,,0,240
2014-11-18-ccc_311_calgary_combined,2014/11/18,ccc_311_calgary_combined,3071,2840,0:01:04,64,,231,181760
2014-11-18-ccc_help_script,2014/11/18,ccc_help_script,5,5,0:00:17,17,,0,85
2014-11-18-ccc_priority_script,2014/11/18,ccc_priority_script,33,30,0:00:09,9,,3,270
2014-11-18-ccc_tax_script,2014/11/18,ccc_tax_script,22,21,0:02:21,141,,1,2961
2014-11-19-ccc_311_calgary_combined,2014/11/19,ccc_311_calgary_combined,3016,2620,0:01:56,116,,396,303920
2014-11-19-ccc_help_script,2014/11/19,ccc_help_script,9,9,0:00:19,19,,0,171
2014-11-19-ccc_priority_script,2014/11/19,ccc_priority_script,19,18,0:00:13,13,,1,234
2014-11-19-ccc_tax_script,2014/11/19,ccc_tax_script,28,23,0:03:09,189,,5,4347
2014-11-20-ccc_311_calgary_combined,2014/11/20,ccc_311_calgary_combined,3339,2723,0:03:05,185,,616,503755
2014-11-20-ccc_help_script,2014/11/20,ccc_help_script,10,10,0:00:16,16,,0,160
2014-11-20-ccc_priority_script,2014/11/20,ccc_priority_script,41,39,0:00:11,11,,2,429
2014-11-20-ccc_tax_script,2014/11/20,ccc_tax_script,24,19,0:04:08,248,,5,4712
2014-11-21-ccc_311_calgary_combined,2014/11/21,ccc_311_calgary_combined,3280,2574,0:04:12,252,,706,648648
2014-11-21-ccc_help_script,2014/11/21,ccc_help_script,6,5,0:00:15,15,,1,75
2014-11-21-ccc_priority_script,2014/11/21,ccc_priority_script,20,20,0:00:13,13,,0,260
2014-11-21-ccc_tax_script,2014/11/21,ccc_tax_script,18,12,0:05:43,343,,6,4116
2014-11-22-ccc_311_calgary_combined,2014/11/22,ccc_311_calgary_combined,1066,1005,0:00:41,41,,61,41205
2014-11-22-ccc_help_script,2014/11/22,ccc_help_script,1,1,0:00:05,5,,0,5
2014-11-22-ccc_priority_script,2014/11/22,ccc_priority_script,9,8,0:00:06,6,,1,48
2014-11-23-ccc_311_calgary_combined,2014/11/23,ccc_311_calgary_combined,763,752,0:00:09,9,,11,6768
2014-11-23-ccc_help_script,2014/11/23,ccc_help_script,1,1,0:00:04,4,,0,4
2014-11-23-ccc_priority_script,2014/11/23,ccc_priority_script,14,14,0:00:05,5,,0,70
2014-11-23-ccc_tax_script,2014/11/23,ccc_tax_script,1,1,0:00:07,7,,0,7
2014-11-24-ccc_311_calgary_combined,2014/11/24,ccc_311_calgary_combined,3314,3183,0:00:37,37,,131,117771
2014-11-24-ccc_help_script,2014/11/24,ccc_help_script,5,5,0:00:08,8,,0,40
2014-11-24-ccc_priority_script,2014/11/24,ccc_priority_script,30,28,0:00:12,12,,2,336
2014-11-24-ccc_tax_script,2014/11/24,ccc_tax_script,19,17,0:00:43,43,,2,731
2014-11-25-ccc_311_calgary_combined,2014/11/25,ccc_311_calgary_combined,3069,2711,0:01:50,110,,358,298210
2014-11-25-ccc_help_script,2014/11/25,ccc_help_script,8,8,0:00:19,19,,0,152
2014-11-25-ccc_priority_script,2014/11/25,ccc_priority_script,27,27,0:00:15,15,,0,405
2014-11-25-ccc_tax_script,2014/11/25,ccc_tax_script,15,11,0:02:32,152,,4,1672
2014-11-26-ccc_311_calgary_combined,2014/11/26,ccc_311_calgary_combined,3304,2551,0:04:14,254,,753,647954
2014-11-26-ccc_help_script,2014/11/26,ccc_help_script,7,7,0:00:14,14,,0,98
2014-11-26-ccc_priority_script,2014/11/26,ccc_priority_script,21,21,0:00:20,20,,0,420
2014-11-26-ccc_tax_script,2014/11/26,ccc_tax_script,16,11,0:04:47,287,,5,3157
2014-11-27-ccc_311_calgary_combined,2014/11/27,ccc_311_calgary_combined,3405,2498,0:05:40,340,,907,849320
2014-11-27-ccc_help_script,2014/11/27,ccc_help_script,9,9,0:00:11,11,,0,99
2014-11-27-ccc_priority_script,2014/11/27,ccc_priority_script,33,32,0:00:16,16,,1,512
2014-11-27-ccc_tax_script,2014/11/27,ccc_tax_script,16,8,0:05:49,349,,8,2792
2014-11-28-ccc_311_calgary_combined,2014/11/28,ccc_311_calgary_combined,2990,2607,0:01:50,110,,383,286770
2014-11-28-ccc_help_script,2014/11/28,ccc_help_script,5,5,0:00:13,13,,0,65
2014-11-28-ccc_priority_script,2014/11/28,ccc_priority_script,58,58,0:00:12,12,,0,696
2014-11-28-ccc_tax_script,2014/11/28,ccc_tax_script,16,14,0:02:27,147,,2,2058
2014-11-29-ccc_311_calgary_combined,2014/11/29,ccc_311_calgary_combined,1443,1376,0:00:24,24,,67,33024
2014-11-29-ccc_help_script,2014/11/29,ccc_help_script,1,1,0:00:07,7,,0,7
2014-11-29-ccc_priority_script,2014/11/29,ccc_priority_script,55,52,0:00:12,12,,3,624
2014-11-29-ccc_tax_script,2014/11/29,ccc_tax_script,1,1,0:00:17,17,,0,17
2014-11-30-ccc_311_calgary_combined,2014/11/30,ccc_311_calgary_combined,875,854,0:00:21,21,,21,17934
2014-11-30-ccc_priority_script,2014/11/30,ccc_priority_script,24,22,0:0:0,0,,2,0
2014-12-01-ccc_311_calgary_combined,2014/12/01,ccc_311_calgary_combined,3354,2945,0:01:58,118,,409,347510
2014-12-01-ccc_help_script,2014/12/01,ccc_help_script,4,4,0:00:29,29,,0,116
2014-12-01-ccc_priority_script,2014/12/01,ccc_priority_script,26,26,0:00:19,19,,0,494
2014-12-01-ccc_tax_script,2014/12/01,ccc_tax_script,11,7,0:05:29,329,,4,2303
2014-12-02-ccc_311_calgary_combined,2014/12/02,ccc_311_calgary_combined,3484,2887,0:02:48,168,,597,485016
2014-12-02-ccc_help_script,2014/12/02,ccc_help_script,1,1,0:00:14,14,,0,14
2014-12-02-ccc_priority_script,2014/12/02,ccc_priority_script,30,27,0:00:15,15,,3,405
2014-12-02-ccc_tax_script,2014/12/02,ccc_tax_script,23,17,0:02:55,175,,6,2975
2014-12-03-ccc_311_calgary_combined,2014/12/03,ccc_311_calgary_combined,3165,2748,0:02:28,148,,417,406704
2014-12-03-ccc_help_script,2014/12/03,ccc_help_script,4,4,0:00:07,7,,0,28
2014-12-03-ccc_priority_script,2014/12/03,ccc_priority_script,42,36,0:00:11,11,,6,396
2014-12-03-ccc_tax_script,2014/12/03,ccc_tax_script,17,14,0:03:21,201,,3,2814
2014-12-04-ccc_311_calgary_combined,2014/12/04,ccc_311_calgary_combined,3016,2704,0:01:35,95,,312,256880
2014-12-04-ccc_help_script,2014/12/04,ccc_help_script,8,8,0:00:14,14,,0,112
2014-12-04-ccc_priority_script,2014/12/04,ccc_priority_script,25,25,0:00:17,17,,0,425
2014-12-04-ccc_tax_script,2014/12/04,ccc_tax_script,24,21,0:01:45,105,,3,2205
2014-12-05-ccc_311_calgary_combined,2014/12/05,ccc_311_calgary_combined,2651,2375,0:01:35,95,,276,225625
2014-12-05-ccc_help_script,2014/12/05,ccc_help_script,4,4,0:00:04,4,,0,16
2014-12-05-ccc_priority_script,2014/12/05,ccc_priority_script,33,32,0:00:09,9,,1,288
2014-12-05-ccc_tax_script,2014/12/05,ccc_tax_script,10,10,0:00:41,41,,0,410
2014-12-06-ccc_311_calgary_combined,2014/12/06,ccc_311_calgary_combined,999,982,0:00:18,18,,17,17676
2014-12-06-ccc_priority_script,2014/12/06,ccc_priority_script,30,30,0:00:11,11,,0,330
2014-12-07-ccc_311_calgary_combined,2014/12/07,ccc_311_calgary_combined,800,791,0:00:08,8,,9,6328
2014-12-07-ccc_help_script,2014/12/07,ccc_help_script,1,1,0:00:05,5,,0,5
2014-12-07-ccc_priority_script,2014/12/07,ccc_priority_script,29,26,0:00:07,7,,3,182
2014-12-08-ccc_311_calgary_combined,2014/12/08,ccc_311_calgary_combined,3022,2964,0:00:15,15,,58,44460
2014-12-08-ccc_help_script,2014/12/08,ccc_help_script,4,4,0:00:08,8,,0,32
2014-12-08-ccc_priority_script,2014/12/08,ccc_priority_script,25,24,0:00:06,6,,1,144
2014-12-08-ccc_tax_script,2014/12/08,ccc_tax_script,12,12,0:00:12,12,,0,144
2014-12-09-ccc_311_calgary_combined,2014/12/09,ccc_311_calgary_combined,3017,2740,0:01:23,83,,277,227420
2014-12-09-ccc_help_script,2014/12/09,ccc_help_script,7,6,0:00:10,10,,1,60
2014-12-09-ccc_priority_script,2014/12/09,ccc_priority_script,32,29,0:00:16,16,,3,464
2014-12-09-ccc_tax_script,2014/12/09,ccc_tax_script,10,8,0:02:13,133,,2,1064
2014-12-10-ccc_311_calgary_combined,2014/12/10,ccc_311_calgary_combined,2802,2577,0:01:08,68,,225,175236
2014-12-10-ccc_help_script,2014/12/10,ccc_help_script,4,4,0:00:06,6,,0,24
2014-12-10-ccc_priority_script,2014/12/10,ccc_priority_script,21,19,0:00:17,17,,2,323
2014-12-10-ccc_tax_script,2014/12/10,ccc_tax_script,16,12,0:01:20,80,,4,960
2014-12-11-ccc_311_calgary_combined,2014/12/11,ccc_311_calgary_combined,3163,2788,0:02:03,123,,375,342924
2014-12-11-ccc_help_script,2014/12/11,ccc_help_script,4,4,0:00:16,16,,0,64
2014-12-11-ccc_priority_script,2014/12/11,ccc_priority_script,29,27,0:00:17,17,,2,459
2014-12-11-ccc_tax_script,2014/12/11,ccc_tax_script,17,15,0:02:31,151,,2,2265
2014-12-12-ccc_311_calgary_combined,2014/12/12,ccc_311_calgary_combined,2961,2619,0:02:03,123,,342,322137
2014-12-12-ccc_help_script,2014/12/12,ccc_help_script,10,10,0:00:09,9,,0,90
2014-12-12-ccc_priority_script,2014/12/12,ccc_priority_script,29,27,0:00:12,12,,2,324
2014-12-12-ccc_tax_script,2014/12/12,ccc_tax_script,29,25,0:01:48,108,,4,2700
2014-12-13-ccc_311_calgary_combined,2014/12/13,ccc_311_calgary_combined,1014,973,0:00:27,27,,41,26271
2014-12-13-ccc_priority_script,2014/12/13,ccc_priority_script,21,20,0:00:06,6,,1,120
2014-12-14-ccc_311_calgary_combined,2014/12/14,ccc_311_calgary_combined,882,868,0:00:17,17,,14,14756
2014-12-14-ccc_help_script,2014/12/14,ccc_help_script,1,1,0:00:06,6,,0,6
2014-12-14-ccc_priority_script,2014/12/14,ccc_priority_script,21,21,0:00:05,5,,0,105
2014-12-15-ccc_311_calgary_combined,2014/12/15,ccc_311_calgary_combined,3241,3132,0:00:32,32,,109,100224
2014-12-15-ccc_help_script,2014/12/15,ccc_help_script,6,6,0:00:12,12,,0,72
2014-12-15-ccc_priority_script,2014/12/15,ccc_priority_script,21,21,0:00:10,10,,0,210
2014-12-15-ccc_tax_script,2014/12/15,ccc_tax_script,9,9,0:00:12,12,,0,108
2014-12-16-ccc_311_calgary_combined,2014/12/16,ccc_311_calgary_combined,3026,2887,0:00:42,42,,139,121254
2014-12-16-ccc_help_script,2014/12/16,ccc_help_script,9,6,0:00:05,5,,3,30
2014-12-16-ccc_priority_script,2014/12/16,ccc_priority_script,29,26,0:00:19,19,,3,494
2014-12-16-ccc_tax_script,2014/12/16,ccc_tax_script,16,12,0:00:19,19,,4,228
2014-12-17-ccc_311_calgary_combined,2014/12/17,ccc_311_calgary_combined,2781,2604,0:00:57,57,,177,148428
2014-12-17-ccc_help_script,2014/12/17,ccc_help_script,5,5,0:00:25,25,,0,125
2014-12-17-ccc_priority_script,2014/12/17,ccc_priority_script,30,29,0:00:16,16,,1,464
2014-12-17-ccc_tax_script,2014/12/17,ccc_tax_script,20,18,0:01:10,70,,2,1260
2014-12-18-ccc_311_calgary_combined,2014/12/18,ccc_311_calgary_combined,2818,2562,0:01:19,79,,256,202398
2014-12-18-ccc_help_script,2014/12/18,ccc_help_script,4,3,0:00:16,16,,1,48
2014-12-18-ccc_priority_script,2014/12/18,ccc_priority_script,26,26,0:00:16,16,,0,416
2014-12-18-ccc_tax_script,2014/12/18,ccc_tax_script,17,17,0:01:20,80,,0,1360
2014-12-19-ccc_311_calgary_combined,2014/12/19,ccc_311_calgary_combined,2490,2368,0:00:43,43,,122,101824
2014-12-19-ccc_help_script,2014/12/19,ccc_help_script,2,2,0:00:08,8,,0,16
2014-12-19-ccc_priority_script,2014/12/19,ccc_priority_script,27,27,0:00:13,13,,0,351
2014-12-19-ccc_tax_script,2014/12/19,ccc_tax_script,18,16,0:00:26,26,,2,416
2014-12-20-ccc_311_calgary_combined,2014/12/20,ccc_311_calgary_combined,1005,988,0:00:11,11,,17,10868
2014-12-20-ccc_priority_script,2014/12/20,ccc_priority_script,14,14,0:00:07,7,,0,98
2014-12-20-ccc_tax_script,2014/12/20,ccc_tax_script,1,1,0:00:06,6,,0,6
2014-12-21-ccc_311_calgary_combined,2014/12/21,ccc_311_calgary_combined,857,840,0:00:17,17,,17,14280
2014-12-21-ccc_priority_script,2014/12/21,ccc_priority_script,11,10,0:00:06,6,,1,60
2014-12-21-ccc_tax_script,2014/12/21,ccc_tax_script,2,2,0:00:04,4,,0,8
2014-12-22-ccc_311_calgary_combined,2014/12/22,ccc_311_calgary_combined,2992,2813,0:00:55,55,,179,154715
2014-12-22-ccc_help_script,2014/12/22,ccc_help_script,6,5,0:00:04,4,,1,20
2014-12-22-ccc_priority_script,2014/12/22,ccc_priority_script,20,20,0:00:08,8,,0,160
2014-12-22-ccc_tax_script,2014/12/22,ccc_tax_script,20,17,0:01:17,77,,3,1309
2014-12-23-ccc_311_calgary_combined,2014/12/23,ccc_311_calgary_combined,2569,2430,0:00:52,52,,139,126360
2014-12-23-ccc_help_script,2014/12/23,ccc_help_script,4,3,0:00:04,4,,1,12
2014-12-23-ccc_priority_script,2014/12/23,ccc_priority_script,25,24,0:00:12,12,,1,288
2014-12-23-ccc_tax_script,2014/12/23,ccc_tax_script,10,9,0:01:20,80,,1,720
2014-12-24-ccc_311_calgary_combined,2014/12/24,ccc_311_calgary_combined,1430,1412,0:00:09,9,,18,12708
2014-12-24-ccc_help_script,2014/12/24,ccc_help_script,3,3,0:00:05,5,,0,15
2014-12-24-ccc_priority_script,2014/12/24,ccc_priority_script,32,32,0:00:06,6,,0,192
2014-12-24-ccc_tax_script,2014/12/24,ccc_tax_script,2,2,0:00:11,11,,0,22
2014-12-25-ccc_311_calgary_combined,2014/12/25,ccc_311_calgary_combined,294,290,0:00:07,7,,4,2030
2014-12-25-ccc_help_script,2014/12/25,ccc_help_script,1,1,0:00:03,3,,0,3
2014-12-25-ccc_priority_script,2014/12/25,ccc_priority_script,14,14,0:00:10,10,,0,140
2014-12-26-ccc_311_calgary_combined,2014/12/26,ccc_311_calgary_combined,797,786,0:00:08,8,,11,6288
2014-12-26-ccc_priority_script,2014/12/26,ccc_priority_script,10,10,0:00:06,6,,0,60
2014-12-27-ccc_311_calgary_combined,2014/12/27,ccc_311_calgary_combined,965,948,0:00:10,10,,17,9480
2014-12-27-ccc_help_script,2014/12/27,ccc_help_script,1,1,0:00:05,5,,0,5
2014-12-27-ccc_priority_script,2014/12/27,ccc_priority_script,13,13,0:00:07,7,,0,91
2014-12-27-ccc_tax_script,2014/12/27,ccc_tax_script,1,1,0:00:04,4,,0,4
2014-12-28-ccc_311_calgary_combined,2014/12/28,ccc_311_calgary_combined,658,655,0:00:07,7,,3,4585
2014-12-28-ccc_help_script,2014/12/28,ccc_help_script,2,2,0:00:07,7,,0,14
2014-12-28-ccc_priority_script,2014/12/28,ccc_priority_script,11,11,0:00:06,6,,0,66
2014-12-29-ccc_311_calgary_combined,2014/12/29,ccc_311_calgary_combined,2550,2480,0:00:22,22,,70,54560
2014-12-29-ccc_help_script,2014/12/29,ccc_help_script,3,3,0:00:06,6,,0,18
2014-12-29-ccc_priority_script,2014/12/29,ccc_priority_script,44,44,0:00:06,6,,0,264
2014-12-29-ccc_tax_script,2014/12/29,ccc_tax_script,1,1,0:00:03,3,,0,3
2014-12-30-ccc_311_calgary_combined,2014/12/30,ccc_311_calgary_combined,2541,2378,0:00:56,56,,163,133168
2014-12-30-ccc_help_script,2014/12/30,ccc_help_script,6,6,0:00:09,9,,0,54
2014-12-30-ccc_priority_script,2014/12/30,ccc_priority_script,23,22,0:00:11,11,,1,242
2014-12-31-ccc_311_calgary_combined,2014/12/31,ccc_311_calgary_combined,2034,2005,0:00:11,11,,29,22055
2014-12-31-ccc_help_script,2014/12/31,ccc_help_script,4,4,0:00:11,11,,0,44
2014-12-31-ccc_priority_script,2014/12/31,ccc_priority_script,20,20,0:00:07,7,,0,140
2015-01-01-ccc_311_calgary_combined,2015/01/01,ccc_311_calgary_combined,672,669,0:00:07,7,,3,4683
2015-01-01-ccc_priority_script,2015/01/01,ccc_priority_script,11,11,0:00:06,6,,0,66
2015-01-02-ccc_311_calgary_combined,2015/01/02,ccc_311_calgary_combined,2194,2153,0:00:12,12,,41,25836
2015-01-02-ccc_help_script,2015/01/02,ccc_help_script,3,3,0:00:06,6,,0,18
2015-01-02-ccc_priority_script,2015/01/02,ccc_priority_script,26,26,0:00:14,14,,0,364
2015-01-02-ccc_tax_script,2015/01/02,ccc_tax_script,11,11,0:00:06,6,,0,66
2015-01-03-ccc_311_calgary_combined,2015/01/03,ccc_311_calgary_combined,963,947,0:00:10,10,,16,9470
2015-01-03-ccc_help_script,2015/01/03,ccc_help_script,1,1,0:00:11,11,,0,11
2015-01-03-ccc_priority_script,2015/01/03,ccc_priority_script,48,47,0:00:07,7,,1,329
2015-01-04-ccc_311_calgary_combined,2015/01/04,ccc_311_calgary_combined,851,839,0:00:09,9,,12,7551
2015-01-04-ccc_priority_script,2015/01/04,ccc_priority_script,27,27,0:00:08,8,,0,216
2015-01-05-ccc_311_calgary_combined,2015/01/05,ccc_311_calgary_combined,3233,3157,0:00:17,17,,76,53669
2015-01-05-ccc_help_script,2015/01/05,ccc_help_script,7,7,0:00:13,13,,0,91
2015-01-05-ccc_priority_script,2015/01/05,ccc_priority_script,24,24,0:00:10,10,,0,240
2015-01-05-ccc_tax_script,2015/01/05,ccc_tax_script,20,18,0:00:16,16,,2,288
2015-01-06-ccc_311_calgary_combined,2015/01/06,ccc_311_calgary_combined,3378,3052,0:01:12,72,,326,219744
2015-01-06-ccc_help_script,2015/01/06,ccc_help_script,6,5,0:00:07,7,,1,35
2015-01-06-ccc_priority_script,2015/01/06,ccc_priority_script,33,32,0:00:11,11,,1,352
2015-01-06-ccc_tax_script,2015/01/06,ccc_tax_script,19,19,0:01:06,66,,0,1254
2015-01-07-ccc_311_calgary_combined,2015/01/07,ccc_311_calgary_combined,3954,3190,0:02:47,167,,764,532730
2015-01-07-ccc_help_script,2015/01/07,ccc_help_script,6,6,0:00:10,10,,0,60
2015-01-07-ccc_priority_script,2015/01/07,ccc_priority_script,45,45,0:00:15,15,,0,675
2015-01-07-ccc_tax_script,2015/01/07,ccc_tax_script,15,15,0:02:59,179,,0,2685
2015-01-08-ccc_311_calgary_combined,2015/01/08,ccc_311_calgary_combined,3455,2861,0:02:38,158,,594,452038
2015-01-08-ccc_help_script,2015/01/08,ccc_help_script,5,3,0:00:06,6,,2,18
2015-01-08-ccc_priority_script,2015/01/08,ccc_priority_script,34,28,0:00:16,16,,6,448
2015-01-08-ccc_tax_script,2015/01/08,ccc_tax_script,19,16,0:02:05,125,,3,2000
2015-01-09-ccc_311_calgary_combined,2015/01/09,ccc_311_calgary_combined,3110,2792,0:01:22,82,,318,228944
2015-01-09-ccc_help_script,2015/01/09,ccc_help_script,3,2,0:00:09,9,,1,18
2015-01-09-ccc_priority_script,2015/01/09,ccc_priority_script,22,22,0:00:15,15,,0,330
2015-01-09-ccc_tax_script,2015/01/09,ccc_tax_script,21,19,0:02:17,137,,2,2603
2015-01-10-ccc_311_calgary_combined,2015/01/10,ccc_311_calgary_combined,1059,1052,0:00:07,7,,7,7364
2015-01-10-ccc_help_script,2015/01/10,ccc_help_script,1,1,0:00:05,5,,0,5
2015-01-10-ccc_priority_script,2015/01/10,ccc_priority_script,24,22,0:00:10,10,,2,220
2015-01-11-ccc_311_calgary_combined,2015/01/11,ccc_311_calgary_combined,791,782,0:00:10,10,,9,7820
2015-01-11-ccc_priority_script,2015/01/11,ccc_priority_script,27,26,0:00:07,7,,1,182
2015-01-11-ccc_tax_script,2015/01/11,ccc_tax_script,1,1,0:00:04,4,,0,4
2015-01-12-ccc_311_calgary_combined,2015/01/12,ccc_311_calgary_combined,3318,3239,0:00:21,21,,79,68019
2015-01-12-ccc_help_script,2015/01/12,ccc_help_script,3,3,0:00:05,5,,0,15
2015-01-12-ccc_priority_script,2015/01/12,ccc_priority_script,29,29,0:00:12,12,,0,348
2015-01-12-ccc_tax_script,2015/01/12,ccc_tax_script,21,21,0:00:21,21,,0,441
2015-01-13-ccc_311_calgary_combined,2015/01/13,ccc_311_calgary_combined,3178,2928,0:01:11,71,,250,207888
2015-01-13-ccc_help_script,2015/01/13,ccc_help_script,5,5,0:00:08,8,,0,40
2015-01-13-ccc_priority_script,2015/01/13,ccc_priority_script,21,20,0:00:17,17,,1,340
2015-01-13-ccc_tax_script,2015/01/13,ccc_tax_script,21,18,0:01:39,99,,3,1782
2015-01-14-ccc_311_calgary_combined,2015/01/14,ccc_311_calgary_combined,3184,2774,0:01:49,109,,410,302366
2015-01-14-ccc_help_script,2015/01/14,ccc_help_script,1,1,0:00:08,8,,0,8
2015-01-14-ccc_priority_script,2015/01/14,ccc_priority_script,24,23,0:00:13,13,,1,299
2015-01-14-ccc_tax_script,2015/01/14,ccc_tax_script,20,15,0:01:40,100,,5,1500
2015-01-15-ccc_311_calgary_combined,2015/01/15,ccc_311_calgary_combined,3216,2832,0:01:50,110,,384,311520
2015-01-15-ccc_help_script,2015/01/15,ccc_help_script,4,4,0:00:09,9,,0,36
2015-01-15-ccc_priority_script,2015/01/15,ccc_priority_script,28,26,0:00:14,14,,2,364
2015-01-15-ccc_tax_script,2015/01/15,ccc_tax_script,14,13,0:01:57,117,,1,1521
2015-01-16-ccc_311_calgary_combined,2015/01/16,ccc_311_calgary_combined,3235,2484,0:04:05,245,,751,608580
2015-01-16-ccc_help_script,2015/01/16,ccc_help_script,4,3,0:00:13,13,,1,39
2015-01-16-ccc_priority_script,2015/01/16,ccc_priority_script,25,25,0:00:15,15,,0,375
2015-01-16-ccc_tax_script,2015/01/16,ccc_tax_script,21,19,0:05:24,324,,2,6156
2015-01-17-ccc_311_calgary_combined,2015/01/17,ccc_311_calgary_combined,1263,1213,0:00:29,29,,50,35177
2015-01-17-ccc_priority_script,2015/01/17,ccc_priority_script,16,16,0:00:09,9,,0,144
2015-01-18-ccc_311_calgary_combined,2015/01/18,ccc_311_calgary_combined,913,889,0:00:16,16,,24,14224
2015-01-18-ccc_priority_script,2015/01/18,ccc_priority_script,14,12,0:00:12,12,,2,144
2015-01-18-ccc_tax_script,2015/01/18,ccc_tax_script,1,1,0:00:07,7,,0,7
2015-01-19-ccc_311_calgary_combined,2015/01/19,ccc_311_calgary_combined,3353,3297,0:00:18,18,,56,59346
2015-01-19-ccc_help_script,2015/01/19,ccc_help_script,4,4,0:00:04,4,,0,16
2015-01-19-ccc_priority_script,2015/01/19,ccc_priority_script,15,14,0:00:10,10,,1,140
2015-01-19-ccc_tax_script,2015/01/19,ccc_tax_script,17,16,0:00:30,30,,1,480
2015-01-20-ccc_311_calgary_combined,2015/01/20,ccc_311_calgary_combined,3302,3010,0:01:19,79,,292,237790
2015-01-20-ccc_help_script,2015/01/20,ccc_help_script,7,7,0:00:08,8,,0,56
2015-01-20-ccc_priority_script,2015/01/20,ccc_priority_script,26,26,0:00:15,15,,0,390
2015-01-20-ccc_tax_script,2015/01/20,ccc_tax_script,15,11,0:02:13,133,,4,1463
2015-01-21-ccc_311_calgary_combined,2015/01/21,ccc_311_calgary_combined,3021,2821,0:00:55,55,,200,155155
2015-01-21-ccc_help_script,2015/01/21,ccc_help_script,6,6,0:00:08,8,,0,48
2015-01-21-ccc_priority_script,2015/01/21,ccc_priority_script,23,20,0:00:07,7,,3,140
2015-01-21-ccc_tax_script,2015/01/21,ccc_tax_script,13,13,0:00:28,28,,0,364
2015-01-22-ccc_311_calgary_combined,2015/01/22,ccc_311_calgary_combined,3108,2932,0:00:51,51,,176,149532
2015-01-22-ccc_help_script,2015/01/22,ccc_help_script,7,6,0:00:20,20,,1,120
2015-01-22-ccc_priority_script,2015/01/22,ccc_priority_script,28,27,0:00:09,9,,1,243
2015-01-22-ccc_tax_script,2015/01/22,ccc_tax_script,8,8,0:00:47,47,,0,376
2015-01-23-ccc_311_calgary_combined,2015/01/23,ccc_311_calgary_combined,2980,2846,0:00:31,31,,134,88226
2015-01-23-ccc_help_script,2015/01/23,ccc_help_script,2,1,0:00:02,2,,1,2
2015-01-23-ccc_priority_script,2015/01/23,ccc_priority_script,34,30,0:00:12,12,,4,360
2015-01-23-ccc_tax_script,2015/01/23,ccc_tax_script,16,15,0:00:23,23,,1,345
2015-01-24-ccc_311_calgary_combined,2015/01/24,ccc_311_calgary_combined,1275,1201,0:00:41,41,,74,49241
2015-01-24-ccc_priority_script,2015/01/24,ccc_priority_script,26,25,0:00:19,19,,1,475
2015-01-25-ccc_311_calgary_combined,2015/01/25,ccc_311_calgary_combined,996,984,0:00:10,10,,12,9840
2015-01-25-ccc_priority_script,2015/01/25,ccc_priority_script,15,15,0:00:05,5,,0,75
2015-01-26-ccc_311_calgary_combined,2015/01/26,ccc_311_calgary_combined,3447,3356,0:00:21,21,,91,70476
2015-01-26-ccc_help_script,2015/01/26,ccc_help_script,1,1,0:00:01,1,,0,1
2015-01-26-ccc_priority_script,2015/01/26,ccc_priority_script,33,31,0:00:11,11,,2,341
2015-01-26-ccc_tax_script,2015/01/26,ccc_tax_script,26,26,0:00:17,17,,0,442
2015-01-27-ccc_311_calgary_combined,2015/01/27,ccc_311_calgary_combined,3338,3027,0:01:40,100,,311,302700
2015-01-27-ccc_help_script,2015/01/27,ccc_help_script,6,5,0:00:08,8,,1,40
2015-01-27-ccc_priority_script,2015/01/27,ccc_priority_script,28,26,0:00:11,11,,2,286
2015-01-27-ccc_tax_script,2015/01/27,ccc_tax_script,14,14,0:01:16,76,,0,1064
2015-01-28-ccc_311_calgary_combined,2015/01/28,ccc_311_calgary_combined,3438,2724,0:03:46,226,,714,615624
2015-01-28-ccc_help_script,2015/01/28,ccc_help_script,10,10,0:00:15,15,,0,150
2015-01-28-ccc_priority_script,2015/01/28,ccc_priority_script,25,23,0:00:17,17,,2,391
2015-01-28-ccc_tax_script,2015/01/28,ccc_tax_script,11,9,0:04:13,253,,2,2277
2015-01-29-ccc_311_calgary_combined,2015/01/29,ccc_311_calgary_combined,3027,2776,0:01:12,72,,251,199872
2015-01-29-ccc_help_script,2015/01/29,ccc_help_script,9,9,0:00:17,17,,0,153
2015-01-29-ccc_priority_script,2015/01/29,ccc_priority_script,27,27,0:00:11,11,,0,297
2015-01-29-ccc_tax_script,2015/01/29,ccc_tax_script,23,19,0:01:54,114,,4,2166
2015-01-30-ccc_311_calgary_combined,2015/01/30,ccc_311_calgary_combined,2921,2489,0:02:35,155,,432,385795
2015-01-30-ccc_help_script,2015/01/30,ccc_help_script,5,5,0:00:21,21,,0,105
2015-01-30-ccc_priority_script,2015/01/30,ccc_priority_script,38,35,0:00:17,17,,3,595
2015-01-30-ccc_tax_script,2015/01/30,ccc_tax_script,19,14,0:03:38,218,,5,3052
2015-01-31-ccc_311_calgary_combined,2015/01/31,ccc_311_calgary_combined,989,967,0:00:11,11,,22,10637
2015-01-31-ccc_priority_script,2015/01/31,ccc_priority_script,39,39,0:00:07,7,,0,273
2015-01-31-ccc_tax_script,2015/01/31,ccc_tax_script,1,1,0:00:07,7,,0,7
2015-02-01-ccc_311_calgary_combined,2015/02/01,ccc_311_calgary_combined,646,642,0:00:07,7,,4,4494
2015-02-01-ccc_help_script,2015/02/01,ccc_help_script,3,3,0:00:06,6,,0,18
2015-02-01-ccc_priority_script,2015/02/01,ccc_priority_script,24,24,0:00:06,6,,0,144
2015-02-02-ccc_311_calgary_combined,2015/02/02,ccc_311_calgary_combined,3026,2988,0:00:11,11,,38,32868
2015-02-02-ccc_help_script,2015/02/02,ccc_help_script,2,5,0:00:04,4,,0,20
2015-02-02-ccc_priority_script,2015/02/02,ccc_priority_script,26,23,0:00:08,8,,3,184
2015-02-02-ccc_tax_script,2015/02/02,ccc_tax_script,19,19,0:00:10,10,,0,190
2015-02-03-ccc_311_calgary_combined,2015/02/03,ccc_311_calgary_combined,2977,2891,0:00:19,19,,86,54929
2015-02-03-ccc_help_script,2015/02/03,ccc_help_script,5,5,0:00:07,7,,0,35
2015-02-03-ccc_priority_script,2015/02/03,ccc_priority_script,33,31,0:00:11,11,,2,341
2015-02-03-ccc_tax_script,2015/02/03,ccc_tax_script,25,20,0:00:16,16,,5,320
2015-02-04-ccc_311_calgary_combined,2015/02/04,ccc_311_calgary_combined,2786,2731,0:00:18,18,,55,49158
2015-02-04-ccc_help_script,2015/02/04,ccc_help_script,5,5,0:00:10,10,,0,50
2015-02-04-ccc_priority_script,2015/02/04,ccc_priority_script,22,22,0:00:07,7,,0,154
2015-02-04-ccc_tax_script,2015/02/04,ccc_tax_script,17,16,0:00:27,27,,1,432
2015-02-05-ccc_311_calgary_combined,2015/02/05,ccc_311_calgary_combined,2643,2538,0:00:33,33,,105,83754
2015-02-05-ccc_help_script,2015/02/05,ccc_help_script,8,8,0:00:14,14,,0,112
2015-02-05-ccc_priority_script,2015/02/05,ccc_priority_script,20,20,0:00:08,8,,0,160
2015-02-05-ccc_tax_script,2015/02/05,ccc_tax_script,14,14,0:00:33,33,,0,462
2015-02-06-ccc_311_calgary_combined,2015/02/06,ccc_311_calgary_combined,2560,2466,0:00:22,22,,94,54252
2015-02-06-ccc_help_script,2015/02/06,ccc_help_script,3,3,0:00:09,9,,0,27
2015-02-06-ccc_priority_script,2015/02/06,ccc_priority_script,31,22,0:00:10,10,,1,220
2015-02-06-ccc_tax_script,2015/02/06,ccc_tax_script,20,18,0:00:17,17,,2,306
2015-02-07-ccc_311_calgary_combined,2015/02/07,ccc_311_calgary_combined,920,902,0:00:12,12,,18,10824
2015-02-07-ccc_priority_script,2015/02/07,ccc_priority_script,16,16,0:00:19,19,,0,304
2015-02-08-ccc_311_calgary_combined,2015/02/08,ccc_311_calgary_combined,780,774,0:00:07,7,,6,5418
2015-02-08-ccc_priority_script,2015/02/08,ccc_priority_script,17,17,0:00:06,6,,0,102
2015-02-09-ccc_311_calgary_combined,2015/02/09,ccc_311_calgary_combined,2999,2953,0:00:15,15,,46,44295
2015-02-09-ccc_help_script,2015/02/09,ccc_help_script,3,3,0:00:09,9,,0,27
2015-02-09-ccc_priority_script,2015/02/09,ccc_priority_script,14,14,0:00:11,11,,0,154
2015-02-09-ccc_tax_script,2015/02/09,ccc_tax_script,19,19,0:00:09,9,,0,171
2015-02-10-ccc_311_calgary_combined,2015/02/10,ccc_311_calgary_combined,2836,2606,0:01:01,61,,230,158966
2015-02-10-ccc_help_script,2015/02/10,ccc_help_script,7,6,0:00:17,17,,1,102
2015-02-10-ccc_priority_script,2015/02/10,ccc_priority_script,16,16,0:00:10,10,,0,160
2015-02-10-ccc_tax_script,2015/02/10,ccc_tax_script,10,9,0:01:16,76,,8,684
2015-02-11-ccc_311_calgary_combined,2015/02/11,ccc_311_calgary_combined,2594,2560,0:00:09,9,,34,23040
2015-02-11-ccc_help_script,2015/02/11,ccc_help_script,1,1,0:00:03,3,,0,3
2015-02-11-ccc_priority_script,2015/02/11,ccc_priority_script,22,21,0:00:08,8,,1,168
2015-02-11-ccc_tax_script,2015/02/11,ccc_tax_script,20,20,0:00:09,9,,0,180
2015-02-12-ccc_311_calgary_combined,2015/02/12,ccc_311_calgary_combined,3414,2935,0:01:39,99,,479,290565
2015-02-12-ccc_help_script,2015/02/12,ccc_help_script,9,9,0:00:08,8,,0,72
2015-02-12-ccc_priority_script,2015/02/12,ccc_priority_script,23,23,0:00:13,13,,0,299
2015-02-12-ccc_tax_script,2015/02/12,ccc_tax_script,13,12,0:00:46,46,,1,552
2015-02-13-ccc_311_calgary_combined,2015/02/13,ccc_311_calgary_combined,2885,2671,0:01:08,68,,214,181628
2015-02-13-ccc_help_script,2015/02/13,ccc_help_script,3,1,0:00:26,26,,2,26
2015-02-13-ccc_priority_script,2015/02/13,ccc_priority_script,28,27,0:00:22,22,,1,594
2015-02-13-ccc_tax_script,2015/02/13,ccc_tax_script,10,10,0:01:44,104,,0,1040
2015-02-14-ccc_311_calgary_combined,2015/02/14,ccc_311_calgary_combined,1128,1114,0:00:11,11,,14,12254
2015-02-14-ccc_priority_script,2015/02/14,ccc_priority_script,19,17,0:00:10,10,,2,170
2015-02-15-ccc_311_calgary_combined,2015/02/15,ccc_311_calgary_combined,945,936,0:00:09,9,,9,8424
2015-02-15-ccc_priority_script,2015/02/15,ccc_priority_script,14,14,0:00:18,18,,0,252
2015-02-16-ccc_311_calgary_combined,2015/02/16,ccc_311_calgary_combined,1485,1468,0:00:08,8,,17,11744
2015-02-16-ccc_help_script,2015/02/16,ccc_help_script,1,1,0:00:15,15,,0,15
2015-02-16-ccc_priority_script,2015/02/16,ccc_priority_script,17,15,0:00:12,12,,2,180
2015-02-17-ccc_311_calgary_combined,2015/02/17,ccc_311_calgary_combined,3450,3277,0:00:33,33,,173,108141
2015-02-17-ccc_help_script,2015/02/17,ccc_help_script,1,1,0:00:17,17,,0,17
2015-02-17-ccc_priority_script,2015/02/17,ccc_priority_script,24,24,0:00:06,6,,0,144
2015-02-17-ccc_tax_script,2015/02/17,ccc_tax_script,18,18,0:00:18,18,,0,324
2015-02-18-ccc_311_calgary_combined,2015/02/18,ccc_311_calgary_combined,3082,2929,0:00:46,46,,153,134734
2015-02-18-ccc_help_script,2015/02/18,ccc_help_script,1,1,0:00:09,9,,0,9
2015-02-18-ccc_priority_script,2015/02/18,ccc_priority_script,17,16,0:00:23,23,,1,368
2015-02-18-ccc_tax_script,2015/02/18,ccc_tax_script,19,19,0:00:38,38,,0,722
2015-02-19-ccc_311_calgary_combined,2015/02/19,ccc_311_calgary_combined,2944,2875,0:00:21,21,,69,60375
2015-02-19-ccc_help_script,2015/02/19,ccc_help_script,6,6,0:00:11,11,,0,66
2015-02-19-ccc_priority_script,2015/02/19,ccc_priority_script,32,31,0:00:13,13,,1,403
2015-02-19-ccc_tax_script,2015/02/19,ccc_tax_script,16,13,0:00:18,18,,3,234
2015-02-20-ccc_311_calgary_combined,2015/02/20,ccc_311_calgary_combined,2778,2425,0:02:08,128,,353,310400
2015-02-20-ccc_help_script,2015/02/20,ccc_help_script,9,9,0:00:15,15,,0,135
2015-02-20-ccc_priority_script,2015/02/20,ccc_priority_script,21,21,0:00:11,11,,0,231
2015-02-20-ccc_tax_script,2015/02/20,ccc_tax_script,18,16,0:02:54,174,,2,2784
2015-02-21-ccc_311_calgary_combined,2015/02/21,ccc_311_calgary_combined,856,848,0:00:11,11,,8,9328
2015-02-21-ccc_priority_script,2015/02/21,ccc_priority_script,17,17,0:00:25,25,,0,425
2015-02-22-ccc_311_calgary_combined,2015/02/22,ccc_311_calgary_combined,707,696,0:00:07,7,,11,4872
2015-02-22-ccc_priority_script,2015/02/22,ccc_priority_script,14,14,0:00:05,5,,0,70
2015-02-23-ccc_311_calgary_combined,2015/02/23,ccc_311_calgary_combined,3212,3165,0:00:13,13,,47,41145
2015-02-23-ccc_help_script,2015/02/23,ccc_help_script,2,2,0:00:04,4,,0,8
2015-02-23-ccc_priority_script,2015/02/23,ccc_priority_script,21,21,0:00:17,17,,0,357
2015-02-23-ccc_tax_script,2015/02/23,ccc_tax_script,11,11,0:00:07,7,,0,77
2015-02-24-ccc_311_calgary_combined,2015/02/24,ccc_311_calgary_combined,2875,2797,0:00:22,22,,78,61534
2015-02-24-ccc_help_script,2015/02/24,ccc_help_script,4,4,0:00:14,14,,0,56
2015-02-24-ccc_priority_script,2015/02/24,ccc_priority_script,15,15,0:00:13,13,,0,195
2015-02-24-ccc_tax_script,2015/02/24,ccc_tax_script,13,11,0:00:13,13,,2,143
2015-02-25-ccc_311_calgary_combined,2015/02/25,ccc_311_calgary_combined,2694,2673,0:00:10,10,,21,26730
2015-02-25-ccc_help_script,2015/02/25,ccc_help_script,2,2,0:00:02,2,,0,4
2015-02-25-ccc_priority_script,2015/02/25,ccc_priority_script,26,26,0:00:06,6,,0,156
2015-02-25-ccc_tax_script,2015/02/25,ccc_tax_script,16,16,0:00:18,18,,0,288
2015-02-26-ccc_311_calgary_combined,2015/02/26,ccc_311_calgary_combined,2570,2534,0:00:11,11,,36,27874
2015-02-26-ccc_help_script,2015/02/26,ccc_help_script,2,2,0:00:04,4,,0,8
2015-02-26-ccc_priority_script,2015/02/26,ccc_priority_script,21,21,0:00:09,9,,0,189
2015-02-26-ccc_tax_script,2015/02/26,ccc_tax_script,17,16,0:00:05,5,,1,80
2015-02-27-ccc_311_calgary_combined,2015/02/27,ccc_311_calgary_combined,2523,2424,0:00:31,31,,99,75144
2015-02-27-ccc_help_script,2015/02/27,ccc_help_script,4,4,0:00:08,8,,0,32
2015-02-27-ccc_priority_script,2015/02/27,ccc_priority_script,23,23,0:00:13,13,,0,299
2015-02-27-ccc_tax_script,2015/02/27,ccc_tax_script,13,13,0:00:40,40,,0,520
2015-02-28-ccc_311_calgary_combined,2015/02/28,ccc_311_calgary_combined,926,916,0:00:09,9,,10,8244
2015-02-28-ccc_priority_script,2015/02/28,ccc_priority_script,17,15,0:00:07,7,,2,105
2015-02-28-ccc_tax_script,2015/02/28,ccc_tax_script,2,2,0:00:04,4,,0,8
2015-03-01-ccc_311_calgary_combined,2015/03/01,ccc_311_calgary_combined,793,786,0:00:07,7,,7,5502
2015-03-01-ccc_help_script,2015/03/01,ccc_help_script,3,3,0:00:06,6,,0,18
2015-03-01-ccc_priority_script,2015/03/01,ccc_priority_script,21,21,0:00:06,6,,0,126
2015-03-01-ccc_tax_script,2015/03/01,ccc_tax_script,1,1,0:00:02,2,,0,2
2015-03-02-ccc_311_calgary_combined,2015/03/02,ccc_311_calgary_combined,3045,3010,0:00:12,12,,35,36120
2015-03-02-ccc_help_script,2015/03/02,ccc_help_script,1,1,0:00:04,4,,0,4
2015-03-02-ccc_priority_script,2015/03/02,ccc_priority_script,33,33,0:00:06,6,,0,198
2015-03-02-ccc_tax_script,2015/03/02,ccc_tax_script,19,19,0:00:10,10,,0,190
2015-03-03-ccc_311_calgary_combined,2015/03/03,ccc_311_calgary_combined,2845,2751,0:00:25,25,,94,68775
2015-03-03-ccc_help_script,2015/03/03,ccc_help_script,5,5,0:00:07,7,,0,35
2015-03-03-ccc_priority_script,2015/03/03,ccc_priority_script,23,23,0:00:11,11,,0,253
2015-03-03-ccc_tax_script,2015/03/03,ccc_tax_script,12,11,0:00:18,18,,1,198
2015-03-04-ccc_311_calgary_combined,2015/03/04,ccc_311_calgary_combined,2872,2799,0:00:18,18,,73,50382
2015-03-04-ccc_help_script,2015/03/04,ccc_help_script,5,5,0:00:10,10,,0,50
2015-03-04-ccc_priority_script,2015/03/04,ccc_priority_script,21,20,0:00:09,9,,1,180
2015-03-04-ccc_tax_script,2015/03/04,ccc_tax_script,8,8,0:00:13,13,,0,104
2015-03-05-ccc_311_calgary_combined,2015/03/05,ccc_311_calgary_combined,2933,2699,0:01:09,69,,234,186231
2015-03-05-ccc_help_script,2015/03/05,ccc_help_script,8,8,0:00:14,14,,0,112
2015-03-05-ccc_priority_script,2015/03/05,ccc_priority_script,30,29,0:00:13,13,,1,377
2015-03-05-ccc_tax_script,2015/03/05,ccc_tax_script,9,7,0:00:56,56,,2,392
2015-03-06-ccc_311_calgary_combined,2015/03/06,ccc_311_calgary_combined,2834,2680,0:00:45,45,,154,120600
2015-03-06-ccc_help_script,2015/03/06,ccc_help_script,2,2,0:00:12,12,,0,24
2015-03-06-ccc_priority_script,2015/03/06,ccc_priority_script,26,25,0:00:11,11,,1,275
2015-03-06-ccc_tax_script,2015/03/06,ccc_tax_script,14,11,0:00:38,38,,3,418
2015-03-07-ccc_311_calgary_combined,2015/03/07,ccc_311_calgary_combined,1150,1126,0:00:17,17,,24,19142
2015-03-07-ccc_help_script,2015/03/07,ccc_help_script,1,1,0:00:04,4,,0,4
2015-03-07-ccc_priority_script,2015/03/07,ccc_priority_script,18,17,0:00:17,17,,1,289
2015-03-08-ccc_311_calgary_combined,2015/03/08,ccc_311_calgary_combined,872,864,0:00:12,12,,8,10368
2015-03-08-ccc_help_script,2015/03/08,ccc_help_script,1,1,0:02:18,138,,0,138
2015-03-08-ccc_priority_script,2015/03/08,ccc_priority_script,19,17,0:00:07,7,,2,119
2015-03-09-ccc_311_calgary_combined,2015/03/09,ccc_311_calgary_combined,3360,3257,0:00:22,22,,103,71654
2015-03-09-ccc_help_script,2015/03/09,ccc_help_script,2,2,0:00:10,10,,0,20
2015-03-09-ccc_priority_script,2015/03/09,ccc_priority_script,24,23,0:00:11,11,,1,253
2015-03-09-ccc_tax_script,2015/03/09,ccc_tax_script,14,12,0:00:24,24,,2,288
2015-03-10-ccc_311_calgary_combined,2015/03/10,ccc_311_calgary_combined,3008,2842,0:00:41,41,,166,116522
2015-03-10-ccc_help_script,2015/03/10,ccc_help_script,9,8,0:00:15,15,,1,120
2015-03-10-ccc_priority_script,2015/03/10,ccc_priority_script,24,23,0:00:13,13,,1,299
2015-03-10-ccc_tax_script,2015/03/10,ccc_tax_script,12,12,0:00:34,34,,0,408
2015-03-11-ccc_311_calgary_combined,2015/03/11,ccc_311_calgary_combined,3021,2884,0:00:31,31,,137,89404
2015-03-11-ccc_help_script,2015/03/11,ccc_help_script,5,5,0:00:07,7,,0,35
2015-03-11-ccc_priority_script,2015/03/11,ccc_priority_script,32,32,0:00:09,9,,0,288
2015-03-11-ccc_tax_script,2015/03/11,ccc_tax_script,18,18,0:00:15,15,,0,270
2015-03-12-ccc_311_calgary_combined,2015/03/12,ccc_311_calgary_combined,3015,2810,0:00:52,52,,205,146120
2015-03-12-ccc_help_script,2015/03/12,ccc_help_script,3,3,0:00:44,44,,0,132
2015-03-12-ccc_priority_script,2015/03/12,ccc_priority_script,38,37,0:00:14,14,,1,518
2015-03-12-ccc_tax_script,2015/03/12,ccc_tax_script,11,11,0:01:12,72,,0,792
2015-03-13-ccc_311_calgary_combined,2015/03/13,ccc_311_calgary_combined,3063,2885,0:00:38,38,,178,109630
2015-03-13-ccc_help_script,2015/03/13,ccc_help_script,7,7,0:00:09,9,,0,63
2015-03-13-ccc_priority_script,2015/03/13,ccc_priority_script,37,37,0:00:10,10,,0,370
2015-03-13-ccc_tax_script,2015/03/13,ccc_tax_script,10,9,0:00:27,27,,1,243
2015-03-14-ccc_311_calgary_combined,2015/03/14,ccc_311_calgary_combined,1367,1158,0:01:58,118,,209,136644
2015-03-14-ccc_help_script,2015/03/14,ccc_help_script,6,5,0:00:22,22,,1,110
2015-03-14-ccc_priority_script,2015/03/14,ccc_priority_script,21,19,0:00:30,30,,2,570
2015-03-14-ccc_tax_script,2015/03/14,ccc_tax_script,2,1,0:06:37,397,,1,397
2015-03-15-ccc_311_calgary_combined,2015/03/15,ccc_311_calgary_combined,961,912,0:00:29,29,,49,26448
2015-03-15-ccc_help_script,2015/03/15,ccc_help_script,2,2,0:00:05,5,,0,10
2015-03-15-ccc_priority_script,2015/03/15,ccc_priority_script,25,24,0:00:14,14,,1,336
2015-03-15-ccc_tax_script,2015/03/15,ccc_tax_script,1,1,0:00:29,29,,0,29
2015-03-16-ccc_311_calgary_combined,2015/03/16,ccc_311_calgary_combined,3193,3144,0:00:12,12,,49,37728
2015-03-16-ccc_help_script,2015/03/16,ccc_help_script,1,1,0:00:03,3,,0,3
2015-03-16-ccc_priority_script,2015/03/16,ccc_priority_script,43,43,0:00:06,6,,0,258
2015-03-16-ccc_tax_script,2015/03/16,ccc_tax_script,17,16,0:00:11,11,,1,176
2015-03-17-ccc_311_calgary_combined,2015/03/17,ccc_311_calgary_combined,2766,2707,0:00:16,16,,59,43312
2015-03-17-ccc_help_script,2015/03/17,ccc_help_script,6,6,0:00:03,3,,0,18
2015-03-17-ccc_priority_script,2015/03/17,ccc_priority_script,21,20,0:00:07,7,,1,140
2015-03-17-ccc_tax_script,2015/03/17,ccc_tax_script,19,19,0:00:11,11,,0,209
2015-03-18-ccc_311_calgary_combined,2015/03/18,ccc_311_calgary_combined,2882,2748,0:00:39,39,,134,107172
2015-03-18-ccc_help_script,2015/03/18,ccc_help_script,8,7,0:00:09,9,,1,63
2015-03-18-ccc_priority_script,2015/03/18,ccc_priority_script,43,42,0:00:11,11,,1,462
2015-03-18-ccc_tax_script,2015/03/18,ccc_tax_script,19,17,0:00:55,55,,2,935
2015-03-19-ccc_311_calgary_combined,2015/03/19,ccc_311_calgary_combined,2837,2680,0:00:52,52,,157,139360
2015-03-19-ccc_help_script,2015/03/19,ccc_help_script,3,3,0:00:08,8,,0,24
2015-03-19-ccc_priority_script,2015/03/19,ccc_priority_script,34,34,0:00:24,24,,0,816
2015-03-19-ccc_tax_script,2015/03/19,ccc_tax_script,14,14,0:00:54,54,,0,756
2015-03-20-ccc_311_calgary_combined,2015/03/20,ccc_311_calgary_combined,2781,2671,0:00:35,35,,110,93485
2015-03-20-ccc_help_script,2015/03/20,ccc_help_script,2,2,0:00:27,27,,0,54
2015-03-20-ccc_priority_script,2015/03/20,ccc_priority_script,22,21,0:00:07,7,,1,147
2015-03-20-ccc_tax_script,2015/03/20,ccc_tax_script,10,9,0:01:12,72,,1,648
2015-03-21-ccc_311_calgary_combined,2015/03/21,ccc_311_calgary_combined,1177,1165,0:00:07,7,,12,8155
2015-03-21-ccc_priority_script,2015/03/21,ccc_priority_script,18,16,0:00:08,8,,2,128
2015-03-21-ccc_tax_script,2015/03/21,ccc_tax_script,2,2,0:00:10,10,,0,20
2015-03-22-ccc_311_calgary_combined,2015/03/22,ccc_311_calgary_combined,850,838,0:00:06,6,,12,5028
2015-03-22-ccc_priority_script,2015/03/22,ccc_priority_script,20,20,0:00:10,10,,0,200
2015-03-23-ccc_311_calgary_combined,2015/03/23,ccc_311_calgary_combined,3120,3096,0:00:07,7,,24,21672
2015-03-23-ccc_help_script,2015/03/23,ccc_help_script,5,5,0:00:04,4,,0,20
2015-03-23-ccc_priority_script,2015/03/23,ccc_priority_script,24,24,0:00:04,4,,0,96
2015-03-23-ccc_tax_script,2015/03/23,ccc_tax_script,16,15,0:00:09,9,,1,135
2015-03-24-ccc_311_calgary_combined,2015/03/24,ccc_311_calgary_combined,2926,2902,0:00:07,7,,24,20314
2015-03-24-ccc_help_script,2015/03/24,ccc_help_script,42,31,0:00:08,8,,11,248
2015-03-24-ccc_priority_script,2015/03/24,ccc_priority_script,26,25,0:00:08,8,,1,200
2015-03-24-ccc_tax_script,2015/03/24,ccc_tax_script,18,18,0:00:05,5,,0,90
2015-03-25-ccc_311_calgary_combined,2015/03/25,ccc_311_calgary_combined,2974,2926,0:00:12,12,,48,35112
2015-03-25-ccc_help_script,2015/03/25,ccc_help_script,1,1,0:00:07,7,,0,7
2015-03-25-ccc_priority_script,2015/03/25,ccc_priority_script,26,26,0:00:05,5,,0,130
2015-03-25-ccc_tax_script,2015/03/25,ccc_tax_script,24,24,0:00:11,11,,0,264
2015-03-26-ccc_311_calgary_combined,2015/03/26,ccc_311_calgary_combined,3090,2938,0:00:39,39,,152,114582
2015-03-26-ccc_help_script,2015/03/26,ccc_help_script,11,11,0:00:08,8,,0,88
2015-03-26-ccc_priority_script,2015/03/26,ccc_priority_script,34,34,0:00:08,8,,0,272
2015-03-26-ccc_tax_script,2015/03/26,ccc_tax_script,16,16,0:00:11,11,,0,176
2015-03-27-ccc_311_calgary_combined,2015/03/27,ccc_311_calgary_combined,3038,2792,0:01:01,61,,246,170312
2015-03-27-ccc_help_script,2015/03/27,ccc_help_script,14,14,0:00:05,5,,0,70
2015-03-27-ccc_priority_script,2015/03/27,ccc_priority_script,31,30,0:00:19,19,,1,570
2015-03-27-ccc_tax_script,2015/03/27,ccc_tax_script,12,11,0:01:10,70,,1,770
2015-03-28-ccc_311_calgary_combined,2015/03/28,ccc_311_calgary_combined,1057,1025,0:00:17,17,,32,17425
2015-03-28-ccc_help_script,2015/03/28,ccc_help_script,1,1,0:00:02,2,,0,2
2015-03-28-ccc_priority_script,2015/03/28,ccc_priority_script,34,32,0:00:13,13,,2,416
2015-03-29-ccc_311_calgary_combined,2015/03/29,ccc_311_calgary_combined,1169,1145,0:00:18,18,,24,20610
2015-03-29-ccc_help_script,2015/03/29,ccc_help_script,1,1,0:00:08,8,,0,8
2015-03-29-ccc_priority_script,2015/03/29,ccc_priority_script,13,13,0:00:10,10,,0,130
2015-03-29-ccc_tax_script,2015/03/29,ccc_tax_script,1,1,0:00:03,3,,0,3
2015-03-30-ccc_311_calgary_combined,2015/03/30,ccc_311_calgary_combined,3623,3561,0:00:16,16,,62,56976
2015-03-30-ccc_help_script,2015/03/30,ccc_help_script,7,7,0:00:05,5,,0,35
2015-03-30-ccc_priority_script,2015/03/30,ccc_priority_script,33,28,0:00:06,6,,5,168
2015-03-30-ccc_tax_script,2015/03/30,ccc_tax_script,26,25,0:00:13,13,,1,325
2015-03-31-ccc_311_calgary_combined,2015/03/31,ccc_311_calgary_combined,3558,3400,0:00:35,35,,158,119000
2015-03-31-ccc_help_script,2015/03/31,ccc_help_script,8,8,0:00:09,9,,0,72
2015-03-31-ccc_priority_script,2015/03/31,ccc_priority_script,28,28,0:00:13,13,,0,364
2015-03-31-ccc_tax_script,2015/03/31,ccc_tax_script,21,21,0:00:06,6,,0,126
2015-04-01-ccc_311_calgary_combined,2015/04/01,ccc_311_calgary_combined,3328,3236,0:00:19,19,,92,61484
2015-04-01-ccc_help_script,2015/04/01,ccc_help_script,3,3,0:00:03,3,,0,9
2015-04-01-ccc_priority_script,2015/04/01,ccc_priority_script,32,31,0:00:12,12,,1,372
2015-04-01-ccc_tax_script,2015/04/01,ccc_tax_script,17,17,0:00:07,7,,0,119
2015-04-02-ccc_311_calgary_combined,2015/04/02,ccc_311_calgary_combined,3441,3338,0:00:24,24,,103,80112
2015-04-02-ccc_help_script,2015/04/02,ccc_help_script,13,12,0:00:08,8,,1,96
2015-04-02-ccc_priority_script,2015/04/02,ccc_priority_script,33,32,0:00:13,13,,1,416
2015-04-02-ccc_tax_script,2015/04/02,ccc_tax_script,9,9,0:00:10,10,,0,90
2015-04-03-ccc_311_calgary_combined,2015/04/03,ccc_311_calgary_combined,1399,1367,0:00:12,12,,32,16404
2015-04-03-ccc_help_script,2015/04/03,ccc_help_script,2,2,0:00:03,3,,0,6
2015-04-03-ccc_priority_script,2015/04/03,ccc_priority_script,17,15,0:00:05,5,,2,75
2015-04-04-ccc_311_calgary_combined,2015/04/04,ccc_311_calgary_combined,1068,1043,0:00:13,13,,25,13559
2015-04-04-ccc_help_script,2015/04/04,ccc_help_script,1,1,0:00:04,4,,0,4
2015-04-04-ccc_priority_script,2015/04/04,ccc_priority_script,13,12,0:00:06,6,,1,72
2015-04-05-ccc_311_calgary_combined,2015/04/05,ccc_311_calgary_combined,741,732,0:00:08,8,,9,5856
2015-04-05-ccc_priority_script,2015/04/05,ccc_priority_script,17,17,0:00:07,7,,0,119
2015-04-05-ccc_tax_script,2015/04/05,ccc_tax_script,2,2,0:00:05,5,,0,10
2015-04-06-ccc_311_calgary_combined,2015/04/06,ccc_311_calgary_combined,2999,2978,0:00:07,7,,21,20846
2015-04-06-ccc_help_script,2015/04/06,ccc_help_script,4,4,0:00:06,6,,0,24
2015-04-06-ccc_priority_script,2015/04/06,ccc_priority_script,36,36,0:00:07,7,,0,252
2015-04-06-ccc_tax_script,2015/04/06,ccc_tax_script,2,2,0:00:03,3,,0,6
2015-04-07-ccc_311_calgary_combined,2015/04/07,ccc_311_calgary_combined,3298,3114,0:00:43,43,,184,133902
2015-04-07-ccc_help_script,2015/04/07,ccc_help_script,9,9,0:00:05,5,,0,45
2015-04-07-ccc_priority_script,2015/04/07,ccc_priority_script,14,14,0:00:10,10,,0,140
2015-04-07-ccc_tax_script,2015/04/07,ccc_tax_script,12,12,0:00:56,56,,0,672
2015-04-08-ccc_311_calgary_combined,2015/04/08,ccc_311_calgary_combined,3380,3257,0:00:20,20,,123,65140
2015-04-08-ccc_help_script,2015/04/08,ccc_help_script,4,4,0:00:08,8,,0,32
2015-04-08-ccc_priority_script,2015/04/08,ccc_priority_script,36,36,0:00:07,7,,0,252
2015-04-08-ccc_tax_script,2015/04/08,ccc_tax_script,20,20,0:00:08,8,,0,160
2015-04-09-ccc_311_calgary_combined,2015/04/09,ccc_311_calgary_combined,3420,3101,0:01:14,74,,319,229474
2015-04-09-ccc_help_script,2015/04/09,ccc_help_script,10,8,0:00:10,10,,2,80
2015-04-09-ccc_priority_script,2015/04/09,ccc_priority_script,27,25,0:00:08,8,,2,200
2015-04-09-ccc_tax_script,2015/04/09,ccc_tax_script,20,19,0:01:05,65,,1,1235
2015-04-10-ccc_311_calgary_combined,2015/04/10,ccc_311_calgary_combined,3175,2928,0:01:00,60,,247,175680
2015-04-10-ccc_help_script,2015/04/10,ccc_help_script,12,11,0:00:11,11,,1,121
2015-04-10-ccc_priority_script,2015/04/10,ccc_priority_script,25,24,0:00:12,12,,1,288
2015-04-10-ccc_tax_script,2015/04/10,ccc_tax_script,16,15,0:01:35,95,,1,1425
2015-04-11-ccc_311_calgary_combined,2015/04/11,ccc_311_calgary_combined,1398,1346,0:00:21,21,,52,28266
2015-04-11-ccc_help_script,2015/04/11,ccc_help_script,2,2,0:00:06,6,,0,12
2015-04-11-ccc_priority_script,2015/04/11,ccc_priority_script,31,31,0:00:10,10,,0,310
2015-04-11-ccc_tax_script,2015/04/11,ccc_tax_script,1,1,0:00:03,3,,0,3
2015-04-12-ccc_311_calgary_combined,2015/04/12,ccc_311_calgary_combined,983,951,0:00:10,10,,32,9510
2015-04-12-ccc_priority_script,2015/04/12,ccc_priority_script,22,19,0:00:06,6,,3,114
2015-04-13-ccc_311_calgary_combined,2015/04/13,ccc_311_calgary_combined,4010,3889,0:00:18,18,,121,70002
2015-04-13-ccc_help_script,2015/04/13,ccc_help_script,9,9,0:00:06,6,,0,54
2015-04-13-ccc_priority_script,2015/04/13,ccc_priority_script,17,17,0:00:08,8,,0,136
2015-04-13-ccc_tax_script,2015/04/13,ccc_tax_script,22,21,0:00:18,18,,1,378
2015-04-14-ccc_311_calgary_combined,2015/04/14,ccc_311_calgary_combined,3652,3524,0:00:20,20,,128,70480
2015-04-14-ccc_help_script,2015/04/14,ccc_help_script,7,7,0:00:08,8,,0,56
2015-04-14-ccc_priority_script,2015/04/14,ccc_priority_script,31,30,0:00:08,8,,1,240
2015-04-14-ccc_tax_script,2015/04/14,ccc_tax_script,22,22,0:00:17,17,,0,374
2015-04-15-ccc_311_calgary_combined,2015/04/15,ccc_311_calgary_combined,3497,3332,0:00:33,33,,165,109956
2015-04-15-ccc_help_script,2015/04/15,ccc_help_script,6,6,0:00:10,10,,0,60
2015-04-15-ccc_priority_script,2015/04/15,ccc_priority_script,20,20,0:00:07,7,,0,140
2015-04-15-ccc_tax_script,2015/04/15,ccc_tax_script,13,12,0:00:39,39,,1,468
2015-04-16-ccc_311_calgary_combined,2015/04/16,ccc_311_calgary_combined,3283,3072,0:00:39,39,,211,119808
2015-04-16-ccc_help_script,2015/04/16,ccc_help_script,7,7,0:00:04,4,,0,28
2015-04-16-ccc_priority_script,2015/04/16,ccc_priority_script,24,24,0:00:24,24,,0,576
2015-04-16-ccc_tax_script,2015/04/16,ccc_tax_script,18,16,0:00:07,7,,2,112
2015-04-17-ccc_311_calgary_combined,2015/04/17,ccc_311_calgary_combined,3244,3102,0:00:33,33,,142,102366
2015-04-17-ccc_help_script,2015/04/17,ccc_help_script,12,10,0:00:10,10,,2,100
2015-04-17-ccc_priority_script,2015/04/17,ccc_priority_script,27,27,0:00:10,10,,0,270
2015-04-17-ccc_tax_script,2015/04/17,ccc_tax_script,18,16,0:00:15,15,,2,240
2015-04-18-ccc_311_calgary_combined,2015/04/18,ccc_311_calgary_combined,1276,1186,0:00:46,46,,90,54556
2015-04-18-ccc_priority_script,2015/04/18,ccc_priority_script,25,25,0:00:21,21,,0,525
2015-04-18-ccc_tax_script,2015/04/18,ccc_tax_script,2,2,0:01:25,85,,0,170
2015-04-19-ccc_311_calgary_combined,2015/04/19,ccc_311_calgary_combined,1068,1000,0:00:31,31,,68,31000
2015-04-19-ccc_priority_script,2015/04/19,ccc_priority_script,18,18,0:00:09,9,,0,162
2015-04-19-ccc_tax_script,2015/04/19,ccc_tax_script,4,3,0:01:22,82,,1,246
2015-04-20-ccc_311_calgary_combined,2015/04/20,ccc_311_calgary_combined,4121,3844,0:00:52,52,,277,199888
2015-04-20-ccc_help_script,2015/04/20,ccc_help_script,3,3,0:00:04,4,,0,12
2015-04-20-ccc_priority_script,2015/04/20,ccc_priority_script,25,23,0:00:07,7,,2,161
2015-04-20-ccc_tax_script,2015/04/20,ccc_tax_script,8,8,0:00:09,9,,0,72
2015-04-21-ccc_311_calgary_combined,2015/04/21,ccc_311_calgary_combined,3711,3584,0:00:27,27,,127,96768
2015-04-21-ccc_help_script,2015/04/21,ccc_help_script,7,6,0:00:05,5,,1,30
2015-04-21-ccc_priority_script,2015/04/21,ccc_priority_script,11,10,0:00:12,12,,1,120
2015-04-21-ccc_tax_script,2015/04/21,ccc_tax_script,19,18,0:00:14,14,,1,252
2015-04-22-ccc_311_calgary_combined,2015/04/22,ccc_311_calgary_combined,3770,3539,0:00:41,41,,231,145099
2015-04-22-ccc_help_script,2015/04/22,ccc_help_script,9,7,0:00:08,8,,2,56
2015-04-22-ccc_priority_script,2015/04/22,ccc_priority_script,24,23,0:00:16,16,,1,368
2015-04-22-ccc_tax_script,2015/04/22,ccc_tax_script,23,22,0:00:52,52,,1,1144
2015-04-23-ccc_311_calgary_combined,2015/04/23,ccc_311_calgary_combined,3649,3516,0:00:25,25,,133,87900
2015-04-23-ccc_help_script,2015/04/23,ccc_help_script,11,11,0:00:08,8,,0,88
2015-04-23-ccc_priority_script,2015/04/23,ccc_priority_script,20,19,0:00:09,9,,1,171
2015-04-23-ccc_tax_script,2015/04/23,ccc_tax_script,20,19,0:00:13,13,,1,247
2015-04-24-ccc_311_calgary_combined,2015/04/24,ccc_311_calgary_combined,3221,3033,0:00:45,45,,188,136485
2015-04-24-ccc_help_script,2015/04/24,ccc_help_script,10,10,0:00:07,7,,0,70
2015-04-24-ccc_priority_script,2015/04/24,ccc_priority_script,30,29,0:00:10,10,,1,290
2015-04-24-ccc_tax_script,2015/04/24,ccc_tax_script,14,14,0:01:38,98,,0,1372
2015-04-25-ccc_311_calgary_combined,2015/04/25,ccc_311_calgary_combined,1245,1214,0:00:11,11,,31,13354
2015-04-25-ccc_help_script,2015/04/25,ccc_help_script,3,2,0:00:06,6,,1,12
2015-04-25-ccc_priority_script,2015/04/25,ccc_priority_script,13,12,0:00:06,6,,1,72
2015-04-25-ccc_tax_script,2015/04/25,ccc_tax_script,2,2,0:02:07,127,,0,254
2015-04-26-ccc_311_calgary_combined,2015/04/26,ccc_311_calgary_combined,1102,1061,0:00:17,17,,41,18037
2015-04-26-ccc_priority_script,2015/04/26,ccc_priority_script,11,11,0:00:08,8,,0,88
2015-04-26-ccc_tax_script,2015/04/26,ccc_tax_script,1,1,0:00:04,4,,0,4
2015-04-27-ccc_311_calgary_combined,2015/04/27,ccc_311_calgary_combined,4119,3995,0:00:20,20,,124,79900
2015-04-27-ccc_help_script,2015/04/27,ccc_help_script,6,6,0:00:07,7,,0,42
2015-04-27-ccc_priority_script,2015/04/27,ccc_priority_script,27,26,0:00:07,7,,1,182
2015-04-27-ccc_tax_script,2015/04/27,ccc_tax_script,10,10,0:00:07,7,,0,70
2015-04-28-ccc_311_calgary_combined,2015/04/28,ccc_311_calgary_combined,4020,3617,0:01:12,72,,403,260424
2015-04-28-ccc_help_script,2015/04/28,ccc_help_script,8,7,0:00:11,11,,1,77
2015-04-28-ccc_priority_script,2015/04/28,ccc_priority_script,31,30,0:00:13,13,,1,390
2015-04-28-ccc_tax_script,2015/04/28,ccc_tax_script,12,11,0:00:56,56,,1,616
2015-04-29-ccc_311_calgary_combined,2015/04/29,ccc_311_calgary_combined,3597,3283,0:01:06,66,,314,216678
2015-04-29-ccc_help_script,2015/04/29,ccc_help_script,8,8,0:00:09,9,,0,72
2015-04-29-ccc_priority_script,2015/04/29,ccc_priority_script,19,19,0:00:10,10,,0,190
2015-04-29-ccc_tax_script,2015/04/29,ccc_tax_script,26,21,0:01:29,89,,5,1869
2015-04-30-ccc_311_calgary_combined,2015/04/30,ccc_311_calgary_combined,3700,3376,0:01:10,70,,324,236320
2015-04-30-ccc_help_script,2015/04/30,ccc_help_script,17,15,0:00:17,17,,2,255
2015-04-30-ccc_priority_script,2015/04/30,ccc_priority_script,26,25,0:00:13,13,,1,325
2015-04-30-ccc_tax_script,2015/04/30,ccc_tax_script,23,21,0:01:11,71,,2,1491
2015-05-01-ccc_311_calgary_combined,2015/05/01,ccc_311_calgary_combined,3647,3173,0:01:40,100,,474,317300
2015-05-01-ccc_help_script,2015/05/01,ccc_help_script,4,4,0:00:26,26,,0,104
2015-05-01-ccc_priority_script,2015/05/01,ccc_priority_script,35,33,0:00:19,19,,2,627
2015-05-01-ccc_tax_script,2015/05/01,ccc_tax_script,12,12,0:01:57,117,,0,1404
2015-05-02-ccc_311_calgary_combined,2015/05/02,ccc_311_calgary_combined,1442,1398,0:00:14,14,,44,19572
2015-05-02-ccc_help_script,2015/05/02,ccc_help_script,2,2,0:00:03,3,,0,6
2015-05-02-ccc_priority_script,2015/05/02,ccc_priority_script,37,35,0:00:17,17,,2,595
2015-05-02-ccc_tax_script,2015/05/02,ccc_tax_script,1,1,0:05:58,358,,0,358
2015-05-03-ccc_311_calgary_combined,2015/05/03,ccc_311_calgary_combined,1168,1127,0:00:28,28,,41,31556
2015-05-03-ccc_priority_script,2015/05/03,ccc_priority_script,26,24,0:00:22,22,,2,528
2015-05-03-ccc_tax_script,2015/05/03,ccc_tax_script,4,1,0:00:04,4,,3,4
2015-05-04-ccc_311_calgary_combined,2015/05/04,ccc_311_calgary_combined,4510,3935,0:01:39,99,,575,389565
2015-05-04-ccc_help_script,2015/05/04,ccc_help_script,22,20,0:00:07,7,,2,140
2015-05-04-ccc_priority_script,2015/05/04,ccc_priority_script,34,32,0:00:13,13,,2,416
2015-05-04-ccc_tax_script,2015/05/04,ccc_tax_script,25,20,0:01:34,94,,5,1880
2015-05-05-ccc_311_calgary_combined,2015/05/05,ccc_311_calgary_combined,4294,3691,0:01:50,110,,603,406010
2015-05-05-ccc_help_script,2015/05/05,ccc_help_script,6,6,0:00:10,10,,0,60
2015-05-05-ccc_priority_script,2015/05/05,ccc_priority_script,37,35,0:00:11,11,,2,385
2015-05-05-ccc_tax_script,2015/05/05,ccc_tax_script,17,15,0:02:40,160,,2,2400
2015-05-06-ccc_311_calgary_combined,2015/05/06,ccc_311_calgary_combined,3586,3438,0:00:25,25,,148,85950
2015-05-06-ccc_help_script,2015/05/06,ccc_help_script,10,8,0:00:08,8,,2,64
2015-05-06-ccc_priority_script,2015/05/06,ccc_priority_script,34,34,0:00:11,11,,0,374
2015-05-06-ccc_tax_script,2015/05/06,ccc_tax_script,14,14,0:00:17,17,,0,238
2015-05-07-ccc_311_calgary_combined,2015/05/07,ccc_311_calgary_combined,3643,3265,0:01:12,72,,378,235080
2015-05-07-ccc_help_script,2015/05/07,ccc_help_script,9,8,0:00:15,15,,1,120
2015-05-07-ccc_priority_script,2015/05/07,ccc_priority_script,43,42,0:00:16,16,,1,672
2015-05-07-ccc_tax_script,2015/05/07,ccc_tax_script,22,21,0:00:51,51,,1,1071
2015-05-08-ccc_311_calgary_combined,2015/05/08,ccc_311_calgary_combined,3416,3069,0:01:22,82,,347,251658
2015-05-08-ccc_help_script,2015/05/08,ccc_help_script,12,11,0:00:07,7,,1,77
2015-05-08-ccc_priority_script,2015/05/08,ccc_priority_script,17,17,0:00:08,8,,0,136
2015-05-08-ccc_tax_script,2015/05/08,ccc_tax_script,14,13,0:01:59,119,,1,1547
2015-05-09-ccc_311_calgary_combined,2015/05/09,ccc_311_calgary_combined,1359,1327,0:00:15,15,,32,19905
2015-05-09-ccc_priority_script,2015/05/09,ccc_priority_script,18,16,0:00:10,10,,2,160
2015-05-10-ccc_311_calgary_combined,2015/05/10,ccc_311_calgary_combined,1040,1010,0:00:22,22,,30,22220
2015-05-10-ccc_priority_script,2015/05/10,ccc_priority_script,13,13,0:00:37,37,,0,481
2015-05-11-ccc_311_calgary_combined,2015/05/11,ccc_311_calgary_combined,4379,4084,0:00:36,36,,295,147024
2015-05-11-ccc_help_script,2015/05/11,ccc_help_script,11,11,0:00:06,6,,0,66
2015-05-11-ccc_priority_script,2015/05/11,ccc_priority_script,21,20,0:00:12,12,,1,240
2015-05-11-ccc_tax_script,2015/05/11,ccc_tax_script,27,26,0:00:25,25,,1,650
2015-05-12-ccc_311_calgary_combined,2015/05/12,ccc_311_calgary_combined,3794,3541,0:00:53,53,,253,187673
2015-05-12-ccc_help_script,2015/05/12,ccc_help_script,7,7,0:00:14,14,,0,98
2015-05-12-ccc_priority_script,2015/05/12,ccc_priority_script,28,26,0:00:14,14,,2,364
2015-05-12-ccc_tax_script,2015/05/12,ccc_tax_script,20,18,0:00:48,48,,2,864
2015-05-13-ccc_311_calgary_combined,2015/05/13,ccc_311_calgary_combined,3746,3433,0:01:21,81,,313,278073
2015-05-13-ccc_help_script,2015/05/13,ccc_help_script,9,9,0:00:07,7,,0,63
2015-05-13-ccc_priority_script,2015/05/13,ccc_priority_script,30,27,0:00:10,10,,3,270
2015-05-13-ccc_tax_script,2015/05/13,ccc_tax_script,24,24,0:01:20,80,,0,1920
2015-05-14-ccc_311_calgary_combined,2015/05/14,ccc_311_calgary_combined,3467,3101,0:01:14,74,,366,229474
2015-05-14-ccc_help_script,2015/05/14,ccc_help_script,24,19,0:00:07,7,,5,133
2015-05-14-ccc_priority_script,2015/05/14,ccc_priority_script,34,29,0:00:20,20,,5,580
2015-05-14-ccc_tax_script,2015/05/14,ccc_tax_script,22,20,0:01:14,74,,2,1480
2015-05-15-ccc_311_calgary_combined,2015/05/15,ccc_311_calgary_combined,3123,3047,0:00:20,20,,76,60940
2015-05-15-ccc_help_script,2015/05/15,ccc_help_script,4,4,0:00:03,3,,0,12
2015-05-15-ccc_priority_script,2015/05/15,ccc_priority_script,21,20,0:00:14,14,,1,280
2015-05-15-ccc_tax_script,2015/05/15,ccc_tax_script,18,18,0:00:09,9,,0,162
2015-05-16-ccc_311_calgary_combined,2015/05/16,ccc_311_calgary_combined,1153,1132,0:00:09,9,,21,10188
2015-05-16-ccc_help_script,2015/05/16,ccc_help_script,1,1,0:00:02,2,,0,2
2015-05-16-ccc_priority_script,2015/05/16,ccc_priority_script,24,24,0:00:26,26,,0,624
2015-05-17-ccc_311_calgary_combined,2015/05/17,ccc_311_calgary_combined,1086,1072,0:00:09,9,,14,9648
2015-05-17-ccc_priority_script,2015/05/17,ccc_priority_script,20,18,0:00:07,7,,2,126
2015-05-18-ccc_311_calgary_combined,2015/05/18,ccc_311_calgary_combined,1265,1257,0:00:08,8,,8,10056
2015-05-18-ccc_priority_script,2015/05/18,ccc_priority_script,11,11,0:00:06,6,,0,66
2015-05-18-ccc_tax_script,2015/05/18,ccc_tax_script,1,1,0:00:06,6,,0,6
2015-05-19-ccc_311_calgary_combined,2015/05/19,ccc_311_calgary_combined,4534,4163,0:01:10,70,,371,291410
2015-05-19-ccc_help_script,2015/05/19,ccc_help_script,7,6,0:00:08,8,,1,48
2015-05-19-ccc_priority_script,2015/05/19,ccc_priority_script,36,34,0:00:08,8,,2,272
2015-05-19-ccc_tax_script,2015/05/19,ccc_tax_script,21,21,0:00:56,56,,0,1176
2015-05-20-ccc_311_calgary_combined,2015/05/20,ccc_311_calgary_combined,4593,3207,0:05:39,339,,1386,1087173
2015-05-20-ccc_help_script,2015/05/20,ccc_help_script,7,6,0:00:04,4,,1,24
2015-05-20-ccc_priority_script,2015/05/20,ccc_priority_script,44,42,0:00:22,22,,2,924
2015-05-20-ccc_tax_script,2015/05/20,ccc_tax_script,22,12,0:07:47,467,,10,5604
2015-05-21-ccc_311_calgary_combined,2015/05/21,ccc_311_calgary_combined,4522,3128,0:05:33,333,,1394,1041624
2015-05-21-ccc_help_script,2015/05/21,ccc_help_script,9,8,0:00:31,31,,1,248
2015-05-21-ccc_priority_script,2015/05/21,ccc_priority_script,23,23,0:00:14,14,,0,322
2015-05-21-ccc_tax_script,2015/05/21,ccc_tax_script,32,25,0:04:22,262,,7,6550
2015-05-22-ccc_311_calgary_combined,2015/05/22,ccc_311_calgary_combined,4605,3178,0:05:27,327,,1427,1039206
2015-05-22-ccc_help_script,2015/05/22,ccc_help_script,16,14,0:00:12,12,,2,168
2015-05-22-ccc_priority_script,2015/05/22,ccc_priority_script,18,18,0:00:21,21,,0,378
2015-05-22-ccc_tax_script,2015/05/22,ccc_tax_script,11,9,0:05:51,351,,2,3159
2015-05-23-ccc_311_calgary_combined,2015/05/23,ccc_311_calgary_combined,1762,1627,0:00:49,49,,135,79723
2015-05-23-ccc_priority_script,2015/05/23,ccc_priority_script,31,31,0:00:11,11,,0,341
2015-05-23-ccc_tax_script,2015/05/23,ccc_tax_script,1,1,0:06:20,380,,0,380
2015-05-24-ccc_311_calgary_combined,2015/05/24,ccc_311_calgary_combined,1378,1264,0:01:01,61,,114,77104
2015-05-24-ccc_help_script,2015/05/24,ccc_help_script,2,2,0:00:11,11,,0,22
2015-05-24-ccc_priority_script,2015/05/24,ccc_priority_script,25,23,0:00:26,26,,2,598
2015-05-24-ccc_tax_script,2015/05/24,ccc_tax_script,1,1,0:00:35,35,,0,35
2015-05-25-ccc_311_calgary_combined,2015/05/25,ccc_311_calgary_combined,5021,3700,0:05:25,325,,1321,1202500
2015-05-25-ccc_help_script,2015/05/25,ccc_help_script,11,7,0:00:15,15,,4,105
2015-05-25-ccc_priority_script,2015/05/25,ccc_priority_script,35,34,0:00:20,20,,1,680
2015-05-25-ccc_tax_script,2015/05/25,ccc_tax_script,29,29,0:06:07,367,,0,10643
2015-05-26-ccc_311_calgary_combined,2015/05/26,ccc_311_calgary_combined,4346,3347,0:03:59,239,,999,799933
2015-05-26-ccc_help_script,2015/05/26,ccc_help_script,22,17,0:00:13,13,,5,221
2015-05-26-ccc_priority_script,2015/05/26,ccc_priority_script,42,37,0:00:17,17,,5,629
2015-05-26-ccc_tax_script,2015/05/26,ccc_tax_script,24,21,0:05:10,310,,3,6510
2015-05-27-ccc_311_calgary_combined,2015/05/27,ccc_311_calgary_combined,4737,2888,0:07:40,460,,1848,1328480
2015-05-27-ccc_help_script,2015/05/27,ccc_help_script,9,6,0:00:10,10,,3,60
2015-05-27-ccc_priority_script,2015/05/27,ccc_priority_script,29,29,0:00:17,17,,0,493
2015-05-27-ccc_tax_script,2015/05/27,ccc_tax_script,21,14,0:07:11,431,,7,6034
2015-05-28-ccc_311_calgary_combined,2015/05/28,ccc_311_calgary_combined,5202,2931,0:08:31,511,,2271,1497741
2015-05-28-ccc_help_script,2015/05/28,ccc_help_script,14,10,0:00:12,12,,4,120
2015-05-28-ccc_priority_script,2015/05/28,ccc_priority_script,25,25,0:00:13,13,,0,325
2015-05-28-ccc_tax_script,2015/05/28,ccc_tax_script,24,16,0:07:12,432,,8,6912
2015-05-29-ccc_311_calgary_combined,2015/05/29,ccc_311_calgary_combined,5540,3514,0:07:43,463,,2026,1626982
2015-05-29-ccc_help_script,2015/05/29,ccc_help_script,6,6,0:00:14,14,,0,84
2015-05-29-ccc_priority_script,2015/05/29,ccc_priority_script,23,22,0:00:14,14,,1,308
2015-05-29-ccc_tax_script,2015/05/29,ccc_tax_script,17,12,0:09:21,561,,5,6732
2015-05-30-ccc_311_calgary_combined,2015/05/30,ccc_311_calgary_combined,1862,1787,0:00:24,24,,75,42888
2015-05-30-ccc_help_script,2015/05/30,ccc_help_script,2,2,0:00:10,10,,0,20
2015-05-30-ccc_priority_script,2015/05/30,ccc_priority_script,18,17,0:00:12,12,,1,204
2015-05-31-ccc_311_calgary_combined,2015/05/31,ccc_311_calgary_combined,1532,1436,0:00:43,43,,96,61748
2015-05-31-ccc_help_script,2015/05/31,ccc_help_script,3,3,0:00:04,4,,0,12
2015-05-31-ccc_priority_script,2015/05/31,ccc_priority_script,23,20,0:00:15,15,,3,300
2015-06-01-ccc_311_calgary_combined,2015/06/01,ccc_311_calgary_combined,6235,3974,0:07:01,421,,2261,1673054
2015-06-01-ccc_help_script,2015/06/01,ccc_help_script,5,4,0:00:03,3,,1,12
2015-06-01-ccc_priority_script,2015/06/01,ccc_priority_script,28,28,0:00:35,35,,0,980
2015-06-01-ccc_tax_script,2015/06/01,ccc_tax_script,18,11,0:11:14,674,,7,7414
2015-06-02-ccc_311_calgary_combined,2015/06/02,ccc_311_calgary_combined,5686,3342,0:08:35,515,,2344,1721130
2015-06-02-ccc_help_script,2015/06/02,ccc_help_script,25,21,0:00:20,20,,4,420
2015-06-02-ccc_priority_script,2015/06/02,ccc_priority_script,43,41,0:00:19,19,,2,779
2015-06-02-ccc_tax_script,2015/06/02,ccc_tax_script,16,7,0:09:40,580,,9,4060
2015-06-03-ccc_311_calgary_combined,2015/06/03,ccc_311_calgary_combined,5226,3269,0:07:54,474,,1957,1549506
2015-06-03-ccc_help_script,2015/06/03,ccc_help_script,7,5,0:00:28,28,,2,140
2015-06-03-ccc_priority_script,2015/06/03,ccc_priority_script,36,35,0:00:19,19,,1,665
2015-06-03-ccc_tax_script,2015/06/03,ccc_tax_script,19,12,0:08:28,508,,7,6096
2015-06-04-ccc_311_calgary_combined,2015/06/04,ccc_311_calgary_combined,5267,3397,0:07:08,428,,1870,1453916
2015-06-04-ccc_help_script,2015/06/04,ccc_help_script,14,13,0:00:13,13,,1,169
2015-06-04-ccc_priority_script,2015/06/04,ccc_priority_script,29,27,0:00:28,28,,2,756
2015-06-04-ccc_tax_script,2015/06/04,ccc_tax_script,24,17,0:08:27,507,,7,8619
2015-06-05-ccc_311_calgary_combined,2015/06/05,ccc_311_calgary_combined,4848,3505,0:05:27,327,,1343,1146135
2015-06-05-ccc_help_script,2015/06/05,ccc_help_script,6,5,0:00:11,11,,1,55
2015-06-05-ccc_priority_script,2015/06/05,ccc_priority_script,29,28,0:00:21,21,,1,588
2015-06-05-ccc_tax_script,2015/06/05,ccc_tax_script,31,16,0:06:53,413,,15,6608
2015-06-06-ccc_311_calgary_combined,2015/06/06,ccc_311_calgary_combined,1799,1608,0:01:17,77,,191,123816
2015-06-06-ccc_help_script,2015/06/06,ccc_help_script,1,1,0:00:21,21,,0,21
2015-06-06-ccc_priority_script,2015/06/06,ccc_priority_script,34,33,0:00:19,19,,1,627
2015-06-07-ccc_311_calgary_combined,2015/06/07,ccc_311_calgary_combined,1696,1486,0:01:26,86,,210,127796
2015-06-07-ccc_help_script,2015/06/07,ccc_help_script,3,3,0:00:23,23,,0,69
2015-06-07-ccc_priority_script,2015/06/07,ccc_priority_script,32,28,0:00:13,13,,4,364
2015-06-08-ccc_311_calgary_combined,2015/06/08,ccc_311_calgary_combined,6036,3822,0:07:24,444,,2214,1696968
2015-06-08-ccc_help_script,2015/06/08,ccc_help_script,16,14,0:00:20,20,,2,280
2015-06-08-ccc_priority_script,2015/06/08,ccc_priority_script,48,45,0:00:20,20,,3,900
2015-06-08-ccc_tax_script,2015/06/08,ccc_tax_script,25,14,0:08:26,506,,11,7084
2015-06-09-ccc_311_calgary_combined,2015/06/09,ccc_311_calgary_combined,5516,3473,0:07:28,448,,2043,1555904
2015-06-09-ccc_help_script,2015/06/09,ccc_help_script,12,12,0:00:10,10,,0,120
2015-06-09-ccc_priority_script,2015/06/09,ccc_priority_script,37,35,0:00:24,24,,2,840
2015-06-09-ccc_tax_script,2015/06/09,ccc_tax_script,27,13,0:07:47,467,,14,6071
2015-06-10-ccc_311_calgary_combined,2015/06/10,ccc_311_calgary_combined,5063,3525,0:06:17,377,,1538,1328925
2015-06-10-ccc_help_script,2015/06/10,ccc_help_script,13,12,0:00:13,13,,1,156
2015-06-10-ccc_priority_script,2015/06/10,ccc_priority_script,31,28,0:00:17,17,,3,476
2015-06-10-ccc_tax_script,2015/06/10,ccc_tax_script,17,11,0:08:41,521,,6,5731
2015-06-11-ccc_311_calgary_combined,2015/06/11,ccc_311_calgary_combined,5165,3090,0:08:12,492,,2075,1520280
2015-06-11-ccc_help_script,2015/06/11,ccc_help_script,15,14,0:00:22,22,,1,308
2015-06-11-ccc_priority_script,2015/06/11,ccc_priority_script,35,34,0:00:24,24,,1,816
2015-06-11-ccc_tax_script,2015/06/11,ccc_tax_script,32,20,0:09:56,596,,12,11920
2015-06-12-ccc_311_calgary_combined,2015/06/12,ccc_311_calgary_combined,4205,3120,0:05:40,340,,1085,1060800
2015-06-12-ccc_help_script,2015/06/12,ccc_help_script,4,3,0:00:06,6,,1,18
2015-06-12-ccc_priority_script,2015/06/12,ccc_priority_script,32,31,0:00:29,29,,1,899
2015-06-12-ccc_tax_script,2015/06/12,ccc_tax_script,21,14,0:06:47,407,,7,5698
2015-06-13-ccc_311_calgary_combined,2015/06/13,ccc_311_calgary_combined,1444,1366,0:00:38,38,,78,51908
2015-06-13-ccc_priority_script,2015/06/13,ccc_priority_script,27,27,0:00:10,10,,0,270
2015-06-14-ccc_311_calgary_combined,2015/06/14,ccc_311_calgary_combined,1155,1112,0:00:26,26,,43,28912
2015-06-14-ccc_priority_script,2015/06/14,ccc_priority_script,33,32,0:00:12,12,,1,384
2015-06-14-ccc_tax_script,2015/06/14,ccc_tax_script,1,1,0:00:04,4,,0,4
2015-06-15-ccc_311_calgary_combined,2015/06/15,ccc_311_calgary_combined,5280,3644,0:06:25,385,,1636,1402940
2015-06-15-ccc_help_script,2015/06/15,ccc_help_script,6,6,0:00:13,13,,0,78
2015-06-15-ccc_priority_script,2015/06/15,ccc_priority_script,33,32,0:00:23,23,,1,736
2015-06-15-ccc_tax_script,2015/06/15,ccc_tax_script,33,17,0:07:53,473,,16,8041
2015-06-16-ccc_311_calgary_combined,2015/06/16,ccc_311_calgary_combined,5129,3236,0:07:50,470,,1893,1520920
2015-06-16-ccc_help_script,2015/06/16,ccc_help_script,8,7,0:00:09,9,,1,63
2015-06-16-ccc_priority_script,2015/06/16,ccc_priority_script,35,31,0:00:14,14,,4,434
2015-06-16-ccc_tax_script,2015/06/16,ccc_tax_script,20,10,0:08:36,516,,10,5160
2015-06-17-ccc_311_calgary_combined,2015/06/17,ccc_311_calgary_combined,4615,3066,0:07:07,427,,1549,1309182
2015-06-17-ccc_help_script,2015/06/17,ccc_help_script,6,6,0:00:08,8,,0,48
2015-06-17-ccc_priority_script,2015/06/17,ccc_priority_script,29,29,0:00:13,13,,0,377
2015-06-17-ccc_tax_script,2015/06/17,ccc_tax_script,18,10,0:08:59,539,,8,5390
2015-06-18-ccc_311_calgary_combined,2015/06/18,ccc_311_calgary_combined,4524,3149,0:06:27,387,,1375,1218663
2015-06-18-ccc_help_script,2015/06/18,ccc_help_script,11,9,0:00:14,14,,2,126
2015-06-18-ccc_priority_script,2015/06/18,ccc_priority_script,34,30,0:00:18,18,,4,540
2015-06-18-ccc_tax_script,2015/06/18,ccc_tax_script,15,10,0:08:05,485,,5,4850
2015-06-19-ccc_311_calgary_combined,2015/06/19,ccc_311_calgary_combined,4321,3244,0:05:16,316,,1077,1025104
2015-06-19-ccc_help_script,2015/06/19,ccc_help_script,10,7,0:00:08,8,,3,56
2015-06-19-ccc_priority_script,2015/06/19,ccc_priority_script,42,40,0:00:21,21,,2,840
2015-06-19-ccc_tax_script,2015/06/19,ccc_tax_script,13,8,0:05:58,358,,5,2864
2015-06-20-ccc_311_calgary_combined,2015/06/20,ccc_311_calgary_combined,1438,1389,0:00:22,22,,49,30558
2015-06-20-ccc_help_script,2015/06/20,ccc_help_script,1,1,0:00:04,4,,0,4
2015-06-20-ccc_priority_script,2015/06/20,ccc_priority_script,32,32,0:00:15,15,,0,480
2015-06-21-ccc_311_calgary_combined,2015/06/21,ccc_311_calgary_combined,1072,1044,0:00:16,16,,28,16704
2015-06-21-ccc_help_script,2015/06/21,ccc_help_script,3,3,0:00:05,5,,0,15
2015-06-21-ccc_priority_script,2015/06/21,ccc_priority_script,28,28,0:00:09,9,,0,252
2015-06-22-ccc_311_calgary_combined,2015/06/22,ccc_311_calgary_combined,5729,3651,0:06:03,363,,1932,1325313
2015-06-22-ccc_help_script,2015/06/22,ccc_help_script,12,9,0:00:11,11,,3,99
2015-06-22-ccc_priority_script,2015/06/22,ccc_priority_script,30,26,0:00:15,15,,4,390
2015-06-22-ccc_tax_script,2015/06/22,ccc_tax_script,18,11,0:08:10,490,,7,5390
2015-06-23-ccc_311_calgary_combined,2015/06/23,ccc_311_calgary_combined,5241,3130,0:08:42,522,,2111,1633860
2015-06-23-ccc_help_script,2015/06/23,ccc_help_script,17,16,0:00:16,16,,1,256
2015-06-23-ccc_priority_script,2015/06/23,ccc_priority_script,39,38,0:00:23,23,,1,874
2015-06-23-ccc_tax_script,2015/06/23,ccc_tax_script,31,17,0:09:48,588,,14,9996
2015-06-24-ccc_311_calgary_combined,2015/06/24,ccc_311_calgary_combined,5274,3380,0:07:23,443,,1894,1497340
2015-06-24-ccc_help_script,2015/06/24,ccc_help_script,8,7,0:00:16,16,,1,112
2015-06-24-ccc_priority_script,2015/06/24,ccc_priority_script,24,24,0:00:13,13,,0,312
2015-06-24-ccc_tax_script,2015/06/24,ccc_tax_script,19,15,0:08:03,483,,4,7245
2015-06-25-ccc_311_calgary_combined,2015/06/25,ccc_311_calgary_combined,5039,3447,0:07:05,425,,1592,1464975
2015-06-25-ccc_help_script,2015/06/25,ccc_help_script,8,7,0:00:13,13,,1,91
2015-06-25-ccc_priority_script,2015/06/25,ccc_priority_script,32,32,0:00:18,18,,0,576
2015-06-25-ccc_tax_script,2015/06/25,ccc_tax_script,17,9,0:07:47,467,,8,4203
2015-06-26-ccc_311_calgary_combined,2015/06/26,ccc_311_calgary_combined,4435,3480,0:04:32,272,,952,946560
2015-06-26-ccc_help_script,2015/06/26,ccc_help_script,3,3,0:00:07,7,,0,21
2015-06-26-ccc_priority_script,2015/06/26,ccc_priority_script,33,32,0:00:24,24,,1,768
2015-06-26-ccc_tax_script,2015/06/26,ccc_tax_script,17,13,0:04:40,280,,4,3640
2015-06-27-ccc_311_calgary_combined,2015/06/27,ccc_311_calgary_combined,1855,1673,0:01:17,77,,180,128821
2015-06-27-ccc_help_script,2015/06/27,ccc_help_script,1,1,0:02:01,121,,0,121
2015-06-27-ccc_priority_script,2015/06/27,ccc_priority_script,29,28,0:00:16,16,,1,448
2015-06-28-ccc_311_calgary_combined,2015/06/28,ccc_311_calgary_combined,1526,1349,0:01:27,87,,182,117363
2015-06-28-ccc_help_script,2015/06/28,ccc_help_script,1,1,0:00:02,2,,0,2
2015-06-28-ccc_priority_script,2015/06/28,ccc_priority_script,32,30,0:00:26,26,,2,780
2015-06-28-ccc_tax_script,2015/06/28,ccc_tax_script,2,1,0:00:03,3,,1,3
2015-06-29-ccc_311_calgary_combined,2015/06/29,ccc_311_calgary_combined,6005,4219,0:06:37,397,,1786,1674943
2015-06-29-ccc_help_script,2015/06/29,ccc_help_script,9,9,0:00:17,17,,0,153
2015-06-29-ccc_priority_script,2015/06/29,ccc_priority_script,40,40,0:00:21,21,,0,840
2015-06-29-ccc_tax_script,2015/06/29,ccc_tax_script,21,15,0:06:23,383,,6,5745
2015-06-30-ccc_311_calgary_combined,2015/06/30,ccc_311_calgary_combined,6559,4734,0:05:25,325,,1822,1538550
2015-06-30-ccc_help_script,2015/06/30,ccc_help_script,15,11,0:00:12,12,,4,132
2015-06-30-ccc_priority_script,2015/06/30,ccc_priority_script,46,45,0:00:15,15,,1,675
2015-06-30-ccc_tax_script,2015/06/30,ccc_tax_script,16,11,0:04:49,289,,5,3179
2015-07-01-ccc_311_calgary_combined,2015/07/01,ccc_311_calgary_combined,2115,1991,0:00:38,38,,127,75658
2015-07-01-ccc_help_script,2015/07/01,ccc_help_script,3,3,0:00:32,32,,0,96
2015-07-01-ccc_priority_script,2015/07/01,ccc_priority_script,36,32,0:00:13,13,,4,416
2015-07-02-ccc_311_calgary_combined,2015/07/02,ccc_311_calgary_combined,4857,3538,0:05:44,344,,1319,1217072
2015-07-02-ccc_help_script,2015/07/02,ccc_help_script,17,16,0:00:12,12,,1,192
2015-07-02-ccc_priority_script,2015/07/02,ccc_priority_script,58,54,0:00:29,29,,4,1566
2015-07-02-ccc_tax_script,2015/07/02,ccc_tax_script,19,11,0:06:15,375,,8,4125
2015-07-03-ccc_311_calgary_combined,2015/07/03,ccc_311_calgary_combined,3871,3233,0:02:56,176,,638,569008
2015-07-03-ccc_help_script,2015/07/03,ccc_help_script,6,6,0:00:17,17,,0,102
2015-07-03-ccc_priority_script,2015/07/03,ccc_priority_script,38,37,0:00:29,29,,1,1073
2015-07-03-ccc_tax_script,2015/07/03,ccc_tax_script,9,7,0:03:56,236,,2,1652
2015-07-04-ccc_311_calgary_combined,2015/07/04,ccc_311_calgary_combined,1732,1457,0:01:52,112,,275,163184
2015-07-04-ccc_help_script,2015/07/04,ccc_help_script,2,2,0:00:46,46,,0,92
2015-07-04-ccc_priority_script,2015/07/04,ccc_priority_script,69,68,0:00:25,25,,1,1700
2015-07-05-ccc_311_calgary_combined,2015/07/05,ccc_311_calgary_combined,1272,1215,0:00:35,35,,57,42525
2015-07-05-ccc_help_script,2015/07/05,ccc_help_script,1,1,0:00:04,4,,0,4
2015-07-05-ccc_priority_script,2015/07/05,ccc_priority_script,27,25,0:00:17,17,,2,425
2015-07-06-ccc_311_calgary_combined,2015/07/06,ccc_311_calgary_combined,5047,3050,0:08:13,493,,1998,1503650
2015-07-06-ccc_help_script,2015/07/06,ccc_help_script,18,16,0:00:22,22,,2,352
2015-07-06-ccc_priority_script,2015/07/06,ccc_priority_script,28,27,0:00:18,18,,1,486
2015-07-06-ccc_tax_script,2015/07/06,ccc_tax_script,13,8,0:09:12,552,,5,4416
2015-07-07-ccc_311_calgary_combined,2015/07/07,ccc_311_calgary_combined,4726,3042,0:07:31,451,,1683,1371942
2015-07-07-ccc_help_script,2015/07/07,ccc_help_script,13,10,0:00:13,13,,3,130
2015-07-07-ccc_priority_script,2015/07/07,ccc_priority_script,44,44,0:00:22,22,,0,968
2015-07-07-ccc_tax_script,2015/07/07,ccc_tax_script,13,10,0:08:15,495,,3,4950
2015-07-08-ccc_311_calgary_combined,2015/07/08,ccc_311_calgary_combined,4765,3123,0:06:38,398,,1641,1242954
2015-07-08-ccc_help_script,2015/07/08,ccc_help_script,20,16,0:00:19,19,,4,304
2015-07-08-ccc_priority_script,2015/07/08,ccc_priority_script,50,47,0:00:28,28,,3,1316
2015-07-08-ccc_tax_script,2015/07/08,ccc_tax_script,18,15,0:06:04,364,,3,5460
2015-07-09-ccc_311_calgary_combined,2015/07/09,ccc_311_calgary_combined,4156,3035,0:05:21,321,,1121,974235
2015-07-09-ccc_help_script,2015/07/09,ccc_help_script,9,7,0:00:21,21,,2,147
2015-07-09-ccc_priority_script,2015/07/09,ccc_priority_script,36,35,0:00:23,23,,1,805
2015-07-09-ccc_tax_script,2015/07/09,ccc_tax_script,16,13,0:05:52,352,,3,4576
2015-07-10-ccc_311_calgary_combined,2015/07/10,ccc_311_calgary_combined,3802,3015,0:03:51,231,,786,696465
2015-07-10-ccc_help_script,2015/07/10,ccc_help_script,12,10,0:00:29,29,,2,290
2015-07-10-ccc_priority_script,2015/07/10,ccc_priority_script,43,40,0:00:21,21,,3,840
2015-07-10-ccc_tax_script,2015/07/10,ccc_tax_script,16,9,0:02:27,147,,7,1323
2015-07-11-ccc_311_calgary_combined,2015/07/11,ccc_311_calgary_combined,1705,1485,0:01:13,73,,219,108405
2015-07-11-ccc_help_script,2015/07/11,ccc_help_script,4,3,0:00:23,23,,1,69
2015-07-11-ccc_priority_script,2015/07/11,ccc_priority_script,58,53,0:00:28,28,,5,1484
2015-07-12-ccc_311_calgary_combined,2015/07/12,ccc_311_calgary_combined,1639,1340,0:01:43,103,,300,138020
2015-07-12-ccc_help_script,2015/07/12,ccc_help_script,4,2,0:00:04,4,,2,8
2015-07-12-ccc_priority_script,2015/07/12,ccc_priority_script,56,51,0:00:31,31,,5,1581
2015-07-13-ccc_311_calgary_combined,2015/07/13,ccc_311_calgary_combined,4790,3068,0:07:13,433,,1722,1328444
2015-07-13-ccc_help_script,2015/07/13,ccc_help_script,9,9,0:00:21,21,,0,189
2015-07-13-ccc_priority_script,2015/07/13,ccc_priority_script,39,37,0:00:27,27,,2,999
2015-07-13-ccc_tax_script,2015/07/13,ccc_tax_script,22,15,0:07:02,422,,7,6330
2015-07-14-ccc_311_calgary_combined,2015/07/14,ccc_311_calgary_combined,4430,2864,0:07:22,442,,1565,1265888
2015-07-14-ccc_help_script,2015/07/14,ccc_help_script,14,10,0:00:12,12,,4,120
2015-07-14-ccc_priority_script,2015/07/14,ccc_priority_script,51,51,0:00:26,26,,0,1326
2015-07-14-ccc_tax_script,2015/07/14,ccc_tax_script,20,11,0:08:02,482,,9,5302
2015-07-15-ccc_311_calgary_combined,2015/07/15,ccc_311_calgary_combined,4242,2841,0:06:34,394,,1400,1119354
2015-07-15-ccc_help_script,2015/07/15,ccc_help_script,13,11,0:00:17,17,,2,187
2015-07-15-ccc_priority_script,2015/07/15,ccc_priority_script,21,20,0:00:20,20,,1,400
2015-07-15-ccc_tax_script,2015/07/15,ccc_tax_script,26,15,0:06:00,360,,11,5400
2015-07-16-ccc_311_calgary_combined,2015/07/16,ccc_311_calgary_combined,3601,2827,0:03:27,207,,774,585189
2015-07-16-ccc_help_script,2015/07/16,ccc_help_script,14,13,0:00:09,9,,1,117
2015-07-16-ccc_priority_script,2015/07/16,ccc_priority_script,27,27,0:00:17,17,,0,459
2015-07-16-ccc_tax_script,2015/07/16,ccc_tax_script,12,8,0:03:42,222,,4,1776
2015-07-17-ccc_311_calgary_combined,2015/07/17,ccc_311_calgary_combined,3510,2528,0:04:41,281,,981,710368
2015-07-17-ccc_help_script,2015/07/17,ccc_help_script,9,7,0:00:43,43,,2,301
2015-07-17-ccc_priority_script,2015/07/17,ccc_priority_script,54,54,0:00:28,28,,0,1512
2015-07-17-ccc_tax_script,2015/07/17,ccc_tax_script,18,14,0:03:35,215,,4,3010
2015-07-18-ccc_311_calgary_combined,2015/07/18,ccc_311_calgary_combined,1525,1402,0:00:51,51,,123,71502
2015-07-18-ccc_help_script,2015/07/18,ccc_help_script,5,5,0:00:18,18,,0,90
2015-07-18-ccc_priority_script,2015/07/18,ccc_priority_script,28,28,0:00:15,15,,0,420
2015-07-18-ccc_tax_script,2015/07/18,ccc_tax_script,1,1,0:00:09,9,,0,9
2015-07-19-ccc_311_calgary_combined,2015/07/19,ccc_311_calgary_combined,1230,1172,0:00:30,30,,58,35160
2015-07-19-ccc_help_script,2015/07/19,ccc_help_script,1,1,0:00:22,22,,0,22
2015-07-19-ccc_priority_script,2015/07/19,ccc_priority_script,27,27,0:00:28,28,,0,756
2015-07-19-ccc_tax_script,2015/07/19,ccc_tax_script,4,4,0:03:26,206,,0,824
2015-07-20-ccc_311_calgary_combined,2015/07/20,ccc_311_calgary_combined,4682,3038,0:07:25,445,,1641,1351910
2015-07-20-ccc_help_script,2015/07/20,ccc_help_script,15,15,0:00:12,12,,0,180
2015-07-20-ccc_priority_script,2015/07/20,ccc_priority_script,30,28,0:00:15,15,,2,420
2015-07-20-ccc_tax_script,2015/07/20,ccc_tax_script,16,11,0:08:00,480,,5,5280
2015-07-21-ccc_311_calgary_combined,2015/07/21,ccc_311_calgary_combined,4620,3053,0:06:19,379,,1567,1157087
2015-07-21-ccc_help_script,2015/07/21,ccc_help_script,22,22,0:00:17,17,,0,374
2015-07-21-ccc_priority_script,2015/07/21,ccc_priority_script,30,26,0:00:26,26,,4,676
2015-07-21-ccc_tax_script,2015/07/21,ccc_tax_script,22,16,0:04:39,279,,6,4464
2015-07-22-ccc_311_calgary_combined,2015/07/22,ccc_311_calgary_combined,4301,2916,0:06:18,378,,1384,1102248
2015-07-22-ccc_help_script,2015/07/22,ccc_help_script,11,10,0:00:21,21,,1,210
2015-07-22-ccc_priority_script,2015/07/22,ccc_priority_script,35,32,0:00:45,45,,3,1440
2015-07-22-ccc_tax_script,2015/07/22,ccc_tax_script,14,13,0:07:57,477,,1,6201
2015-07-23-ccc_311_calgary_combined,2015/07/23,ccc_311_calgary_combined,4014,2821,0:05:28,328,,1193,925288
2015-07-23-ccc_help_script,2015/07/23,ccc_help_script,17,15,0:00:15,15,,2,225
2015-07-23-ccc_priority_script,2015/07/23,ccc_priority_script,26,24,0:00:33,33,,2,792
2015-07-23-ccc_tax_script,2015/07/23,ccc_tax_script,11,4,0:01:50,110,,7,440
2015-07-24-ccc_311_calgary_combined,2015/07/24,ccc_311_calgary_combined,4153,2572,0:08:16,496,,1581,1275712
2015-07-24-ccc_help_script,2015/07/24,ccc_help_script,9,8,0:00:24,24,,1,192
2015-07-24-ccc_priority_script,2015/07/24,ccc_priority_script,36,34,0:00:23,23,,2,782
2015-07-24-ccc_tax_script,2015/07/24,ccc_tax_script,18,8,0:08:57,537,,10,4296
2015-07-25-ccc_311_calgary_combined,2015/07/25,ccc_311_calgary_combined,1397,1301,0:00:40,40,,96,52040
2015-07-25-ccc_priority_script,2015/07/25,ccc_priority_script,27,27,0:00:20,20,,0,540
2015-07-25-ccc_tax_script,2015/07/25,ccc_tax_script,2,2,0:01:37,97,,0,194
2015-07-26-ccc_311_calgary_combined,2015/07/26,ccc_311_calgary_combined,1202,1063,0:01:09,69,,139,73347
2015-07-26-ccc_help_script,2015/07/26,ccc_help_script,3,2,0:00:54,54,,1,108
2015-07-26-ccc_priority_script,2015/07/26,ccc_priority_script,26,24,0:00:16,16,,2,384
2015-07-27-ccc_311_calgary_combined,2015/07/27,ccc_311_calgary_combined,4578,3367,0:05:13,313,,1210,1053871
2015-07-27-ccc_help_script,2015/07/27,ccc_help_script,10,10,0:00:46,46,,0,460
2015-07-27-ccc_priority_script,2015/07/27,ccc_priority_script,25,23,0:00:14,14,,2,322
2015-07-27-ccc_tax_script,2015/07/27,ccc_tax_script,10,9,0:06:47,407,,1,3663
2015-07-28-ccc_311_calgary_combined,2015/07/28,ccc_311_calgary_combined,4153,3305,0:03:34,214,,848,707270
2015-07-28-ccc_help_script,2015/07/28,ccc_help_script,16,16,0:00:43,43,,0,688
2015-07-28-ccc_priority_script,2015/07/28,ccc_priority_script,36,33,0:00:24,24,,3,792
2015-07-28-ccc_tax_script,2015/07/28,ccc_tax_script,15,12,0:04:59,299,,3,3588
2015-07-29-ccc_311_calgary_combined,2015/07/29,ccc_311_calgary_combined,4060,2843,0:05:30,330,,1197,938190
2015-07-29-ccc_help_script,2015/07/29,ccc_help_script,6,5,0:00:13,13,,1,65
2015-07-29-ccc_priority_script,2015/07/29,ccc_priority_script,48,41,0:00:19,19,,7,779
2015-07-29-ccc_tax_script,2015/07/29,ccc_tax_script,11,7,0:05:39,339,,4,2373
2015-07-30-ccc_311_calgary_combined,2015/07/30,ccc_311_calgary_combined,4080,2884,0:05:20,320,,1193,922880
2015-07-30-ccc_help_script,2015/07/30,ccc_help_script,18,17,0:00:19,19,,1,323
2015-07-30-ccc_priority_script,2015/07/30,ccc_priority_script,43,40,0:00:21,21,,3,840
2015-07-30-ccc_tax_script,2015/07/30,ccc_tax_script,17,12,0:07:11,431,,5,5172
2015-07-31-ccc_311_calgary_combined,2015/07/31,ccc_311_calgary_combined,3701,2890,0:03:34,214,,808,618460
2015-07-31-ccc_help_script,2015/07/31,ccc_help_script,9,7,0:00:09,9,,2,63
2015-07-31-ccc_priority_script,2015/07/31,ccc_priority_script,19,17,0:00:15,15,,2,255
2015-07-31-ccc_tax_script,2015/07/31,ccc_tax_script,18,15,0:03:41,221,,3,3315
2015-08-01-ccc_311_calgary_combined,2015/08/01,ccc_311_calgary_combined,1433,1359,0:00:36,36,,74,48924
2015-08-01-ccc_priority_script,2015/08/01,ccc_priority_script,31,31,0:00:19,19,,0,589
2015-08-02-ccc_311_calgary_combined,2015/08/02,ccc_311_calgary_combined,1213,1122,0:00:39,39,,91,43758
2015-08-02-ccc_help_script,2015/08/02,ccc_help_script,4,4,0:00:27,27,,0,108
2015-08-02-ccc_priority_script,2015/08/02,ccc_priority_script,26,26,0:00:33,33,,0,858
2015-08-03-ccc_311_calgary_combined,2015/08/03,ccc_311_calgary_combined,1486,1419,0:00:30,30,,67,42570
2015-08-03-ccc_help_script,2015/08/03,ccc_help_script,1,1,0:00:46,46,,0,46
2015-08-03-ccc_priority_script,2015/08/03,ccc_priority_script,18,18,0:00:17,17,,0,306
2015-08-04-ccc_311_calgary_combined,2015/08/04,ccc_311_calgary_combined,5979,3439,0:06:38,398,,2540,1368722
2015-08-04-ccc_help_script,2015/08/04,ccc_help_script,21,17,0:00:15,15,,4,255
2015-08-04-ccc_priority_script,2015/08/04,ccc_priority_script,98,95,0:00:22,22,,3,2090
2015-08-04-ccc_tax_script,2015/08/04,ccc_tax_script,19,13,0:07:16,436,,6,5668
2015-08-05-ccc_311_calgary_combined,2015/08/05,ccc_311_calgary_combined,4427,3222,0:04:05,245,,1205,789390
2015-08-05-ccc_help_script,2015/08/05,ccc_help_script,20,20,0:00:13,13,,0,260
2015-08-05-ccc_priority_script,2015/08/05,ccc_priority_script,51,49,0:00:19,19,,2,931
2015-08-05-ccc_tax_script,2015/08/05,ccc_tax_script,24,19,0:04:51,291,,5,5529
2015-08-06-ccc_311_calgary_combined,2015/08/06,ccc_311_calgary_combined,4240,3231,0:03:46,226,,1009,730206
2015-08-06-ccc_help_script,2015/08/06,ccc_help_script,11,10,0:02:19,139,,1,1390
2015-08-06-ccc_priority_script,2015/08/06,ccc_priority_script,40,37,0:00:17,17,,3,629
2015-08-06-ccc_tax_script,2015/08/06,ccc_tax_script,12,10,0:05:12,312,,2,3120
2015-08-07-ccc_311_calgary_combined,2015/08/07,ccc_311_calgary_combined,3849,2949,0:03:44,224,,899,660576
2015-08-07-ccc_help_script,2015/08/07,ccc_help_script,4,4,0:00:06,6,,0,24
2015-08-07-ccc_priority_script,2015/08/07,ccc_priority_script,43,42,0:00:26,26,,1,1092
2015-08-07-ccc_tax_script,2015/08/07,ccc_tax_script,17,12,0:05:20,320,,5,3840
2015-08-08-ccc_311_calgary_combined,2015/08/08,ccc_311_calgary_combined,1653,1368,0:02:03,123,,285,168264
2015-08-08-ccc_help_script,2015/08/08,ccc_help_script,4,3,0:00:18,18,,1,54
2015-08-08-ccc_priority_script,2015/08/08,ccc_priority_script,30,30,0:00:34,34,,0,1020
2015-08-09-ccc_311_calgary_combined,2015/08/09,ccc_311_calgary_combined,1290,1174,0:00:54,54,,115,63396
2015-08-09-ccc_help_script,2015/08/09,ccc_help_script,2,1,0:00:06,6,,1,6
2015-08-09-ccc_priority_script,2015/08/09,ccc_priority_script,36,34,0:00:14,14,,2,476
2015-08-10-ccc_311_calgary_combined,2015/08/10,ccc_311_calgary_combined,4621,3402,0:04:36,276,,1219,938952
2015-08-10-ccc_help_script,2015/08/10,ccc_help_script,9,8,0:00:11,11,,1,88
2015-08-10-ccc_priority_script,2015/08/10,ccc_priority_script,31,28,0:00:12,12,,3,336
2015-08-10-ccc_tax_script,2015/08/10,ccc_tax_script,20,15,0:04:25,265,,5,3975
2015-08-11-ccc_311_calgary_combined,2015/08/11,ccc_311_calgary_combined,4176,3340,0:03:22,202,,836,674680
2015-08-11-ccc_help_script,2015/08/11,ccc_help_script,11,11,0:00:13,13,,0,143
2015-08-11-ccc_priority_script,2015/08/11,ccc_priority_script,28,28,0:00:30,30,,0,840
2015-08-11-ccc_tax_script,2015/08/11,ccc_tax_script,11,11,0:03:30,210,,0,2310
2015-08-12-ccc_311_calgary_combined,2015/08/12,ccc_311_calgary_combined,4182,2978,0:04:54,294,,1204,875532
2015-08-12-ccc_help_script,2015/08/12,ccc_help_script,7,7,0:00:27,27,,0,189
2015-08-12-ccc_priority_script,2015/08/12,ccc_priority_script,24,23,0:00:15,15,,1,345
2015-08-12-ccc_tax_script,2015/08/12,ccc_tax_script,16,12,0:07:24,444,,4,5328
2015-08-13-ccc_311_calgary_combined,2015/08/13,ccc_311_calgary_combined,3994,3025,0:04:19,259,,969,783475
2015-08-13-ccc_help_script,2015/08/13,ccc_help_script,15,12,0:00:13,13,,3,156
2015-08-13-ccc_priority_script,2015/08/13,ccc_priority_script,35,32,0:00:19,19,,3,608
2015-08-13-ccc_tax_script,2015/08/13,ccc_tax_script,7,5,0:06:54,414,,2,2070
2015-08-14-ccc_311_calgary_combined,2015/08/14,ccc_311_calgary_combined,3910,2629,0:05:47,347,,1274,912263
2015-08-14-ccc_help_script,2015/08/14,ccc_help_script,12,10,0:00:22,22,,2,220
2015-08-14-ccc_priority_script,2015/08/14,ccc_priority_script,24,24,0:00:14,14,,0,336
2015-08-14-ccc_tax_script,2015/08/14,ccc_tax_script,13,11,0:06:02,362,,2,3982
2015-08-15-ccc_311_calgary_combined,2015/08/15,ccc_311_calgary_combined,1300,1206,0:00:45,45,,94,54270
2015-08-15-ccc_help_script,2015/08/15,ccc_help_script,1,1,0:00:02,2,,0,2
2015-08-15-ccc_priority_script,2015/08/15,ccc_priority_script,30,30,0:00:19,19,,0,570
2015-08-15-ccc_tax_script,2015/08/15,ccc_tax_script,2,1,0:00:05,5,,1,5
2015-08-16-ccc_311_calgary_combined,2015/08/16,ccc_311_calgary_combined,1142,1088,0:00:25,25,,54,27200
2015-08-16-ccc_help_script,2015/08/16,ccc_help_script,2,2,0:00:27,27,,0,54
2015-08-16-ccc_priority_script,2015/08/16,ccc_priority_script,21,21,0:00:06,6,,0,126
2015-08-17-ccc_311_calgary_combined,2015/08/17,ccc_311_calgary_combined,5011,3580,0:05:11,311,,1431,1113380
2015-08-17-ccc_help_script,2015/08/17,ccc_help_script,12,12,0:00:12,12,,0,144
2015-08-17-ccc_priority_script,2015/08/17,ccc_priority_script,42,41,0:00:12,12,,1,492
2015-08-17-ccc_tax_script,2015/08/17,ccc_tax_script,14,13,0:08:04,484,,1,6292
2015-08-18-ccc_311_calgary_combined,2015/08/18,ccc_311_calgary_combined,4203,3321,0:03:26,206,,882,684126
2015-08-18-ccc_help_script,2015/08/18,ccc_help_script,9,8,0:00:09,9,,1,72
2015-08-18-ccc_priority_script,2015/08/18,ccc_priority_script,31,30,0:00:20,20,,1,600
2015-08-18-ccc_tax_script,2015/08/18,ccc_tax_script,22,22,0:03:14,194,,0,4268
2015-08-19-ccc_311_calgary_combined,2015/08/19,ccc_311_calgary_combined,4035,3249,0:02:53,173,,786,562077
2015-08-19-ccc_help_script,2015/08/19,ccc_help_script,12,9,0:00:15,15,,3,135
2015-08-19-ccc_priority_script,2015/08/19,ccc_priority_script,39,38,0:00:23,23,,1,874
2015-08-19-ccc_tax_script,2015/08/19,ccc_tax_script,17,16,0:03:17,197,,1,3152
2015-08-20-ccc_311_calgary_combined,2015/08/20,ccc_311_calgary_combined,4009,3234,0:02:58,178,,775,575652
2015-08-20-ccc_help_script,2015/08/20,ccc_help_script,19,14,0:00:15,15,,5,210
2015-08-20-ccc_priority_script,2015/08/20,ccc_priority_script,39,33,0:00:13,13,,6,429
2015-08-20-ccc_tax_script,2015/08/20,ccc_tax_script,17,14,0:02:51,171,,3,2394
2015-08-21-ccc_311_calgary_combined,2015/08/21,ccc_311_calgary_combined,3276,2798,0:01:59,119,,478,332962
2015-08-21-ccc_help_script,2015/08/21,ccc_help_script,9,7,0:00:22,22,,2,154
2015-08-21-ccc_priority_script,2015/08/21,ccc_priority_script,38,37,0:00:15,15,,1,555
2015-08-21-ccc_tax_script,2015/08/21,ccc_tax_script,15,11,0:01:16,76,,4,836
2015-08-22-ccc_311_calgary_combined,2015/08/22,ccc_311_calgary_combined,1505,1357,0:01:02,62,,148,84134
2015-08-22-ccc_help_script,2015/08/22,ccc_help_script,1,0,0:00:00,0,,1,0
2015-08-22-ccc_priority_script,2015/08/22,ccc_priority_script,25,24,0:00:22,22,,1,528
2015-08-23-ccc_311_calgary_combined,2015/08/23,ccc_311_calgary_combined,1157,1133,0:00:14,14,,24,15862
2015-08-23-ccc_help_script,2015/08/23,ccc_help_script,3,3,0:00:07,7,,0,21
2015-08-23-ccc_priority_script,2015/08/23,ccc_priority_script,20,19,0:00:05,5,,1,95
2015-08-24-ccc_311_calgary_combined,2015/08/24,ccc_311_calgary_combined,4052,3671,0:01:15,75,,381,275325
2015-08-24-ccc_help_script,2015/08/24,ccc_help_script,7,7,0:00:11,11,,0,77
2015-08-24-ccc_priority_script,2015/08/24,ccc_priority_script,37,34,0:00:12,12,,3,408
2015-08-24-ccc_tax_script,2015/08/24,ccc_tax_script,18,17,0:01:16,76,,1,1292
2015-08-25-ccc_311_calgary_combined,2015/08/25,ccc_311_calgary_combined,4126,3278,0:03:07,187,,848,612986
2015-08-25-ccc_help_script,2015/08/25,ccc_help_script,10,10,0:00:10,10,,0,100
2015-08-25-ccc_priority_script,2015/08/25,ccc_priority_script,32,28,0:00:14,14,,4,392
2015-08-25-ccc_tax_script,2015/08/25,ccc_tax_script,15,9,0:03:07,187,,6,1683
2015-08-26-ccc_311_calgary_combined,2015/08/26,ccc_311_calgary_combined,3775,3101,0:02:42,162,,674,502362
2015-08-26-ccc_help_script,2015/08/26,ccc_help_script,8,8,0:00:11,11,,0,88
2015-08-26-ccc_priority_script,2015/08/26,ccc_priority_script,35,31,0:00:19,19,,4,589
2015-08-26-ccc_tax_script,2015/08/26,ccc_tax_script,10,10,0:01:52,112,,0,1120
2015-08-27-ccc_311_calgary_combined,2015/08/27,ccc_311_calgary_combined,3775,3377,0:01:22,82,,398,276914
2015-08-27-ccc_help_script,2015/08/27,ccc_help_script,12,11,0:00:09,9,,1,99
2015-08-27-ccc_priority_script,2015/08/27,ccc_priority_script,28,26,0:00:13,13,,2,338
2015-08-27-ccc_tax_script,2015/08/27,ccc_tax_script,13,12,0:01:21,81,,1,972
2015-08-28-ccc_311_calgary_combined,2015/08/28,ccc_311_calgary_combined,3649,3159,0:02:03,123,,490,388557
2015-08-28-ccc_help_script,2015/08/28,ccc_help_script,5,5,0:00:13,13,,0,65
2015-08-28-ccc_priority_script,2015/08/28,ccc_priority_script,31,28,0:01:48,108,,3,3024
2015-08-28-ccc_tax_script,2015/08/28,ccc_tax_script,19,13,0:03:03,183,,6,2379
2015-08-29-ccc_311_calgary_combined,2015/08/29,ccc_311_calgary_combined,1777,1456,0:01:57,117,,321,170352
2015-08-29-ccc_help_script,2015/08/29,ccc_help_script,1,1,0:00:05,5,,0,5
2015-08-29-ccc_priority_script,2015/08/29,ccc_priority_script,38,35,0:00:31,31,,3,1085
2015-08-30-ccc_311_calgary_combined,2015/08/30,ccc_311_calgary_combined,1369,1285,0:00:44,44,,83,56540
2015-08-30-ccc_help_script,2015/08/30,ccc_help_script,8,8,0:00:11,11,,0,88
2015-08-30-ccc_priority_script,2015/08/30,ccc_priority_script,18,18,0:00:10,10,,0,180
2015-08-31-ccc_311_calgary_combined,2015/08/31,ccc_311_calgary_combined,4224,3820,0:01:20,80,,403,305600
2015-08-31-ccc_help_script,2015/08/31,ccc_help_script,13,12,0:00:11,11,,1,132
2015-08-31-ccc_priority_script,2015/08/31,ccc_priority_script,16,16,0:00:10,10,,0,160
2015-08-31-ccc_tax_script,2015/08/31,ccc_tax_script,15,14,0:01:31,91,,1,1274
2015-09-01-ccc_311_calgary_combined,2015/09/01,ccc_311_calgary_combined,4223,3516,0:02:41,161,,704,566076
2015-09-01-ccc_help_script,2015/09/01,ccc_help_script,12,11,0:00:16,16,,1,176
2015-09-01-ccc_priority_script,2015/09/01,ccc_priority_script,37,36,0:00:12,12,,1,432
2015-09-01-ccc_tax_script,2015/09/01,ccc_tax_script,13,11,0:03:19,199,,2,2189
2015-09-02-ccc_311_calgary_combined,2015/09/02,ccc_311_calgary_combined,4257,3253,0:04:17,257,,1002,836021
2015-09-02-ccc_help_script,2015/09/02,ccc_help_script,25,19,0:00:13,13,,6,247
2015-09-02-ccc_priority_script,2015/09/02,ccc_priority_script,37,37,0:00:15,15,,0,555
2015-09-02-ccc_tax_script,2015/09/02,ccc_tax_script,17,17,0:06:09,369,,0,6273
2015-09-03-ccc_311_calgary_combined,2015/09/03,ccc_311_calgary_combined,3838,3227,0:02:41,161,,610,519547
2015-09-03-ccc_help_script,2015/09/03,ccc_help_script,14,11,0:00:08,8,,3,88
2015-09-03-ccc_priority_script,2015/09/03,ccc_priority_script,44,42,0:00:14,14,,2,588
2015-09-03-ccc_tax_script,2015/09/03,ccc_tax_script,19,17,0:03:35,215,,2,3655
2015-09-04-ccc_311_calgary_combined,2015/09/04,ccc_311_calgary_combined,3256,2971,0:01:10,70,,285,207970
2015-09-04-ccc_help_script,2015/09/04,ccc_help_script,17,12,0:00:24,24,,5,288
2015-09-04-ccc_priority_script,2015/09/04,ccc_priority_script,22,22,0:00:28,28,,0,616
2015-09-04-ccc_tax_script,2015/09/04,ccc_tax_script,14,13,0:01:17,77,,1,1001
2015-09-05-ccc_311_calgary_combined,2015/09/05,ccc_311_calgary_combined,1143,1097,0:00:17,17,,46,18649
2015-09-05-ccc_help_script,2015/09/05,ccc_help_script,1,0,0:00:00,0,,0,0
2015-09-05-ccc_priority_script,2015/09/05,ccc_priority_script,26,25,0:00:07,7,,1,175
2015-09-06-ccc_311_calgary_combined,2015/09/06,ccc_311_calgary_combined,1038,973,0:00:31,31,,65,30163
2015-09-06-ccc_help_script,2015/09/06,ccc_help_script,5,5,0:00:07,7,,0,35
2015-09-06-ccc_priority_script,2015/09/06,ccc_priority_script,20,20,0:00:15,15,,0,300
2015-09-06-ccc_tax_script,2015/09/06,ccc_tax_script,1,1,0:00:03,3,,0,3
2015-09-07-ccc_311_calgary_combined,2015/09/07,ccc_311_calgary_combined,1347,1308,0:00:20,20,,39,26160
2015-09-07-ccc_help_script,2015/09/07,ccc_help_script,4,4,0:00:03,3,,0,12
2015-09-07-ccc_priority_script,2015/09/07,ccc_priority_script,20,20,0:00:27,27,,0,540
2015-09-07-ccc_tax_script,2015/09/07,ccc_tax_script,1,1,0:00:02,2,,0,2
2015-09-08-ccc_311_calgary_combined,2015/09/08,ccc_311_calgary_combined,4610,3441,0:04:18,258,,1168,887778
2015-09-08-ccc_help_script,2015/09/08,ccc_help_script,10,7,0:00:13,13,,3,91
2015-09-08-ccc_priority_script,2015/09/08,ccc_priority_script,26,25,0:00:18,18,,1,450
2015-09-08-ccc_tax_script,2015/09/08,ccc_tax_script,15,12,0:02:47,167,,3,2004
2015-09-09-ccc_311_calgary_combined,2015/09/09,ccc_311_calgary_combined,3797,3406,0:01:27,87,,391,296322
2015-09-09-ccc_help_script,2015/09/09,ccc_help_script,11,10,0:00:13,13,,1,130
2015-09-09-ccc_priority_script,2015/09/09,ccc_priority_script,29,29,0:00:14,14,,0,406
2015-09-09-ccc_tax_script,2015/09/09,ccc_tax_script,9,8,0:01:21,81,,1,648
2015-09-10-ccc_311_calgary_combined,2015/09/10,ccc_311_calgary_combined,3915,3126,0:03:15,195,,788,609570
2015-09-10-ccc_help_script,2015/09/10,ccc_help_script,15,13,0:01:24,84,,2,1092
2015-09-10-ccc_priority_script,2015/09/10,ccc_priority_script,41,40,0:00:26,26,,1,1040
2015-09-10-ccc_tax_script,2015/09/10,ccc_tax_script,16,14,0:03:56,236,,2,3304
2015-09-11-ccc_311_calgary_combined,2015/09/11,ccc_311_calgary_combined,3729,3158,0:02:17,137,,571,432646
2015-09-11-ccc_help_script,2015/09/11,ccc_help_script,8,5,0:00:17,17,,3,85
2015-09-11-ccc_priority_script,2015/09/11,ccc_priority_script,24,23,0:00:14,14,,1,322
2015-09-11-ccc_tax_script,2015/09/11,ccc_tax_script,10,6,0:02:45,165,,4,990
2015-09-12-ccc_311_calgary_combined,2015/09/12,ccc_311_calgary_combined,1689,1329,0:02:16,136,,360,180744
2015-09-12-ccc_priority_script,2015/09/12,ccc_priority_script,35,30,0:00:43,43,,5,1290
2015-09-12-ccc_tax_script,2015/09/12,ccc_tax_script,1,1,0:00:04,4,,0,4
2015-09-13-ccc_311_calgary_combined,2015/09/13,ccc_311_calgary_combined,1114,1058,0:00:29,29,,56,30682
2015-09-13-ccc_priority_script,2015/09/13,ccc_priority_script,19,18,0:00:16,16,,1,288
2015-09-14-ccc_311_calgary_script,2015/09/14,ccc_311_calgary_script,3663,3392,0:01:01,61,0:09:15,271,206912
2015-09-14-ccc_311_lobby_ph_script,2015/09/14,ccc_311_lobby_ph_script,1,1,0:00:12,12,0:00:12,0,12
2015-09-14-ccc_aserv_info_script,2015/09/14,ccc_aserv_info_script,0,0,0:00:00,0,0:00:00,0,0
2015-09-14-ccc_bylaw_script,2015/09/14,ccc_bylaw_script,0,0,0:00:00,0,0:00:00,0,0
2015-09-14-ccc_city_script,2015/09/14,ccc_city_script,19,19,0:00:11,11,0:01:08,0,209
2015-09-14-ccc_cty_online_script,2015/09/14,ccc_cty_online_script,0,0,0:00:00,0,0:00:00,0,0
2015-09-14-ccc_feedback_script,2015/09/14,ccc_feedback_script,1,0,0:00:00,0,0:00:00,0,0
2015-09-14-ccc_fpb_script,2015/09/14,ccc_fpb_script,0,0,0:00:00,0,0:00:00,0,0
2015-09-14-ccc_help_script,2015/09/14,ccc_help_script,3,3,0:00:04,4,0:00:05,0,12
2015-09-14-ccc_link_script,2015/09/14,ccc_link_script,0,0,0:00:00,0,0:00:00,0,0
2015-09-14-ccc_media_line_script,2015/09/14,ccc_media_line_script,2,2,0:00:09,9,0:00:14,0,18
2015-09-14-ccc_priority_script,2015/09/14,ccc_priority_script,30,30,0:00:14,14,0:00:54,0,420
2015-09-14-ccc_tax_script,2015/09/14,ccc_tax_script,12,10,0:00:44,44,0:03:33,2,440
2015-09-14-ccc_waste_recycling_script,2015/09/14,ccc_waste_recycling_script,0,0,0:00:00,0,0:00:00,0,0
2015-09-15-ccc_311_calgary_script,2015/09/15,ccc_311_calgary_script,3777,3124,0:02:37,157,0:16:19,653,490468
2015-09-15-ccc_311_lobby_ph_script,2015/09/15,ccc_311_lobby_ph_script,3,3,0:00:19,19,0:00:47,0,57
2015-09-15-ccc_aserv_info_script,2015/09/15,ccc_aserv_info_script,0,0,0:00:00,0,0:00:00,0,0
2015-09-15-ccc_bylaw_script,2015/09/15,ccc_bylaw_script,0,0,0:00:00,0,0:00:00,0,0
2015-09-15-ccc_city_script,2015/09/15,ccc_city_script,21,21,0:00:34,34,0:03:49,0,714
2015-09-15-ccc_cty_online_script,2015/09/15,ccc_cty_online_script,0,0,0:00:00,0,0:00:00,0,0
2015-09-15-ccc_feedback_script,2015/09/15,ccc_feedback_script,0,0,0:00:00,0,0:00:00,0,0
2015-09-15-ccc_fpb_script,2015/09/15,ccc_fpb_script,0,0,0:00:00,0,0:00:00,0,0
2015-09-15-ccc_help_script,2015/09/15,ccc_help_script,7,7,0:00:16,16,0:00:47,0,112
2015-09-15-ccc_link_script,2015/09/15,ccc_link_script,0,0,0:00:00,0,0:00:00,0,0
2015-09-15-ccc_media_line_script,2015/09/15,ccc_media_line_script,0,0,0:00:00,0,0:00:00,0,0
2015-09-15-ccc_priority_script,2015/09/15,ccc_priority_script,35,31,0:00:17,17,0:01:28,4,527
2015-09-15-ccc_tax_script,2015/09/15,ccc_tax_script,16,13,0:02:32,152,0:06:09,3,1976
2015-09-15-ccc_waste_recycling_script,2015/09/15,ccc_waste_recycling_script,0,0,0:00:00,0,0:00:00,0,0
2015-09-16-ccc_311_calgary_script,2015/09/16,ccc_311_calgary_script,3469,3039,0:01:46,106,0:11:28,430,322134
2015-09-16-ccc_311_lobby_ph_script,2015/09/16,ccc_311_lobby_ph_script,3,2,0:00:13,13,0:00:18,1,26
2015-09-16-ccc_aserv_info_script,2015/09/16,ccc_aserv_info_script,0,0,0:00:00,0,0:00:00,0,0
2015-09-16-ccc_bylaw_script,2015/09/16,ccc_bylaw_script,0,0,0:00:00,0,0:00:00,0,0
2015-09-16-ccc_city_script,2015/09/16,ccc_city_script,23,23,0:01:06,66,0:05:21,0,1518
2015-09-16-ccc_cty_online_script,2015/09/16,ccc_cty_online_script,0,0,0:00:00,0,0:00:00,0,0
2015-09-16-ccc_feedback_script,2015/09/16,ccc_feedback_script,0,0,0:00:00,0,0:00:00,0,0
2015-09-16-ccc_fpb_script,2015/09/16,ccc_fpb_script,2,0,0:00:00,0,0:00:00,2,0
2015-09-16-ccc_help_script,2015/09/16,ccc_help_script,14,12,0:00:18,18,0:01:16,2,216
2015-09-16-ccc_link_script,2015/09/16,ccc_link_script,0,0,0:00:00,0,0:00:00,0,0
2015-09-16-ccc_media_line_script,2015/09/16,ccc_media_line_script,3,2,0:00:23,23,0:00:41,1,46
2015-09-16-ccc_priority_script,2015/09/16,ccc_priority_script,14,14,0:00:08,8,0:00:40,0,112
2015-09-16-ccc_tax_script,2015/09/16,ccc_tax_script,9,7,0:01:36,96,0:03:35,2,672
2015-09-16-ccc_waste_recycling_script,2015/09/16,ccc_waste_recycling_script,0,0,0:00:00,0,0:00:00,0,0
2015-09-17-ccc_311_calgary_script,2015/09/17,ccc_311_calgary_script,3336,3166,0:00:39,39,0:04:53,170,123474
2015-09-17-ccc_311_lobby_ph_script,2015/09/17,ccc_311_lobby_ph_script,5,5,0:00:07,7,0:00:11,0,35
2015-09-17-ccc_aserv_info_script,2015/09/17,ccc_aserv_info_script,0,0,0:00:00,0,0:00:00,0,0
2015-09-17-ccc_bylaw_script,2015/09/17,ccc_bylaw_script,0,0,0:00:00,0,0:00:00,0,0
2015-09-17-ccc_city_script,2015/09/17,ccc_city_script,21,20,0:00:15,15,0:01:45,1,300
2015-09-17-ccc_cty_online_script,2015/09/17,ccc_cty_online_script,0,0,0:00:00,0,0:00:00,0,0
2015-09-17-ccc_feedback_script,2015/09/17,ccc_feedback_script,0,0,0:00:00,0,0:00:00,0,0
2015-09-17-ccc_fpb_script,2015/09/17,ccc_fpb_script,1,1,0:00:05,5,0:00:05,0,5
2015-09-17-ccc_help_script,2015/09/17,ccc_help_script,14,13,0:00:06,6,0:00:14,1,78
2015-09-17-ccc_link_script,2015/09/17,ccc_link_script,0,0,0:00:00,0,0:00:00,0,0
2015-09-17-ccc_media_line_script,2015/09/17,ccc_media_line_script,1,1,0:00:10,10,0:00:10,0,10
2015-09-17-ccc_priority_script,2015/09/17,ccc_priority_script,35,35,0:00:13,13,0:01:19,0,455
2015-09-17-ccc_tax_script,2015/09/17,ccc_tax_script,9,7,0:00:47,47,0:02:10,2,329
2015-09-17-ccc_waste_recycling_script,2015/09/17,ccc_waste_recycling_script,0,0,0:00:00,0,0:00:00,0,0
2015-09-18-ccc_311_calgary_script,2015/09/18,ccc_311_calgary_script,3157,2984,0:00:38,38,0:08:10,173,113392
2015-09-18-ccc_311_lobby_ph_script,2015/09/18,ccc_311_lobby_ph_script,5,5,0:00:10,10,0:00:16,0,50
2015-09-18-ccc_aserv_info_script,2015/09/18,ccc_aserv_info_script,0,0,0:00:00,0,0:00:00,0,0
2015-09-18-ccc_bylaw_script,2015/09/18,ccc_bylaw_script,0,0,0:00:00,0,0:00:00,0,0
2015-09-18-ccc_city_script,2015/09/18,ccc_city_script,13,13,0:00:07,7,0:00:21,0,91
2015-09-18-ccc_cty_online_script,2015/09/18,ccc_cty_online_script,0,0,0:00:00,0,0:00:00,0,0
2015-09-18-ccc_feedback_script,2015/09/18,ccc_feedback_script,0,0,0:00:00,0,0:00:00,0,0
2015-09-18-ccc_fpb_script,2015/09/18,ccc_fpb_script,2,1,0:00:01,1,0:00:01,1,1
2015-09-18-ccc_help_script,2015/09/18,ccc_help_script,4,4,0:00:13,13,0:00:32,0,52
2015-09-18-ccc_link_script,2015/09/18,ccc_link_script,0,0,0:00:00,0,0:00:00,0,0
2015-09-18-ccc_media_line_script,2015/09/18,ccc_media_line_script,1,1,0:00:05,5,0:00:05,0,5
2015-09-18-ccc_priority_script,2015/09/18,ccc_priority_script,42,41,0:00:16,16,0:01:47,1,656
2015-09-18-ccc_tax_script,2015/09/18,ccc_tax_script,7,7,0:01:06,66,0:02:51,0,462
2015-09-18-ccc_waste_recycling_script,2015/09/18,ccc_waste_recycling_script,0,0,0:00:00,0,0:00:00,0,0
2015-09-19-ccc_311_calgary_script,2015/09/19,ccc_311_calgary_script,1362,1103,0:02:06,126,0:11:38,259,138978
2015-09-19-ccc_311_lobby_ph_script,2015/09/19,ccc_311_lobby_ph_script,0,0,0:00:00,0,0:00:00,0,0
2015-09-19-ccc_aserv_info_script,2015/09/19,ccc_aserv_info_script,0,0,0:00:00,0,0:00:00,0,0
2015-09-19-ccc_bylaw_script,2015/09/19,ccc_bylaw_script,0,0,0:00:00,0,0:00:00,0,0
2015-09-19-ccc_city_script,2015/09/19,ccc_city_script,0,0,0:00:00,0,0:00:00,0,0
2015-09-19-ccc_cty_online_script,2015/09/19,ccc_cty_online_script,0,0,0:00:00,0,0:00:00,0,0
2015-09-19-ccc_feedback_script,2015/09/19,ccc_feedback_script,0,0,0:00:00,0,0:00:00,0,0
2015-09-19-ccc_fpb_script,2015/09/19,ccc_fpb_script,0,0,0:00:00,0,0:00:00,0,0
2015-09-19-ccc_help_script,2015/09/19,ccc_help_script,2,1,0:00:38,38,0:00:38,1,38
2015-09-19-ccc_link_script,2015/09/19,ccc_link_script,0,0,0:00:00,0,0:00:00,0,0
2015-09-19-ccc_media_line_script,2015/09/19,ccc_media_line_script,1,1,0:00:01,1,0:00:01,0,1
2015-09-19-ccc_priority_script,2015/09/19,ccc_priority_script,24,20,0:00:20,20,0:01:25,4,400
2015-09-19-ccc_tax_script,2015/09/19,ccc_tax_script,2,0,0:00:00,0,0:00:00,2,0
2015-09-19-ccc_waste_recycling_script,2015/09/19,ccc_waste_recycling_script,0,0,0:00:00,0,0:00:00,0,0
2015-09-20-ccc_311_calgary_script,2015/09/20,ccc_311_calgary_script,1153,1085,0:00:42,42,0:11:32,68,45570
2015-09-20-ccc_311_lobby_ph_script,2015/09/20,ccc_311_lobby_ph_script,0,0,0:00:00,0,0:00:00,0,0
2015-09-20-ccc_aserv_info_script,2015/09/20,ccc_aserv_info_script,0,0,0:00:00,0,0:00:00,0,0
2015-09-20-ccc_bylaw_script,2015/09/20,ccc_bylaw_script,0,0,0:00:00,0,0:00:00,0,0
2015-09-20-ccc_city_script,2015/09/20,ccc_city_script,0,0,0:00:00,0,0:00:00,0,0
2015-09-20-ccc_cty_online_script,2015/09/20,ccc_cty_online_script,0,0,0:00:00,0,0:00:00,0,0
2015-09-20-ccc_feedback_script,2015/09/20,ccc_feedback_script,0,0,0:00:00,0,0:00:00,0,0
2015-09-20-ccc_fpb_script,2015/09/20,ccc_fpb_script,0,0,0:00:00,0,0:00:00,0,0
2015-09-20-ccc_help_script,2015/09/20,ccc_help_script,0,0,0:00:00,0,0:00:00,0,0
2015-09-20-ccc_link_script,2015/09/20,ccc_link_script,0,0,0:00:00,0,0:00:00,0,0
2015-09-20-ccc_media_line_script,2015/09/20,ccc_media_line_script,3,3,0:00:07,7,0:00:10,0,21
2015-09-20-ccc_priority_script,2015/09/20,ccc_priority_script,16,14,0:00:14,14,0:01:07,2,196
2015-09-20-ccc_tax_script,2015/09/20,ccc_tax_script,2,2,0:00:03,3,0:00:03,0,6
2015-09-20-ccc_waste_recycling_script,2015/09/20,ccc_waste_recycling_script,0,0,0:00:00,0,0:00:00,0,0
2015-09-21-ccc_311_calgary_script,2015/09/21,ccc_311_calgary_script,3472,3194,0:01:03,63,0:10:27,278,201222
2015-09-21-ccc_311_lobby_ph_script,2015/09/21,ccc_311_lobby_ph_script,1,1,0:00:10,10,0:00:10,0,10
2015-09-21-ccc_aserv_info_script,2015/09/21,ccc_aserv_info_script,0,0,0:00:00,0,0:00:00,0,0
2015-09-21-ccc_bylaw_script,2015/09/21,ccc_bylaw_script,0,0,0:00:00,0,0:00:00,0,0
2015-09-21-ccc_city_script,2015/09/21,ccc_city_script,15,15,0:00:21,21,0:01:06,0,315
2015-09-21-ccc_cty_online_script,2015/09/21,ccc_cty_online_script,0,0,0:00:00,0,0:00:00,0,0
2015-09-21-ccc_feedback_script,2015/09/21,ccc_feedback_script,0,0,0:00:00,0,0:00:00,0,0
2015-09-21-ccc_fpb_script,2015/09/21,ccc_fpb_script,0,0,0:00:00,0,0:00:00,0,0
2015-09-21-ccc_help_script,2015/09/21,ccc_help_script,15,15,0:00:11,11,0:01:07,0,165
2015-09-21-ccc_link_script,2015/09/21,ccc_link_script,0,0,0:00:00,0,0:00:00,0,0
2015-09-21-ccc_media_line_script,2015/09/21,ccc_media_line_script,0,0,0:00:00,0,0:00:00,0,0
2015-09-21-ccc_priority_script,2015/09/21,ccc_priority_script,22,22,0:00:08,8,0:00:36,0,176
2015-09-21-ccc_tax_script,2015/09/21,ccc_tax_script,9,8,0:00:33,33,0:02:30,1,264
2015-09-21-ccc_waste_recycling_script,2015/09/21,ccc_waste_recycling_script,0,0,0:00:00,0,0:00:00,0,0
2015-09-22-ccc_311_calgary_script,2015/09/22,ccc_311_calgary_script,3467,3311,0:00:34,34,0:06:23,156,112574
2015-09-22-ccc_311_lobby_ph_script,2015/09/22,ccc_311_lobby_ph_script,10,10,0:00:11,11,0:00:25,0,110
2015-09-22-ccc_aserv_info_script,2015/09/22,ccc_aserv_info_script,0,0,0:00:00,0,0:00:00,0,0
2015-09-22-ccc_bylaw_script,2015/09/22,ccc_bylaw_script,0,0,0:00:00,0,0:00:00,0,0
2015-09-22-ccc_city_script,2015/09/22,ccc_city_script,11,11,0:00:06,6,0:00:24,0,66
2015-09-22-ccc_cty_online_script,2015/09/22,ccc_cty_online_script,0,0,0:00:00,0,0:00:00,0,0
2015-09-22-ccc_feedback_script,2015/09/22,ccc_feedback_script,1,0,0:00:00,0,0:00:00,0,0
2015-09-22-ccc_fpb_script,2015/09/22,ccc_fpb_script,0,0,0:00:00,0,0:00:00,0,0
2015-09-22-ccc_help_script,2015/09/22,ccc_help_script,8,8,0:00:11,11,0:00:34,0,88
2015-09-22-ccc_link_script,2015/09/22,ccc_link_script,0,0,0:00:00,0,0:00:00,0,0
2015-09-22-ccc_media_line_script,2015/09/22,ccc_media_line_script,0,0,0:00:00,0,0:00:00,0,0
2015-09-22-ccc_priority_script,2015/09/22,ccc_priority_script,26,25,0:00:07,7,0:00:37,1,175
2015-09-22-ccc_tax_script,2015/09/22,ccc_tax_script,13,13,0:00:36,36,0:03:48,0,468
2015-09-22-ccc_waste_recycling_script,2015/09/22,ccc_waste_recycling_script,0,0,0:00:00,0,0:00:00,0,0
2015-09-23-ccc_311_calgary_script,2015/09/23,ccc_311_calgary_script,3611,3230,0:01:15,75,0:13:50,381,242250
2015-09-23-ccc_311_lobby_ph_script,2015/09/23,ccc_311_lobby_ph_script,5,4,0:00:12,12,0:00:16,1,48
2015-09-23-ccc_aserv_info_script,2015/09/23,ccc_aserv_info_script,0,0,0:00:00,0,0:00:00,0,0
2015-09-23-ccc_bylaw_script,2015/09/23,ccc_bylaw_script,0,0,0:00:00,0,0:00:00,0,0
2015-09-23-ccc_city_script,2015/09/23,ccc_city_script,22,22,0:00:15,15,0:01:25,0,330
2015-09-23-ccc_cty_online_script,2015/09/23,ccc_cty_online_script,0,0,0:00:00,0,0:00:00,0,0
2015-09-23-ccc_feedback_script,2015/09/23,ccc_feedback_script,0,0,0:00:00,0,0:00:00,0,0
2015-09-23-ccc_fpb_script,2015/09/23,ccc_fpb_script,0,0,0:00:00,0,0:00:00,0,0
2015-09-23-ccc_help_script,2015/09/23,ccc_help_script,7,5,0:00:15,15,0:00:34,2,75
2015-09-23-ccc_link_script,2015/09/23,ccc_link_script,0,0,0:00:00,0,0:00:00,0,0
2015-09-23-ccc_media_line_script,2015/09/23,ccc_media_line_script,1,1,0:00:04,4,0:00:04,0,4
2015-09-23-ccc_priority_script,2015/09/23,ccc_priority_script,17,17,0:00:16,16,0:01:18,0,272
2015-09-23-ccc_tax_script,2015/09/23,ccc_tax_script,20,18,0:01:03,63,0:03:26,2,1134
2015-09-23-ccc_waste_recycling_script,2015/09/23,ccc_waste_recycling_script,0,0,0:00:00,0,0:00:00,0,0
2015-09-24-ccc_311_calgary_script,2015/09/24,ccc_311_calgary_script,3611,3230,0:01:15,75,0:13:50,381,242250
2015-09-24-ccc_311_lobby_ph_script,2015/09/24,ccc_311_lobby_ph_script,5,4,0:00:12,12,0:00:16,1,48
2015-09-24-ccc_aserv_info_script,2015/09/24,ccc_aserv_info_script,0,0,0:00:00,0,0:00:00,0,0
2015-09-24-ccc_bylaw_script,2015/09/24,ccc_bylaw_script,0,0,0:00:00,0,0:00:00,0,0
2015-09-24-ccc_city_script,2015/09/24,ccc_city_script,22,22,0:00:15,15,0:01:25,0,330
2015-09-24-ccc_cty_online_script,2015/09/24,ccc_cty_online_script,0,0,0:00:00,0,0:00:00,0,0
2015-09-24-ccc_feedback_script,2015/09/24,ccc_feedback_script,0,0,0:00:00,0,0:00:00,0,0
2015-09-24-ccc_fpb_script,2015/09/24,ccc_fpb_script,0,0,0:00:00,0,0:00:00,0,0
2015-09-24-ccc_help_script,2015/09/24,ccc_help_script,7,5,0:00:15,15,0:00:34,2,75
2015-09-24-ccc_link_script,2015/09/24,ccc_link_script,0,0,0:00:00,0,0:00:00,0,0
2015-09-24-ccc_media_line_script,2015/09/24,ccc_media_line_script,1,1,0:00:04,4,0:00:04,0,4
2015-09-24-ccc_priority_script,2015/09/24,ccc_priority_script,17,17,0:00:16,16,0:01:18,0,272
2015-09-24-ccc_tax_script,2015/09/24,ccc_tax_script,20,18,0:01:03,63,0:03:26,2,1134
2015-09-24-ccc_waste_recycling_script,2015/09/24,ccc_waste_recycling_script,0,0,0:00:00,0,0:00:00,0,0
2015-09-25-ccc_311_calgary_script,2015/09/25,ccc_311_calgary_script,3611,3230,0:01:15,75,0:13:50,381,242250
2015-09-25-ccc_311_lobby_ph_script,2015/09/25,ccc_311_lobby_ph_script,5,4,0:00:12,12,0:00:16,1,48
2015-09-25-ccc_aserv_info_script,2015/09/25,ccc_aserv_info_script,0,0,0:00:00,0,0:00:00,0,0
2015-09-25-ccc_bylaw_script,2015/09/25,ccc_bylaw_script,0,0,0:00:00,0,0:00:00,0,0
2015-09-25-ccc_city_script,2015/09/25,ccc_city_script,22,22,0:00:15,15,0:01:25,0,330
2015-09-25-ccc_cty_online_script,2015/09/25,ccc_cty_online_script,0,0,0:00:00,0,0:00:00,0,0
2015-09-25-ccc_feedback_script,2015/09/25,ccc_feedback_script,0,0,0:00:00,0,0:00:00,0,0
2015-09-25-ccc_fpb_script,2015/09/25,ccc_fpb_script,0,0,0:00:00,0,0:00:00,0,0
2015-09-25-ccc_help_script,2015/09/25,ccc_help_script,7,5,0:00:15,15,0:00:34,2,75
2015-09-25-ccc_link_script,2015/09/25,ccc_link_script,0,0,0:00:00,0,0:00:00,0,0
2015-09-25-ccc_media_line_script,2015/09/25,ccc_media_line_script,1,1,0:00:04,4,0:00:04,0,4
2015-09-25-ccc_priority_script,2015/09/25,ccc_priority_script,17,17,0:00:16,16,0:01:18,0,272
2015-09-25-ccc_tax_script,2015/09/25,ccc_tax_script,20,18,0:01:03,63,0:03:26,2,1134
2015-09-25-ccc_waste_recycling_script,2015/09/25,ccc_waste_recycling_script,0,0,0:00:00,0,0:00:00,0,0
2015-09-26-ccc_311_calgary_script,2015/09/26,ccc_311_calgary_script,3611,3230,0:01:15,75,0:13:50,381,242250
2015-09-26-ccc_311_lobby_ph_script,2015/09/26,ccc_311_lobby_ph_script,5,4,0:00:12,12,0:00:16,1,48
2015-09-26-ccc_aserv_info_script,2015/09/26,ccc_aserv_info_script,0,0,0:00:00,0,0:00:00,0,0
2015-09-26-ccc_bylaw_script,2015/09/26,ccc_bylaw_script,0,0,0:00:00,0,0:00:00,0,0
2015-09-26-ccc_city_script,2015/09/26,ccc_city_script,22,22,0:00:15,15,0:01:25,0,330
2015-09-26-ccc_cty_online_script,2015/09/26,ccc_cty_online_script,0,0,0:00:00,0,0:00:00,0,0
2015-09-26-ccc_feedback_script,2015/09/26,ccc_feedback_script,0,0,0:00:00,0,0:00:00,0,0
2015-09-26-ccc_fpb_script,2015/09/26,ccc_fpb_script,0,0,0:00:00,0,0:00:00,0,0
2015-09-26-ccc_help_script,2015/09/26,ccc_help_script,7,5,0:00:15,15,0:00:34,2,75
2015-09-26-ccc_link_script,2015/09/26,ccc_link_script,0,0,0:00:00,0,0:00:00,0,0
2015-09-26-ccc_media_line_script,2015/09/26,ccc_media_line_script,1,1,0:00:04,4,0:00:04,0,4
2015-09-26-ccc_priority_script,2015/09/26,ccc_priority_script,17,17,0:00:16,16,0:01:18,0,272
2015-09-26-ccc_tax_script,2015/09/26,ccc_tax_script,20,18,0:01:03,63,0:03:26,2,1134
2015-09-26-ccc_waste_recycling_script,2015/09/26,ccc_waste_recycling_script,0,0,0:00:00,0,0:00:00,0,0
2015-09-27-ccc_311_calgary_script,2015/09/27,ccc_311_calgary_script,966,923,0:00:27,27,0:08:21,43,24921
2015-09-27-ccc_311_lobby_ph_script,2015/09/27,ccc_311_lobby_ph_script,0,0,0:00:00,0,0:00:00,0,0
2015-09-27-ccc_aserv_info_script,2015/09/27,ccc_aserv_info_script,0,0,0:00:00,0,0:00:00,0,0
2015-09-27-ccc_bylaw_script,2015/09/27,ccc_bylaw_script,0,0,0:00:00,0,0:00:00,0,0
2015-09-27-ccc_city_script,2015/09/27,ccc_city_script,0,0,0:00:00,0,0:00:00,0,0
2015-09-27-ccc_cty_online_script,2015/09/27,ccc_cty_online_script,0,0,0:00:00,0,0:00:00,0,0
2015-09-27-ccc_feedback_script,2015/09/27,ccc_feedback_script,1,0,0:00:00,0,0:00:00,0,0
2015-09-27-ccc_fpb_script,2015/09/27,ccc_fpb_script,0,0,0:00:00,0,0:00:00,0,0
2015-09-27-ccc_help_script,2015/09/27,ccc_help_script,1,1,0:00:03,3,0:00:03,0,3
2015-09-27-ccc_link_script,2015/09/27,ccc_link_script,0,0,0:00:00,0,0:00:00,0,0
2015-09-27-ccc_media_line_script,2015/09/27,ccc_media_line_script,0,0,0:00:00,0,0:00:00,0,0
2015-09-27-ccc_priority_script,2015/09/27,ccc_priority_script,24,23,0:00:17,17,0:02:04,1,391
2015-09-27-ccc_tax_script,2015/09/27,ccc_tax_script,0,0,0:00:00,0,0:00:00,0,0
2015-09-27-ccc_waste_recycling_script,2015/09/27,ccc_waste_recycling_script,0,0,0:00:00,0,0:00:00,0,0
2015-09-28-ccc_311_calgary_script,2015/09/28,ccc_311_calgary_script,3743,3387,0:01:16,76,0:07:39,356,257412
2015-09-28-ccc_311_lobby_ph_script,2015/09/28,ccc_311_lobby_ph_script,4,4,0:00:05,5,0:00:07,0,20
2015-09-28-ccc_aserv_info_script,2015/09/28,ccc_aserv_info_script,0,0,0:00:00,0,0:00:00,0,0
2015-09-28-ccc_bylaw_script,2015/09/28,ccc_bylaw_script,0,0,0:00:00,0,0:00:00,0,0
2015-09-28-ccc_city_script,2015/09/28,ccc_city_script,32,29,0:00:09,9,0:00:55,3,261
2015-09-28-ccc_cty_online_script,2015/09/28,ccc_cty_online_script,0,0,0:00:00,0,0:00:00,0,0
2015-09-28-ccc_feedback_script,2015/09/28,ccc_feedback_script,0,0,0:00:00,0,0:00:00,0,0
2015-09-28-ccc_fpb_script,2015/09/28,ccc_fpb_script,0,0,0:00:00,0,0:00:00,0,0
2015-09-28-ccc_help_script,2015/09/28,ccc_help_script,8,6,0:00:19,19,0:01:26,2,114
2015-09-28-ccc_link_script,2015/09/28,ccc_link_script,0,0,0:00:00,0,0:00:00,0,0
2015-09-28-ccc_media_line_script,2015/09/28,ccc_media_line_script,1,1,0:00:12,12,0:00:12,0,12
2015-09-28-ccc_priority_script,2015/09/28,ccc_priority_script,24,24,0:00:16,16,0:00:59,0,384
2015-09-28-ccc_tax_script,2015/09/28,ccc_tax_script,17,17,0:00:40,40,0:04:22,0,680
2015-09-28-ccc_waste_recycling_script,2015/09/28,ccc_waste_recycling_script,0,0,0:00:00,0,0:00:00,0,0
2015-09-29-ccc_311_calgary_script,2015/09/29,ccc_311_calgary_script,3557,3123,0:01:47,107,0:09:17,434,334161
2015-09-29-ccc_311_lobby_ph_script,2015/09/29,ccc_311_lobby_ph_script,4,3,0:00:04,4,0:00:07,1,12
2015-09-29-ccc_aserv_info_script,2015/09/29,ccc_aserv_info_script,0,0,0:00:00,0,0:00:00,0,0
2015-09-29-ccc_bylaw_script,2015/09/29,ccc_bylaw_script,0,0,0:00:00,0,0:00:00,0,0
2015-09-29-ccc_city_script,2015/09/29,ccc_city_script,18,18,0:01:00,60,0:06:19,0,1080
2015-09-29-ccc_cty_online_script,2015/09/29,ccc_cty_online_script,0,0,0:00:00,0,0:00:00,0,0
2015-09-29-ccc_feedback_script,2015/09/29,ccc_feedback_script,1,0,0:00:00,0,0:00:00,0,0
2015-09-29-ccc_fpb_script,2015/09/29,ccc_fpb_script,0,0,0:00:00,0,0:00:00,0,0
2015-09-29-ccc_help_script,2015/09/29,ccc_help_script,13,13,0:00:07,7,0:00:21,0,91
2015-09-29-ccc_link_script,2015/09/29,ccc_link_script,1,0,0:00:00,0,0:00:00,0,0
2015-09-29-ccc_media_line_script,2015/09/29,ccc_media_line_script,0,0,0:00:00,0,0:00:00,0,0
2015-09-29-ccc_priority_script,2015/09/29,ccc_priority_script,23,23,0:00:10,10,0:00:39,0,230
2015-09-29-ccc_tax_script,2015/09/29,ccc_tax_script,22,20,0:02:49,169,0:08:23,2,3380
2015-09-29-ccc_waste_recycling_script,2015/09/29,ccc_waste_recycling_script,0,0,0:00:00,0,0:00:00,0,0
2015-09-30-ccc_311_calgary_script,2015/09/30,ccc_311_calgary_script,3785,2977,0:03:04,184,0:10:57,808,547768
2015-09-30-ccc_311_lobby_ph_script,2015/09/30,ccc_311_lobby_ph_script,7,6,0:00:17,17,0:00:30,1,102
2015-09-30-ccc_aserv_info_script,2015/09/30,ccc_aserv_info_script,0,0,0:00:00,0,0:00:00,0,0
2015-09-30-ccc_bylaw_script,2015/09/30,ccc_bylaw_script,0,0,0:00:00,0,0:00:00,0,0
2015-09-30-ccc_city_script,2015/09/30,ccc_city_script,29,25,0:00:49,49,0:07:07,4,1225
2015-09-30-ccc_cty_online_script,2015/09/30,ccc_cty_online_script,0,0,0:00:00,0,0:00:00,0,0
2015-09-30-ccc_feedback_script,2015/09/30,ccc_feedback_script,0,0,0:00:00,0,0:00:00,0,0
2015-09-30-ccc_fpb_script,2015/09/30,ccc_fpb_script,0,0,0:00:00,0,0:00:00,0,0
2015-09-30-ccc_help_script,2015/09/30,ccc_help_script,8,8,0:00:11,11,0:00:39,0,88
2015-09-30-ccc_link_script,2015/09/30,ccc_link_script,0,0,0:00:00,0,0:00:00,0,0
2015-09-30-ccc_media_line_script,2015/09/30,ccc_media_line_script,0,0,0:00:00,0,0:00:00,0,0
2015-09-30-ccc_priority_script,2015/09/30,ccc_priority_script,40,39,0:00:18,18,0:01:30,1,702
2015-09-30-ccc_tax_script,2015/09/30,ccc_tax_script,14,9,0:03:59,239,0:07:32,5,2151
2015-09-30-ccc_waste_recycling_script,2015/09/30,ccc_waste_recycling_script,0,0,0:00:00,0,0:00:00,0,0
2015-10-01-ccc_311_calgary_script,2015/10/01,ccc_311_calgary_script,3607,2979,0:02:37,157,0:10:31,627,467703
2015-10-01-ccc_311_lobby_ph_script,2015/10/01,ccc_311_lobby_ph_script,3,3,0:00:14,14,0:00:21,0,42
2015-10-01-ccc_aserv_info_script,2015/10/01,ccc_aserv_info_script,0,0,0:00:00,0,0:00:00,0,0
2015-10-01-ccc_bylaw_script,2015/10/01,ccc_bylaw_script,0,0,0:00:00,0,0:00:00,0,0
2015-10-01-ccc_city_script,2015/10/01,ccc_city_script,22,20,0:01:07,67,0:05:51,2,1340
2015-10-01-ccc_cty_online_script,2015/10/01,ccc_cty_online_script,0,0,0:00:00,0,0:00:00,0,0
2015-10-01-ccc_feedback_script,2015/10/01,ccc_feedback_script,0,0,0:00:00,0,0:00:00,0,0
2015-10-01-ccc_fpb_script,2015/10/01,ccc_fpb_script,0,0,0:00:00,0,0:00:00,0,0
2015-10-01-ccc_help_script,2015/10/01,ccc_help_script,10,10,0:00:10,10,0:00:26,0,100
2015-10-01-ccc_link_script,2015/10/01,ccc_link_script,0,0,0:00:00,0,0:00:00,0,0
2015-10-01-ccc_media_line_script,2015/10/01,ccc_media_line_script,0,0,0:00:00,0,0:00:00,0,0
2015-10-01-ccc_priority_script,2015/10/01,ccc_priority_script,27,26,0:00:21,21,0:02:58,1,546
2015-10-01-ccc_tax_script,2015/10/01,ccc_tax_script,13,10,0:03:04,184,0:05:41,3,1840
2015-10-01-ccc_waste_recycling_script,2015/10/01,ccc_waste_recycling_script,0,0,0:00:00,0,0:00:00,0,0
2015-10-02-ccc_311_calgary_script,2015/10/02,ccc_311_calgary_script,3651,3000,0:02:47,167,0:13:09,652,501000
2015-10-02-ccc_311_lobby_ph_script,2015/10/02,ccc_311_lobby_ph_script,4,3,0:00:18,18,0:00:25,1,54
2015-10-02-ccc_aserv_info_script,2015/10/02,ccc_aserv_info_script,0,0,0:00:00,0,0:00:00,0,0
2015-10-02-ccc_bylaw_script,2015/10/02,ccc_bylaw_script,0,0,0:00:00,0,0:00:00,0,0
2015-10-02-ccc_city_script,2015/10/02,ccc_city_script,22,21,0:01:24,84,0:06:20,1,1764
2015-10-02-ccc_cty_online_script,2015/10/02,ccc_cty_online_script,0,0,0:00:00,0,0:00:00,0,0
2015-10-02-ccc_feedback_script,2015/10/02,ccc_feedback_script,0,0,0:00:00,0,0:00:00,0,0
2015-10-02-ccc_fpb_script,2015/10/02,ccc_fpb_script,0,0,0:00:00,0,0:00:00,0,0
2015-10-02-ccc_help_script,2015/10/02,ccc_help_script,5,5,0:00:12,12,0:00:29,0,60
2015-10-02-ccc_link_script,2015/10/02,ccc_link_script,0,0,0:00:00,0,0:00:00,0,0
2015-10-02-ccc_media_line_script,2015/10/02,ccc_media_line_script,0,0,0:00:00,0,0:00:00,0,0
2015-10-02-ccc_priority_script,2015/10/02,ccc_priority_script,45,43,0:00:20,20,0:01:28,2,860
2015-10-02-ccc_tax_script,2015/10/02,ccc_tax_script,26,21,0:02:46,166,0:08:11,5,3486
2015-10-02-ccc_waste_recycling_script,2015/10/02,ccc_waste_recycling_script,0,0,0:00:00,0,0:00:00,0,0
2015-10-03-ccc_311_calgary_script,2015/10/03,ccc_311_calgary_script,1063,1014,0:00:28,28,0:07:52,49,28392
2015-10-03-ccc_311_lobby_ph_script,2015/10/03,ccc_311_lobby_ph_script,0,0,0:00:00,0,0:00:00,0,0
2015-10-03-ccc_aserv_info_script,2015/10/03,ccc_aserv_info_script,0,0,0:00:00,0,0:00:00,0,0
2015-10-03-ccc_bylaw_script,2015/10/03,ccc_bylaw_script,0,0,0:00:00,0,0:00:00,0,0
2015-10-03-ccc_city_script,2015/10/03,ccc_city_script,0,0,0:00:00,0,0:00:00,0,0
2015-10-03-ccc_cty_online_script,2015/10/03,ccc_cty_online_script,0,0,0:00:00,0,0:00:00,0,0
2015-10-03-ccc_feedback_script,2015/10/03,ccc_feedback_script,0,0,0:00:00,0,0:00:00,0,0
2015-10-03-ccc_fpb_script,2015/10/03,ccc_fpb_script,0,0,0:00:00,0,0:00:00,0,0
2015-10-03-ccc_help_script,2015/10/03,ccc_help_script,4,3,0:00:10,10,0:00:22,1,30
2015-10-03-ccc_link_script,2015/10/03,ccc_link_script,0,0,0:00:00,0,0:00:00,0,0
2015-10-03-ccc_media_line_script,2015/10/03,ccc_media_line_script,1,1,0:00:05,5,0:00:05,0,5
2015-10-03-ccc_priority_script,2015/10/03,ccc_priority_script,36,33,0:00:22,22,0:02:46,3,726
2015-10-03-ccc_tax_script,2015/10/03,ccc_tax_script,4,4,0:00:19,19,0:00:48,0,76
2015-10-03-ccc_waste_recycling_script,2015/10/03,ccc_waste_recycling_script,0,0,0:00:00,0,0:00:00,0,0
2015-10-04-ccc_311_calgary_script,2015/10/04,ccc_311_calgary_script,984,952,0:00:18,18,0:06:05,32,17136
2015-10-04-ccc_311_lobby_ph_script,2015/10/04,ccc_311_lobby_ph_script,0,0,0:00:00,0,0:00:00,0,0
2015-10-04-ccc_aserv_info_script,2015/10/04,ccc_aserv_info_script,0,0,0:00:00,0,0:00:00,0,0
2015-10-04-ccc_bylaw_script,2015/10/04,ccc_bylaw_script,0,0,0:00:00,0,0:00:00,0,0
2015-10-04-ccc_city_script,2015/10/04,ccc_city_script,0,0,0:00:00,0,0:00:00,0,0
2015-10-04-ccc_cty_online_script,2015/10/04,ccc_cty_online_script,0,0,0:00:00,0,0:00:00,0,0
2015-10-04-ccc_feedback_script,2015/10/04,ccc_feedback_script,0,0,0:00:00,0,0:00:00,0,0
2015-10-04-ccc_fpb_script,2015/10/04,ccc_fpb_script,0,0,0:00:00,0,0:00:00,0,0
2015-10-04-ccc_help_script,2015/10/04,ccc_help_script,1,1,0:00:04,4,0:00:04,0,4
2015-10-04-ccc_link_script,2015/10/04,ccc_link_script,0,0,0:00:00,0,0:00:00,0,0
2015-10-04-ccc_media_line_script,2015/10/04,ccc_media_line_script,2,1,0:00:07,7,0:00:07,1,7
2015-10-04-ccc_priority_script,2015/10/04,ccc_priority_script,31,28,0:00:22,22,0:03:08,3,616
2015-10-04-ccc_tax_script,2015/10/04,ccc_tax_script,3,3,0:00:08,8,0:00:13,0,24
2015-10-04-ccc_waste_recycling_script,2015/10/04,ccc_waste_recycling_script,0,0,0:00:00,0,0:00:00,0,0
2015-10-05-ccc_311_calgary_script,2015/10/05,ccc_311_calgary_script,3640,3490,0:00:30,30,0:05:54,150,104700
2015-10-05-ccc_311_lobby_ph_script,2015/10/05,ccc_311_lobby_ph_script,3,2,0:00:04,4,0:00:04,1,8
2015-10-05-ccc_aserv_info_script,2015/10/05,ccc_aserv_info_script,0,0,0:00:00,0,0:00:00,0,0
2015-10-05-ccc_bylaw_script,2015/10/05,ccc_bylaw_script,0,0,0:00:00,0,0:00:00,0,0
2015-10-05-ccc_city_script,2015/10/05,ccc_city_script,14,14,0:00:11,11,0:00:42,0,154
2015-10-05-ccc_cty_online_script,2015/10/05,ccc_cty_online_script,0,0,0:00:00,0,0:00:00,0,0
2015-10-05-ccc_feedback_script,2015/10/05,ccc_feedback_script,0,0,0:00:00,0,0:00:00,0,0
2015-10-05-ccc_fpb_script,2015/10/05,ccc_fpb_script,0,0,0:00:00,0,0:00:00,0,0
2015-10-05-ccc_help_script,2015/10/05,ccc_help_script,3,3,0:00:04,4,0:00:07,0,12
2015-10-05-ccc_link_script,2015/10/05,ccc_link_script,0,0,0:00:00,0,0:00:00,0,0
2015-10-05-ccc_media_line_script,2015/10/05,ccc_media_line_script,1,1,0:00:08,8,0:00:08,0,8
2015-10-05-ccc_priority_script,2015/10/05,ccc_priority_script,25,24,0:00:09,9,0:00:27,1,216
2015-10-05-ccc_tax_script,2015/10/05,ccc_tax_script,22,22,0:00:25,25,0:01:07,0,550
2015-10-05-ccc_waste_recycling_script,2015/10/05,ccc_waste_recycling_script,0,0,0:00:00,0,0:00:00,0,0
2015-10-06-ccc_311_calgary_script,2015/10/06,ccc_311_calgary_script,3495,2875,0:03:03,183,0:10:14,620,526125
2015-10-06-ccc_311_lobby_ph_script,2015/10/06,ccc_311_lobby_ph_script,3,3,0:00:10,10,0:00:19,0,30
2015-10-06-ccc_aserv_info_script,2015/10/06,ccc_aserv_info_script,0,0,0:00:00,0,0:00:00,0,0
2015-10-06-ccc_bylaw_script,2015/10/06,ccc_bylaw_script,0,0,0:00:00,0,0:00:00,0,0
2015-10-06-ccc_city_script,2015/10/06,ccc_city_script,14,14,0:00:42,42,0:02:07,0,588
2015-10-06-ccc_cty_online_script,2015/10/06,ccc_cty_online_script,0,0,0:00:00,0,0:00:00,0,0
2015-10-06-ccc_feedback_script,2015/10/06,ccc_feedback_script,1,0,0:00:00,0,0:00:00,0,0
2015-10-06-ccc_fpb_script,2015/10/06,ccc_fpb_script,0,0,0:00:00,0,0:00:00,0,0
2015-10-06-ccc_help_script,2015/10/06,ccc_help_script,11,11,0:00:10,10,0:00:28,0,110
2015-10-06-ccc_link_script,2015/10/06,ccc_link_script,0,0,0:00:00,0,0:00:00,0,0
2015-10-06-ccc_media_line_script,2015/10/06,ccc_media_line_script,1,1,0:00:09,9,0:00:09,0,9
2015-10-06-ccc_priority_script,2015/10/06,ccc_priority_script,48,46,0:00:20,20,0:02:00,2,920
2015-10-06-ccc_tax_script,2015/10/06,ccc_tax_script,22,16,0:03:31,211,0:06:59,6,3376
2015-10-06-ccc_waste_recycling_script,2015/10/06,ccc_waste_recycling_script,0,0,0:00:00,0,0:00:00,0,0
2015-10-07-ccc_311_calgary_script,2015/10/07,ccc_311_calgary_script,3477,3245,0:00:53,53,0:08:03,232,171985
2015-10-07-ccc_311_lobby_ph_script,2015/10/07,ccc_311_lobby_ph_script,5,5,0:00:05,5,0:00:07,0,25
2015-10-07-ccc_aserv_info_script,2015/10/07,ccc_aserv_info_script,0,0,0:00:00,0,0:00:00,0,0
2015-10-07-ccc_bylaw_script,2015/10/07,ccc_bylaw_script,0,0,0:00:00,0,0:00:00,0,0
2015-10-07-ccc_city_script,2015/10/07,ccc_city_script,9,9,0:00:08,8,0:00:31,0,72
2015-10-07-ccc_cty_online_script,2015/10/07,ccc_cty_online_script,0,0,0:00:00,0,0:00:00,0,0
2015-10-07-ccc_feedback_script,2015/10/07,ccc_feedback_script,0,0,0:00:00,0,0:00:00,0,0
2015-10-07-ccc_fpb_script,2015/10/07,ccc_fpb_script,1,0,0:00:00,0,0:00:00,1,0
2015-10-07-ccc_help_script,2015/10/07,ccc_help_script,9,8,0:00:08,8,0:00:15,1,64
2015-10-07-ccc_link_script,2015/10/07,ccc_link_script,0,0,0:00:00,0,0:00:00,0,0
2015-10-07-ccc_media_line_script,2015/10/07,ccc_media_line_script,1,1,0:00:05,5,0:00:05,0,5
2015-10-07-ccc_priority_script,2015/10/07,ccc_priority_script,32,30,0:00:16,16,0:01:35,2,480
2015-10-07-ccc_tax_script,2015/10/07,ccc_tax_script,16,16,0:00:55,55,0:05:16,0,880
2015-10-07-ccc_waste_recycling_script,2015/10/07,ccc_waste_recycling_script,0,0,0:00:00,0,0:00:00,0,0
2015-10-08-ccc_311_calgary_script,2015/10/08,ccc_311_calgary_script,3292,2764,0:02:13,133,0:13:01,528,367612
2015-10-08-ccc_311_lobby_ph_script,2015/10/08,ccc_311_lobby_ph_script,4,2,0:00:10,10,0:00:14,2,20
2015-10-08-ccc_aserv_info_script,2015/10/08,ccc_aserv_info_script,0,0,0:00:00,0,0:00:00,0,0
2015-10-08-ccc_bylaw_script,2015/10/08,ccc_bylaw_script,0,0,0:00:00,0,0:00:00,0,0
2015-10-08-ccc_city_script,2015/10/08,ccc_city_script,18,15,0:00:24,24,0:01:37,3,360
2015-10-08-ccc_cty_online_script,2015/10/08,ccc_cty_online_script,0,0,0:00:00,0,0:00:00,0,0
2015-10-08-ccc_feedback_script,2015/10/08,ccc_feedback_script,0,0,0:00:00,0,0:00:00,0,0
2015-10-08-ccc_fpb_script,2015/10/08,ccc_fpb_script,0,0,0:00:00,0,0:00:00,0,0
2015-10-08-ccc_help_script,2015/10/08,ccc_help_script,14,13,0:00:22,22,0:01:02,1,286
2015-10-08-ccc_link_script,2015/10/08,ccc_link_script,0,0,0:00:00,0,0:00:00,0,0
2015-10-08-ccc_media_line_script,2015/10/08,ccc_media_line_script,1,0,0:00:00,0,0:00:00,1,0
2015-10-08-ccc_priority_script,2015/10/08,ccc_priority_script,22,21,0:00:13,13,0:00:53,1,273
2015-10-08-ccc_tax_script,2015/10/08,ccc_tax_script,10,9,0:02:08,128,0:06:31,1,1152
2015-10-08-ccc_waste_recycling_script,2015/10/08,ccc_waste_recycling_script,0,0,0:00:00,0,0:00:00,0,0
2015-10-09-ccc_311_calgary_script,2015/10/09,ccc_311_calgary_script,3018,2767,0:01:18,78,0:06:58,251,215826
2015-10-09-ccc_311_lobby_ph_script,2015/10/09,ccc_311_lobby_ph_script,1,1,0:00:12,12,0:00:12,0,12
2015-10-09-ccc_aserv_info_script,2015/10/09,ccc_aserv_info_script,0,0,0:00:00,0,0:00:00,0,0
2015-10-09-ccc_bylaw_script,2015/10/09,ccc_bylaw_script,0,0,0:00:00,0,0:00:00,0,0
2015-10-09-ccc_city_script,2015/10/09,ccc_city_script,13,12,0:00:37,37,0:03:10,1,444
2015-10-09-ccc_cty_online_script,2015/10/09,ccc_cty_online_script,0,0,0:00:00,0,0:00:00,0,0
2015-10-09-ccc_feedback_script,2015/10/09,ccc_feedback_script,0,0,0:00:00,0,0:00:00,0,0
2015-10-09-ccc_fpb_script,2015/10/09,ccc_fpb_script,2,0,0:00:00,0,0:00:00,2,0
2015-10-09-ccc_help_script,2015/10/09,ccc_help_script,8,5,0:00:07,7,0:00:19,3,35
2015-10-09-ccc_link_script,2015/10/09,ccc_link_script,0,0,0:00:00,0,0:00:00,0,0
2015-10-09-ccc_media_line_script,2015/10/09,ccc_media_line_script,0,0,0:00:00,0,0:00:00,0,0
2015-10-09-ccc_priority_script,2015/10/09,ccc_priority_script,27,27,0:00:12,12,0:00:37,0,324
2015-10-09-ccc_tax_script,2015/10/09,ccc_tax_script,9,9,0:01:51,111,0:03:28,0,999
2015-10-09-ccc_waste_recycling_script,2015/10/09,ccc_waste_recycling_script,0,0,0:00:00,0,0:00:00,0,0
2015-10-10-ccc_311_calgary_script,2015/10/10,ccc_311_calgary_script,1179,1091,0:00:45,45,0:08:51,88,49095
2015-10-10-ccc_311_lobby_ph_script,2015/10/10,ccc_311_lobby_ph_script,0,0,0:00:00,0,0:00:00,0,0
2015-10-10-ccc_aserv_info_script,2015/10/10,ccc_aserv_info_script,0,0,0:00:00,0,0:00:00,0,0
2015-10-10-ccc_bylaw_script,2015/10/10,ccc_bylaw_script,0,0,0:00:00,0,0:00:00,0,0
2015-10-10-ccc_city_script,2015/10/10,ccc_city_script,0,0,0:00:00,0,0:00:00,0,0
2015-10-10-ccc_cty_online_script,2015/10/10,ccc_cty_online_script,0,0,0:00:00,0,0:00:00,0,0
2015-10-10-ccc_feedback_script,2015/10/10,ccc_feedback_script,0,0,0:00:00,0,0:00:00,0,0
2015-10-10-ccc_fpb_script,2015/10/10,ccc_fpb_script,0,0,0:00:00,0,0:00:00,0,0
2015-10-10-ccc_help_script,2015/10/10,ccc_help_script,0,0,0:00:00,0,0:00:00,0,0
2015-10-10-ccc_link_script,2015/10/10,ccc_link_script,0,0,0:00:00,0,0:00:00,0,0
2015-10-10-ccc_media_line_script,2015/10/10,ccc_media_line_script,0,0,0:00:00,0,0:00:00,0,0
2015-10-10-ccc_priority_script,2015/10/10,ccc_priority_script,20,18,0:00:22,22,0:01:36,1,396
2015-10-10-ccc_tax_script,2015/10/10,ccc_tax_script,0,0,0:00:00,0,0:00:00,0,0
2015-10-10-ccc_waste_recycling_script,2015/10/10,ccc_waste_recycling_script,0,0,0:00:00,0,0:00:00,0,0
2015-10-11-ccc_311_calgary_script,2015/10/11,ccc_311_calgary_script,455,437,0:00:27,27,0:04:25,18,11799
2015-10-11-ccc_311_lobby_ph_script,2015/10/11,ccc_311_lobby_ph_script,0,0,0:00:00,0,0:00:00,0,0
2015-10-11-ccc_aserv_info_script,2015/10/11,ccc_aserv_info_script,0,0,0:00:00,0,0:00:00,0,0
2015-10-11-ccc_bylaw_script,2015/10/11,ccc_bylaw_script,0,0,0:00:00,0,0:00:00,0,0
2015-10-11-ccc_city_script,2015/10/11,ccc_city_script,0,0,0:00:00,0,0:00:00,0,0
2015-10-11-ccc_cty_online_script,2015/10/11,ccc_cty_online_script,0,0,0:00:00,0,0:00:00,0,0
2015-10-11-ccc_feedback_script,2015/10/11,ccc_feedback_script,0,0,0:00:00,0,0:00:00,0,0
2015-10-11-ccc_fpb_script,2015/10/11,ccc_fpb_script,0,0,0:00:00,0,0:00:00,0,0
2015-10-11-ccc_help_script,2015/10/11,ccc_help_script,0,0,0:00:00,0,0:00:00,0,0
2015-10-11-ccc_link_script,2015/10/11,ccc_link_script,0,0,0:00:00,0,0:00:00,0,0
2015-10-11-ccc_media_line_script,2015/10/11,ccc_media_line_script,0,0,0:00:00,0,0:00:00,0,0
2015-10-11-ccc_priority_script,2015/10/11,ccc_priority_script,16,16,0:00:09,9,0:00:26,1,144
2015-10-11-ccc_tax_script,2015/10/11,ccc_tax_script,0,0,0:00:00,0,0:00:00,0,0
2015-10-11-ccc_waste_recycling_script,2015/10/11,ccc_waste_recycling_script,0,0,0:00:00,0,0:00:00,0,0
2015-10-12-ccc_311_calgary_script,2015/10/12,ccc_311_calgary_script,1020,1007,0:00:06,6,0:04:18,13,6042
2015-10-12-ccc_311_lobby_ph_script,2015/10/12,ccc_311_lobby_ph_script,0,0,0:00:00,0,0:00:00,0,0
2015-10-12-ccc_aserv_info_script,2015/10/12,ccc_aserv_info_script,0,0,0:00:00,0,0:00:00,0,0
2015-10-12-ccc_bylaw_script,2015/10/12,ccc_bylaw_script,0,0,0:00:00,0,0:00:00,0,0
2015-10-12-ccc_city_script,2015/10/12,ccc_city_script,0,0,0:00:00,0,0:00:00,0,0
2015-10-12-ccc_cty_online_script,2015/10/12,ccc_cty_online_script,0,0,0:00:00,0,0:00:00,0,0
2015-10-12-ccc_feedback_script,2015/10/12,ccc_feedback_script,0,0,0:00:00,0,0:00:00,0,0
2015-10-12-ccc_fpb_script,2015/10/12,ccc_fpb_script,0,0,0:00:00,0,0:00:00,0,0
2015-10-12-ccc_help_script,2015/10/12,ccc_help_script,2,2,0:00:04,4,0:00:05,0,8
2015-10-12-ccc_link_script,2015/10/12,ccc_link_script,0,0,0:00:00,0,0:00:00,0,0
2015-10-12-ccc_media_line_script,2015/10/12,ccc_media_line_script,1,1,0:00:06,6,0:00:06,0,6
2015-10-12-ccc_priority_script,2015/10/12,ccc_priority_script,7,7,0:00:04,4,0:00:08,0,28
2015-10-12-ccc_tax_script,2015/10/12,ccc_tax_script,0,0,0:00:00,0,0:00:00,0,0
2015-10-12-ccc_waste_recycling_script,2015/10/12,ccc_waste_recycling_script,0,0,0:00:00,0,0:00:00,0,0
2015-10-13-ccc_311_calgary_script,2015/10/13,ccc_311_calgary_script,3720,3344,0:01:46,106,0:07:52,376,354464
2015-10-13-ccc_311_lobby_ph_script,2015/10/13,ccc_311_lobby_ph_script,6,5,0:00:10,10,0:00:22,1,50
2015-10-13-ccc_aserv_info_script,2015/10/13,ccc_aserv_info_script,0,0,0:00:00,0,0:00:00,0,0
2015-10-13-ccc_bylaw_script,2015/10/13,ccc_bylaw_script,0,0,0:00:00,0,0:00:00,0,0
2015-10-13-ccc_city_script,2015/10/13,ccc_city_script,25,25,0:00:11,11,0:00:43,0,275
2015-10-13-ccc_cty_online_script,2015/10/13,ccc_cty_online_script,0,0,0:00:00,0,0:00:00,0,0
2015-10-13-ccc_feedback_script,2015/10/13,ccc_feedback_script,0,0,0:00:00,0,0:00:00,0,0
2015-10-13-ccc_fpb_script,2015/10/13,ccc_fpb_script,0,0,0:00:00,0,0:00:00,0,0
2015-10-13-ccc_help_script,2015/10/13,ccc_help_script,12,10,0:00:06,6,0:00:18,2,60
2015-10-13-ccc_link_script,2015/10/13,ccc_link_script,0,0,0:00:00,0,0:00:00,0,0
2015-10-13-ccc_media_line_script,2015/10/13,ccc_media_line_script,0,0,0:00:00,0,0:00:00,0,0
2015-10-13-ccc_priority_script,2015/10/13,ccc_priority_script,31,28,0:00:09,9,0:00:21,3,252
2015-10-13-ccc_tax_script,2015/10/13,ccc_tax_script,12,11,0:01:28,88,0:05:00,1,968
2015-10-13-ccc_waste_recycling_script,2015/10/13,ccc_waste_recycling_script,0,0,0:00:00,0,0:00:00,0,0
2015-10-14-ccc_311_calgary_script,2015/10/14,ccc_311_calgary_script,3365,3157,0:00:44,44,0:09:23,208,138908
2015-10-14-ccc_311_lobby_ph_script,2015/10/14,ccc_311_lobby_ph_script,5,5,0:00:16,16,0:00:53,0,80
2015-10-14-ccc_aserv_info_script,2015/10/14,ccc_aserv_info_script,0,0,0:00:00,0,0:00:00,0,0
2015-10-14-ccc_bylaw_script,2015/10/14,ccc_bylaw_script,0,0,0:00:00,0,0:00:00,0,0
2015-10-14-ccc_city_script,2015/10/14,ccc_city_script,14,14,0:00:11,11,0:00:47,0,154
2015-10-14-ccc_cty_online_script,2015/10/14,ccc_cty_online_script,0,0,0:00:00,0,0:00:00,0,0
2015-10-14-ccc_feedback_script,2015/10/14,ccc_feedback_script,1,0,0:00:00,0,0:00:00,0,0
2015-10-14-ccc_fpb_script,2015/10/14,ccc_fpb_script,1,0,0:00:00,0,0:00:00,1,0
2015-10-14-ccc_help_script,2015/10/14,ccc_help_script,9,6,0:00:13,13,0:00:31,3,78
2015-10-14-ccc_link_script,2015/10/14,ccc_link_script,0,0,0:00:00,0,0:00:00,0,0
2015-10-14-ccc_media_line_script,2015/10/14,ccc_media_line_script,0,0,0:00:00,0,0:00:00,0,0
2015-10-14-ccc_priority_script,2015/10/14,ccc_priority_script,31,29,0:00:06,6,0:00:39,2,174
2015-10-14-ccc_tax_script,2015/10/14,ccc_tax_script,15,14,0:01:13,73,0:03:56,1,1022
2015-10-14-ccc_waste_recycling_script,2015/10/14,ccc_waste_recycling_script,0,0,0:00:00,0,0:00:00,0,0
2015-10-15-ccc_311_calgary_script,2015/10/15,ccc_311_calgary_script,3296,2847,0:02:00,120,0:14:50,449,341640
2015-10-15-ccc_311_lobby_ph_script,2015/10/15,ccc_311_lobby_ph_script,5,5,0:00:11,11,0:00:25,0,55
2015-10-15-ccc_aserv_info_script,2015/10/15,ccc_aserv_info_script,0,0,0:00:00,0,0:00:00,0,0
2015-10-15-ccc_bylaw_script,2015/10/15,ccc_bylaw_script,0,0,0:00:00,0,0:00:00,0,0
2015-10-15-ccc_city_script,2015/10/15,ccc_city_script,26,25,0:00:19,19,0:01:44,1,475
2015-10-15-ccc_cty_online_script,2015/10/15,ccc_cty_online_script,0,0,0:00:00,0,0:00:00,0,0
2015-10-15-ccc_feedback_script,2015/10/15,ccc_feedback_script,0,0,0:00:00,0,0:00:00,0,0
2015-10-15-ccc_fpb_script,2015/10/15,ccc_fpb_script,1,1,0:01:45,105,0:01:45,0,105
2015-10-15-ccc_help_script,2015/10/15,ccc_help_script,11,9,0:00:09,9,0:00:29,2,81
2015-10-15-ccc_link_script,2015/10/15,ccc_link_script,0,0,0:00:00,0,0:00:00,0,0
2015-10-15-ccc_media_line_script,2015/10/15,ccc_media_line_script,5,5,0:00:33,33,0:01:15,0,165
2015-10-15-ccc_priority_script,2015/10/15,ccc_priority_script,41,41,0:00:29,29,0:02:16,0,1189
2015-10-15-ccc_tax_script,2015/10/15,ccc_tax_script,17,14,0:02:35,155,0:06:53,3,2170
2015-10-15-ccc_waste_recycling_script,2015/10/15,ccc_waste_recycling_script,0,0,0:00:00,0,0:00:00,0,0
2015-10-16-ccc_311_calgary_script,2015/10/16,ccc_311_calgary_script,3010,2779,0:01:11,71,0:08:04,231,197309
2015-10-16-ccc_311_lobby_ph_script,2015/10/16,ccc_311_lobby_ph_script,4,1,0:00:01,1,0:00:01,3,1
2015-10-16-ccc_aserv_info_script,2015/10/16,ccc_aserv_info_script,0,0,0:00:00,0,0:00:00,0,0
2015-10-16-ccc_bylaw_script,2015/10/16,ccc_bylaw_script,0,0,0:00:00,0,0:00:00,0,0
2015-10-16-ccc_city_script,2015/10/16,ccc_city_script,24,24,0:00:30,30,0:02:25,0,720
2015-10-16-ccc_cty_online_script,2015/10/16,ccc_cty_online_script,0,0,0:00:00,0,0:00:00,0,0
2015-10-16-ccc_feedback_script,2015/10/16,ccc_feedback_script,1,0,0:00:00,0,0:00:00,0,0
2015-10-16-ccc_fpb_script,2015/10/16,ccc_fpb_script,0,0,0:00:00,0,0:00:00,0,0
2015-10-16-ccc_help_script,2015/10/16,ccc_help_script,5,4,0:00:08,8,0:00:10,1,32
2015-10-16-ccc_link_script,2015/10/16,ccc_link_script,1,0,0:00:00,0,0:00:00,0,0
2015-10-16-ccc_media_line_script,2015/10/16,ccc_media_line_script,0,0,0:00:00,0,0:00:00,0,0
2015-10-16-ccc_priority_script,2015/10/16,ccc_priority_script,24,22,0:00:18,18,0:00:55,2,396
2015-10-16-ccc_tax_script,2015/10/16,ccc_tax_script,11,10,0:00:25,25,0:01:55,1,250
2015-10-16-ccc_waste_recycling_script,2015/10/16,ccc_waste_recycling_script,0,0,0:00:00,0,0:00:00,0,0
2015-10-17-ccc_311_calgary_script,2015/10/17,ccc_311_calgary_script,1241,1146,0:00:46,46,0:10:57,95,52716
2015-10-17-ccc_311_lobby_ph_script,2015/10/17,ccc_311_lobby_ph_script,0,0,0:00:00,0,0:00:00,0,0
2015-10-17-ccc_aserv_info_script,2015/10/17,ccc_aserv_info_script,0,0,0:00:00,0,0:00:00,0,0
2015-10-17-ccc_bylaw_script,2015/10/17,ccc_bylaw_script,0,0,0:00:00,0,0:00:00,0,0
2015-10-17-ccc_city_script,2015/10/17,ccc_city_script,0,0,0:00:00,0,0:00:00,0,0
2015-10-17-ccc_cty_online_script,2015/10/17,ccc_cty_online_script,0,0,0:00:00,0,0:00:00,0,0
2015-10-17-ccc_feedback_script,2015/10/17,ccc_feedback_script,0,0,0:00:00,0,0:00:00,0,0
2015-10-17-ccc_fpb_script,2015/10/17,ccc_fpb_script,0,0,0:00:00,0,0:00:00,0,0
2015-10-17-ccc_help_script,2015/10/17,ccc_help_script,0,0,0:00:00,0,0:00:00,0,0
2015-10-17-ccc_link_script,2015/10/17,ccc_link_script,0,0,0:00:00,0,0:00:00,0,0
2015-10-17-ccc_media_line_script,2015/10/17,ccc_media_line_script,4,4,0:00:06,6,0:00:12,0,24
2015-10-17-ccc_priority_script,2015/10/17,ccc_priority_script,19,19,0:00:14,14,0:00:42,0,266
2015-10-17-ccc_tax_script,2015/10/17,ccc_tax_script,1,1,0:00:03,3,0:00:03,0,3
2015-10-17-ccc_waste_recycling_script,2015/10/17,ccc_waste_recycling_script,0,0,0:00:00,0,0:00:00,0,0
2015-10-18-ccc_311_calgary_script,2015/10/18,ccc_311_calgary_script,978,933,0:00:27,27,0:06:26,45,25191
2015-10-18-ccc_311_lobby_ph_script,2015/10/18,ccc_311_lobby_ph_script,0,0,0:00:00,0,0:00:00,0,0
2015-10-18-ccc_aserv_info_script,2015/10/18,ccc_aserv_info_script,0,0,0:00:00,0,0:00:00,0,0
2015-10-18-ccc_bylaw_script,2015/10/18,ccc_bylaw_script,0,0,0:00:00,0,0:00:00,0,0
2015-10-18-ccc_city_script,2015/10/18,ccc_city_script,0,0,0:00:00,0,0:00:00,0,0
2015-10-18-ccc_cty_online_script,2015/10/18,ccc_cty_online_script,0,0,0:00:00,0,0:00:00,0,0
2015-10-18-ccc_feedback_script,2015/10/18,ccc_feedback_script,0,0,0:00:00,0,0:00:00,0,0
2015-10-18-ccc_fpb_script,2015/10/18,ccc_fpb_script,0,0,0:00:00,0,0:00:00,0,0
2015-10-18-ccc_help_script,2015/10/18,ccc_help_script,1,1,0:00:52,52,0:00:52,0,52
2015-10-18-ccc_link_script,2015/10/18,ccc_link_script,0,0,0:00:00,0,0:00:00,0,0
2015-10-18-ccc_media_line_script,2015/10/18,ccc_media_line_script,3,3,0:00:04,4,0:00:08,0,12
2015-10-18-ccc_priority_script,2015/10/18,ccc_priority_script,25,24,0:00:17,17,0:01:32,1,408
2015-10-18-ccc_tax_script,2015/10/18,ccc_tax_script,0,0,0:00:00,0,0:00:00,0,0
2015-10-18-ccc_waste_recycling_script,2015/10/18,ccc_waste_recycling_script,0,0,0:00:00,0,0:00:00,0,0
2015-10-19-ccc_311_calgary_script,2015/10/19,ccc_311_calgary_script,3496,3266,0:00:53,53,0:05:05,230,173098
2015-10-19-ccc_311_lobby_ph_script,2015/10/19,ccc_311_lobby_ph_script,3,3,0:00:09,9,0:00:24,0,27
2015-10-19-ccc_aserv_info_script,2015/10/19,ccc_aserv_info_script,0,0,0:00:00,0,0:00:00,0,0
2015-10-19-ccc_bylaw_script,2015/10/19,ccc_bylaw_script,0,0,0:00:00,0,0:00:00,0,0
2015-10-19-ccc_city_script,2015/10/19,ccc_city_script,20,20,0:00:10,10,0:00:23,0,200
2015-10-19-ccc_cty_online_script,2015/10/19,ccc_cty_online_script,0,0,0:00:00,0,0:00:00,0,0
2015-10-19-ccc_feedback_script,2015/10/19,ccc_feedback_script,0,0,0:00:00,0,0:00:00,0,0
2015-10-19-ccc_fpb_script,2015/10/19,ccc_fpb_script,1,1,0:00:08,8,0:00:08,0,8
2015-10-19-ccc_help_script,2015/10/19,ccc_help_script,4,3,0:00:04,4,0:00:05,1,12
2015-10-19-ccc_link_script,2015/10/19,ccc_link_script,0,0,0:00:00,0,0:00:00,0,0
2015-10-19-ccc_media_line_script,2015/10/19,ccc_media_line_script,0,0,0:00:00,0,0:00:00,0,0
2015-10-19-ccc_priority_script,2015/10/19,ccc_priority_script,28,27,0:00:11,11,0:00:56,1,297
2015-10-19-ccc_tax_script,2015/10/19,ccc_tax_script,18,18,0:00:45,45,0:02:09,0,810
2015-10-19-ccc_waste_recycling_script,2015/10/19,ccc_waste_recycling_script,0,0,0:00:00,0,0:00:00,0,0
2015-10-20-ccc_311_calgary_script,2015/10/20,ccc_311_calgary_script,3386,2783,0:02:57,177,0:09:05,603,492591
2015-10-20-ccc_311_lobby_ph_script,2015/10/20,ccc_311_lobby_ph_script,5,3,0:00:13,13,0:00:20,2,39
2015-10-20-ccc_aserv_info_script,2015/10/20,ccc_aserv_info_script,0,0,0:00:00,0,0:00:00,0,0
2015-10-20-ccc_bylaw_script,2015/10/20,ccc_bylaw_script,0,0,0:00:00,0,0:00:00,0,0
2015-10-20-ccc_city_script,2015/10/20,ccc_city_script,10,10,0:00:35,35,0:02:44,0,350
2015-10-20-ccc_cty_online_script,2015/10/20,ccc_cty_online_script,0,0,0:00:00,0,0:00:00,0,0
2015-10-20-ccc_feedback_script,2015/10/20,ccc_feedback_script,0,0,0:00:00,0,0:00:00,0,0
2015-10-20-ccc_fpb_script,2015/10/20,ccc_fpb_script,3,0,0:00:00,0,0:00:00,3,0
2015-10-20-ccc_help_script,2015/10/20,ccc_help_script,9,9,0:00:15,15,0:00:36,0,135
2015-10-20-ccc_link_script,2015/10/20,ccc_link_script,0,0,0:00:00,0,0:00:00,0,0
2015-10-20-ccc_media_line_script,2015/10/20,ccc_media_line_script,1,1,0:00:23,23,0:00:23,0,23
2015-10-20-ccc_priority_script,2015/10/20,ccc_priority_script,31,30,0:00:18,18,0:01:16,1,540
2015-10-20-ccc_tax_script,2015/10/20,ccc_tax_script,19,13,0:03:51,231,0:07:02,6,3003
2015-10-20-ccc_waste_recycling_script,2015/10/20,ccc_waste_recycling_script,0,0,0:00:00,0,0:00:00,0,0
2015-10-21-ccc_311_calgary_script,2015/10/21,ccc_311_calgary_script,3566,2910,0:02:53,173,0:10:47,656,503430
2015-10-21-ccc_311_lobby_ph_script,2015/10/21,ccc_311_lobby_ph_script,2,2,0:00:12,12,0:00:18,0,24
2015-10-21-ccc_aserv_info_script,2015/10/21,ccc_aserv_info_script,0,0,0:00:00,0,0:00:00,0,0
2015-10-21-ccc_bylaw_script,2015/10/21,ccc_bylaw_script,0,0,0:00:00,0,0:00:00,0,0
2015-10-21-ccc_city_script,2015/10/21,ccc_city_script,12,12,0:00:57,57,0:05:16,0,684
2015-10-21-ccc_cty_online_script,2015/10/21,ccc_cty_online_script,0,0,0:00:00,0,0:00:00,0,0
2015-10-21-ccc_feedback_script,2015/10/21,ccc_feedback_script,0,0,0:00:00,0,0:00:00,0,0
2015-10-21-ccc_fpb_script,2015/10/21,ccc_fpb_script,0,0,0:00:00,0,0:00:00,0,0
2015-10-21-ccc_help_script,2015/10/21,ccc_help_script,6,6,0:00:14,14,0:00:30,0,84
2015-10-21-ccc_link_script,2015/10/21,ccc_link_script,0,0,0:00:00,0,0:00:00,0,0
2015-10-21-ccc_media_line_script,2015/10/21,ccc_media_line_script,1,1,0:00:48,48,0:00:48,0,48
2015-10-21-ccc_priority_script,2015/10/21,ccc_priority_script,37,32,0:00:13,13,0:00:53,5,416
2015-10-21-ccc_tax_script,2015/10/21,ccc_tax_script,17,11,0:03:30,210,0:08:15,6,2310
2015-10-21-ccc_waste_recycling_script,2015/10/21,ccc_waste_recycling_script,0,0,0:00:00,0,0:00:00,0,0
2015-10-22-ccc_311_calgary_script,2015/10/22,ccc_311_calgary_script,3460,2778,0:02:51,171,0:09:51,682,475038
2015-10-22-ccc_311_lobby_ph_script,2015/10/22,ccc_311_lobby_ph_script,4,3,0:00:15,15,0:00:26,1,45
2015-10-22-ccc_aserv_info_script,2015/10/22,ccc_aserv_info_script,0,0,0:00:00,0,0:00:00,0,0
2015-10-22-ccc_bylaw_script,2015/10/22,ccc_bylaw_script,0,0,0:00:00,0,0:00:00,0,0
2015-10-22-ccc_city_script,2015/10/22,ccc_city_script,9,9,0:01:11,71,0:04:28,0,639
2015-10-22-ccc_cty_online_script,2015/10/22,ccc_cty_online_script,0,0,0:00:00,0,0:00:00,0,0
2015-10-22-ccc_feedback_script,2015/10/22,ccc_feedback_script,0,0,0:00:00,0,0:00:00,0,0
2015-10-22-ccc_fpb_script,2015/10/22,ccc_fpb_script,0,0,0:00:00,0,0:00:00,0,0
2015-10-22-ccc_help_script,2015/10/22,ccc_help_script,17,15,0:00:12,12,0:00:24,2,180
2015-10-22-ccc_link_script,2015/10/22,ccc_link_script,0,0,0:00:00,0,0:00:00,0,0
2015-10-22-ccc_media_line_script,2015/10/22,ccc_media_line_script,2,1,0:00:23,23,0:00:23,1,23
2015-10-22-ccc_priority_script,2015/10/22,ccc_priority_script,35,34,0:00:16,16,0:02:06,1,544
2015-10-22-ccc_tax_script,2015/10/22,ccc_tax_script,16,13,0:04:24,264,0:07:17,3,3432
2015-10-22-ccc_waste_recycling_script,2015/10/22,ccc_waste_recycling_script,0,0,0:00:00,0,0:00:00,0,0
2015-10-23-ccc_311_calgary_script,2015/10/23,ccc_311_calgary_script,2999,2662,0:01:38,98,0:12:54,337,260876
2015-10-23-ccc_311_lobby_ph_script,2015/10/23,ccc_311_lobby_ph_script,4,3,0:00:07,7,0:00:16,1,21
2015-10-23-ccc_aserv_info_script,2015/10/23,ccc_aserv_info_script,0,0,0:00:00,0,0:00:00,0,0
2015-10-23-ccc_bylaw_script,2015/10/23,ccc_bylaw_script,0,0,0:00:00,0,0:00:00,0,0
2015-10-23-ccc_city_script,2015/10/23,ccc_city_script,13,13,0:00:17,17,0:01:27,0,221
2015-10-23-ccc_cty_online_script,2015/10/23,ccc_cty_online_script,0,0,0:00:00,0,0:00:00,0,0
2015-10-23-ccc_feedback_script,2015/10/23,ccc_feedback_script,0,0,0:00:00,0,0:00:00,0,0
2015-10-23-ccc_fpb_script,2015/10/23,ccc_fpb_script,0,0,0:00:00,0,0:00:00,0,0
2015-10-23-ccc_help_script,2015/10/23,ccc_help_script,5,2,0:00:16,16,0:00:24,3,32
2015-10-23-ccc_link_script,2015/10/23,ccc_link_script,0,0,0:00:00,0,0:00:00,0,0
2015-10-23-ccc_media_line_script,2015/10/23,ccc_media_line_script,0,0,0:00:00,0,0:00:00,0,0
2015-10-23-ccc_priority_script,2015/10/23,ccc_priority_script,34,33,0:00:12,12,0:00:46,1,396
2015-10-23-ccc_tax_script,2015/10/23,ccc_tax_script,11,10,0:03:06,186,0:05:54,1,1860
2015-10-23-ccc_waste_recycling_script,2015/10/23,ccc_waste_recycling_script,0,0,0:00:00,0,0:00:00,0,0
2015-10-24-ccc_311_calgary_script,2015/10/24,ccc_311_calgary_script,1035,1011,0:00:16,16,0:05:11,24,16176
2015-10-24-ccc_311_lobby_ph_script,2015/10/24,ccc_311_lobby_ph_script,0,0,0:00:00,0,0:00:00,0,0
2015-10-24-ccc_aserv_info_script,2015/10/24,ccc_aserv_info_script,0,0,0:00:00,0,0:00:00,0,0
2015-10-24-ccc_bylaw_script,2015/10/24,ccc_bylaw_script,0,0,0:00:00,0,0:00:00,0,0
2015-10-24-ccc_city_script,2015/10/24,ccc_city_script,0,0,0:00:00,0,0:00:00,0,0
2015-10-24-ccc_cty_online_script,2015/10/24,ccc_cty_online_script,0,0,0:00:00,0,0:00:00,0,0
2015-10-24-ccc_feedback_script,2015/10/24,ccc_feedback_script,0,0,0:00:00,0,0:00:00,0,0
2015-10-24-ccc_fpb_script,2015/10/24,ccc_fpb_script,0,0,0:00:00,0,0:00:00,0,0
2015-10-24-ccc_help_script,2015/10/24,ccc_help_script,7,7,0:00:06,6,0:00:13,0,42
2015-10-24-ccc_link_script,2015/10/24,ccc_link_script,0,0,0:00:00,0,0:00:00,0,0
2015-10-24-ccc_media_line_script,2015/10/24,ccc_media_line_script,1,1,0:00:16,16,0:00:16,0,16
2015-10-24-ccc_priority_script,2015/10/24,ccc_priority_script,24,23,0:00:08,8,0:00:33,1,184
2015-10-24-ccc_tax_script,2015/10/24,ccc_tax_script,0,0,0:00:00,0,0:00:00,0,0
2015-10-24-ccc_waste_recycling_script,2015/10/24,ccc_waste_recycling_script,0,0,0:00:00,0,0:00:00,0,0
2015-10-25-ccc_311_calgary_script,2015/10/25,ccc_311_calgary_script,964,862,0:00:48,48,0:12:22,102,41376
2015-10-25-ccc_311_lobby_ph_script,2015/10/25,ccc_311_lobby_ph_script,0,0,0:00:00,0,0:00:00,0,0
2015-10-25-ccc_aserv_info_script,2015/10/25,ccc_aserv_info_script,0,0,0:00:00,0,0:00:00,0,0
2015-10-25-ccc_bylaw_script,2015/10/25,ccc_bylaw_script,0,0,0:00:00,0,0:00:00,0,0
2015-10-25-ccc_city_script,2015/10/25,ccc_city_script,0,0,0:00:00,0,0:00:00,0,0
2015-10-25-ccc_cty_online_script,2015/10/25,ccc_cty_online_script,0,0,0:00:00,0,0:00:00,0,0
2015-10-25-ccc_feedback_script,2015/10/25,ccc_feedback_script,0,0,0:00:00,0,0:00:00,0,0
2015-10-25-ccc_fpb_script,2015/10/25,ccc_fpb_script,0,0,0:00:00,0,0:00:00,0,0
2015-10-25-ccc_help_script,2015/10/25,ccc_help_script,1,1,0:00:04,4,0:00:04,0,4
2015-10-25-ccc_link_script,2015/10/25,ccc_link_script,0,0,0:00:00,0,0:00:00,0,0
2015-10-25-ccc_media_line_script,2015/10/25,ccc_media_line_script,0,0,0:00:00,0,0:00:00,0,0
2015-10-25-ccc_priority_script,2015/10/25,ccc_priority_script,12,12,0:00:06,6,0:00:12,0,72
2015-10-25-ccc_tax_script,2015/10/25,ccc_tax_script,0,0,0:00:00,0,0:00:00,0,0
2015-10-25-ccc_waste_recycling_script,2015/10/25,ccc_waste_recycling_script,0,0,0:00:00,0,0:00:00,0,0
2015-10-26-ccc_311_calgary_script,2015/10/26,ccc_311_calgary_script,3478,3074,0:02:02,122,0:09:00,404,375028
2015-10-26-ccc_311_lobby_ph_script,2015/10/26,ccc_311_lobby_ph_script,2,2,0:00:04,4,0:00:05,0,8
2015-10-26-ccc_aserv_info_script,2015/10/26,ccc_aserv_info_script,0,0,0:00:00,0,0:00:00,0,0
2015-10-26-ccc_bylaw_script,2015/10/26,ccc_bylaw_script,0,0,0:00:00,0,0:00:00,0,0
2015-10-26-ccc_city_script,2015/10/26,ccc_city_script,26,25,0:00:08,8,0:00:29,1,200
2015-10-26-ccc_cty_online_script,2015/10/26,ccc_cty_online_script,0,0,0:00:00,0,0:00:00,0,0
2015-10-26-ccc_feedback_script,2015/10/26,ccc_feedback_script,0,0,0:00:00,0,0:00:00,0,0
2015-10-26-ccc_fpb_script,2015/10/26,ccc_fpb_script,0,0,0:00:00,0,0:00:00,0,0
2015-10-26-ccc_help_script,2015/10/26,ccc_help_script,8,8,0:00:11,11,0:00:26,0,88
2015-10-26-ccc_link_script,2015/10/26,ccc_link_script,0,0,0:00:00,0,0:00:00,0,0
2015-10-26-ccc_media_line_script,2015/10/26,ccc_media_line_script,1,0,0:00:00,0,0:00:00,1,0
2015-10-26-ccc_priority_script,2015/10/26,ccc_priority_script,28,26,0:00:13,13,0:00:41,2,338
2015-10-26-ccc_tax_script,2015/10/26,ccc_tax_script,14,12,0:03:55,235,0:07:46,2,2820
2015-10-26-ccc_waste_recycling_script,2015/10/26,ccc_waste_recycling_script,0,0,0:00:00,0,0:00:00,0,0
2015-10-27-ccc_311_calgary_script,2015/10/27,ccc_311_calgary_script,3271,2840,0:02:06,126,0:09:56,431,357840
2015-10-27-ccc_311_lobby_ph_script,2015/10/27,ccc_311_lobby_ph_script,2,1,0:00:20,20,0:00:20,1,20
2015-10-27-ccc_aserv_info_script,2015/10/27,ccc_aserv_info_script,0,0,0:00:00,0,0:00:00,0,0
2015-10-27-ccc_bylaw_script,2015/10/27,ccc_bylaw_script,0,0,0:00:00,0,0:00:00,0,0
2015-10-27-ccc_city_script,2015/10/27,ccc_city_script,11,11,0:00:19,19,0:00:55,0,209
2015-10-27-ccc_cty_online_script,2015/10/27,ccc_cty_online_script,0,0,0:00:00,0,0:00:00,0,0
2015-10-27-ccc_feedback_script,2015/10/27,ccc_feedback_script,0,0,0:00:00,0,0:00:00,0,0
2015-10-27-ccc_fpb_script,2015/10/27,ccc_fpb_script,0,0,0:00:00,0,0:00:00,0,0
2015-10-27-ccc_help_script,2015/10/27,ccc_help_script,10,9,0:00:30,30,0:01:34,1,270
2015-10-27-ccc_link_script,2015/10/27,ccc_link_script,0,0,0:00:00,0,0:00:00,0,0
2015-10-27-ccc_media_line_script,2015/10/27,ccc_media_line_script,3,3,0:00:14,14,0:00:27,0,42
2015-10-27-ccc_priority_script,2015/10/27,ccc_priority_script,39,38,0:00:14,14,0:00:44,1,532
2015-10-27-ccc_tax_script,2015/10/27,ccc_tax_script,24,22,0:02:41,161,0:07:40,2,3542
2015-10-27-ccc_waste_recycling_script,2015/10/27,ccc_waste_recycling_script,0,0,0:00:00,0,0:00:00,0,0
2015-10-28-ccc_311_calgary_script,2015/10/28,ccc_311_calgary_script,3089,2699,0:01:21,81,0:05:51,390,218619
2015-10-28-ccc_311_lobby_ph_script,2015/10/28,ccc_311_lobby_ph_script,3,3,0:00:10,10,0:00:16,0,30
2015-10-28-ccc_aserv_info_script,2015/10/28,ccc_aserv_info_script,0,0,0:00:00,0,0:00:00,0,0
2015-10-28-ccc_bylaw_script,2015/10/28,ccc_bylaw_script,0,0,0:00:00,0,0:00:00,0,0
2015-10-28-ccc_city_script,2015/10/28,ccc_city_script,14,14,0:00:14,14,0:00:54,0,196
2015-10-28-ccc_cty_online_script,2015/10/28,ccc_cty_online_script,0,0,0:00:00,0,0:00:00,0,0
2015-10-28-ccc_feedback_script,2015/10/28,ccc_feedback_script,0,0,0:00:00,0,0:00:00,0,0
2015-10-28-ccc_fpb_script,2015/10/28,ccc_fpb_script,0,0,0:00:00,0,0:00:00,0,0
2015-10-28-ccc_help_script,2015/10/28,ccc_help_script,11,10,0:00:23,23,0:01:19,1,230
2015-10-28-ccc_link_script,2015/10/28,ccc_link_script,0,0,0:00:00,0,0:00:00,0,0
2015-10-28-ccc_media_line_script,2015/10/28,ccc_media_line_script,1,1,0:00:03,3,0:00:03,0,3
2015-10-28-ccc_priority_script,2015/10/28,ccc_priority_script,35,35,0:00:11,11,0:00:40,0,385
2015-10-28-ccc_tax_script,2015/10/28,ccc_tax_script,24,19,0:02:13,133,0:04:29,5,2527
2015-10-28-ccc_waste_recycling_script,2015/10/28,ccc_waste_recycling_script,0,0,0:00:00,0,0:00:00,0,0
2015-10-29-ccc_311_calgary_script,2015/10/29,ccc_311_calgary_script,3089,2699,0:01:21,81,0:05:51,390,218619
2015-10-29-ccc_311_lobby_ph_script,2015/10/29,ccc_311_lobby_ph_script,3,3,0:00:10,10,0:00:16,0,30
2015-10-29-ccc_aserv_info_script,2015/10/29,ccc_aserv_info_script,0,0,0:00:00,0,0:00:00,0,0
2015-10-29-ccc_bylaw_script,2015/10/29,ccc_bylaw_script,0,0,0:00:00,0,0:00:00,0,0
2015-10-29-ccc_city_script,2015/10/29,ccc_city_script,14,14,0:00:14,14,0:00:54,0,196
2015-10-29-ccc_cty_online_script,2015/10/29,ccc_cty_online_script,0,0,0:00:00,0,0:00:00,0,0
2015-10-29-ccc_feedback_script,2015/10/29,ccc_feedback_script,0,0,0:00:00,0,0:00:00,0,0
2015-10-29-ccc_fpb_script,2015/10/29,ccc_fpb_script,0,0,0:00:00,0,0:00:00,0,0
2015-10-29-ccc_help_script,2015/10/29,ccc_help_script,11,10,0:00:23,23,0:01:19,1,230
2015-10-29-ccc_link_script,2015/10/29,ccc_link_script,0,0,0:00:00,0,0:00:00,0,0
2015-10-29-ccc_media_line_script,2015/10/29,ccc_media_line_script,1,1,0:00:03,3,0:00:03,0,3
2015-10-29-ccc_priority_script,2015/10/29,ccc_priority_script,35,35,0:00:11,11,0:00:40,0,385
2015-10-29-ccc_tax_script,2015/10/29,ccc_tax_script,24,19,0:02:13,133,0:04:29,5,2527
2015-10-29-ccc_waste_recycling_script,2015/10/29,ccc_waste_recycling_script,0,0,0:00:00,0,0:00:00,0,0
2015-10-30-ccc_311_calgary_script,2015/10/30,ccc_311_calgary_script,2925,2467,0:01:52,112,0:11:32,458,276304
2015-10-30-ccc_311_lobby_ph_script,2015/10/30,ccc_311_lobby_ph_script,3,2,0:00:25,25,0:00:29,1,50
2015-10-30-ccc_aserv_info_script,2015/10/30,ccc_aserv_info_script,0,0,0:00:00,0,0:00:00,0,0
2015-10-30-ccc_bylaw_script,2015/10/30,ccc_bylaw_script,0,0,0:00:00,0,0:00:00,0,0
2015-10-30-ccc_city_script,2015/10/30,ccc_city_script,27,24,0:00:30,30,0:04:15,3,720
2015-10-30-ccc_cty_online_script,2015/10/30,ccc_cty_online_script,0,0,0:00:00,0,0:00:00,0,0
2015-10-30-ccc_feedback_script,2015/10/30,ccc_feedback_script,0,0,0:00:00,0,0:00:00,0,0
2015-10-30-ccc_fpb_script,2015/10/30,ccc_fpb_script,1,1,0:04:22,262,0:04:22,0,262
2015-10-30-ccc_help_script,2015/10/30,ccc_help_script,6,5,0:00:11,11,0:00:17,1,55
2015-10-30-ccc_link_script,2015/10/30,ccc_link_script,0,0,0:00:00,0,0:00:00,0,0
2015-10-30-ccc_media_line_script,2015/10/30,ccc_media_line_script,1,1,0:00:31,31,0:00:31,0,31
2015-10-30-ccc_priority_script,2015/10/30,ccc_priority_script,30,29,0:00:25,25,0:05:16,1,725
2015-10-30-ccc_tax_script,2015/10/30,ccc_tax_script,26,23,0:02:34,154,0:06:39,3,3542
2015-10-30-ccc_waste_recycling_script,2015/10/30,ccc_waste_recycling_script,0,0,0:00:00,0,0:00:00,0,0
2015-10-31-ccc_311_calgary_script,2015/10/31,ccc_311_calgary_script,1204,1103,0:00:44,44,0:08:00,101,48532
2015-10-31-ccc_311_lobby_ph_script,2015/10/31,ccc_311_lobby_ph_script,0,0,0:00:00,0,0:00:00,0,0
2015-10-31-ccc_aserv_info_script,2015/10/31,ccc_aserv_info_script,0,0,0:00:00,0,0:00:00,0,0
2015-10-31-ccc_bylaw_script,2015/10/31,ccc_bylaw_script,0,0,0:00:00,0,0:00:00,0,0
2015-10-31-ccc_city_script,2015/10/31,ccc_city_script,0,0,0:00:00,0,0:00:00,0,0
2015-10-31-ccc_cty_online_script,2015/10/31,ccc_cty_online_script,0,0,0:00:00,0,0:00:00,0,0
2015-10-31-ccc_feedback_script,2015/10/31,ccc_feedback_script,0,0,0:00:00,0,0:00:00,0,0
2015-10-31-ccc_fpb_script,2015/10/31,ccc_fpb_script,0,0,0:00:00,0,0:00:00,0,0
2015-10-31-ccc_help_script,2015/10/31,ccc_help_script,3,3,0:00:13,13,0:00:26,0,39
2015-10-31-ccc_link_script,2015/10/31,ccc_link_script,0,0,0:00:00,0,0:00:00,0,0
2015-10-31-ccc_media_line_script,2015/10/31,ccc_media_line_script,0,0,0:00:00,0,0:00:00,0,0
2015-10-31-ccc_priority_script,2015/10/31,ccc_priority_script,44,41,0:00:23,23,0:03:26,3,943
2015-10-31-ccc_tax_script,2015/10/31,ccc_tax_script,0,0,0:00:00,0,0:00:00,0,0
2015-10-31-ccc_waste_recycling_script,2015/10/31,ccc_waste_recycling_script,0,0,0:00:00,0,0:00:00,0,0
2015-11-01-ccc_311_calgary_script,2015/11/01,ccc_311_calgary_script,1088,1007,0:00:30,30,0:06:29,81,30210
2015-11-01-ccc_311_lobby_ph_script,2015/11/01,ccc_311_lobby_ph_script,0,0,0:00:00,0,0:00:00,0,0
2015-11-01-ccc_aserv_info_script,2015/11/01,ccc_aserv_info_script,0,0,0:00:00,0,0:00:00,0,0
2015-11-01-ccc_bylaw_script,2015/11/01,ccc_bylaw_script,0,0,0:00:00,0,0:00:00,0,0
2015-11-01-ccc_city_script,2015/11/01,ccc_city_script,0,0,0:00:00,0,0:00:00,0,0
2015-11-01-ccc_cty_online_script,2015/11/01,ccc_cty_online_script,0,0,0:00:00,0,0:00:00,0,0
2015-11-01-ccc_feedback_script,2015/11/01,ccc_feedback_script,1,0,0:00:00,0,0:00:00,0,0
2015-11-01-ccc_fpb_script,2015/11/01,ccc_fpb_script,1,0,0:00:00,0,0:00:00,1,0
2015-11-01-ccc_help_script,2015/11/01,ccc_help_script,1,1,0:00:22,22,0:00:22,0,22
2015-11-01-ccc_link_script,2015/11/01,ccc_link_script,0,0,0:00:00,0,0:00:00,0,0
2015-11-01-ccc_media_line_script,2015/11/01,ccc_media_line_script,0,0,0:00:00,0,0:00:00,0,0
2015-11-01-ccc_priority_script,2015/11/01,ccc_priority_script,21,20,0:00:11,11,0:01:34,1,220
2015-11-01-ccc_tax_script,2015/11/01,ccc_tax_script,0,0,0:00:00,0,0:00:00,0,0
2015-11-01-ccc_waste_recycling_script,2015/11/01,ccc_waste_recycling_script,0,0,0:00:00,0,0:00:00,0,0
2015-11-02-ccc_311_calgary_script,2015/11/02,ccc_311_calgary_script,3474,3016,0:01:34,94,0:06:07,457,283504
2015-11-02-ccc_311_lobby_ph_script,2015/11/02,ccc_311_lobby_ph_script,4,3,0:00:06,6,0:00:12,1,18
2015-11-02-ccc_aserv_info_script,2015/11/02,ccc_aserv_info_script,0,0,0:00:00,0,0:00:00,0,0
2015-11-02-ccc_bylaw_script,2015/11/02,ccc_bylaw_script,0,0,0:00:00,0,0:00:00,0,0
2015-11-02-ccc_city_script,2015/11/02,ccc_city_script,7,6,0:00:20,20,0:00:40,1,120
2015-11-02-ccc_cty_online_script,2015/11/02,ccc_cty_online_script,0,0,0:00:00,0,0:00:00,0,0
2015-11-02-ccc_feedback_script,2015/11/02,ccc_feedback_script,0,0,0:00:00,0,0:00:00,0,0
2015-11-02-ccc_fpb_script,2015/11/02,ccc_fpb_script,3,2,0:01:04,64,0:02:04,1,128
2015-11-02-ccc_help_script,2015/11/02,ccc_help_script,4,4,0:00:12,12,0:00:25,0,48
2015-11-02-ccc_link_script,2015/11/02,ccc_link_script,0,0,0:00:00,0,0:00:00,0,0
2015-11-02-ccc_media_line_script,2015/11/02,ccc_media_line_script,0,0,0:00:00,0,0:00:00,0,0
2015-11-02-ccc_priority_script,2015/11/02,ccc_priority_script,26,26,0:00:12,12,0:00:56,0,312
2015-11-02-ccc_tax_script,2015/11/02,ccc_tax_script,16,15,0:02:47,167,0:04:50,1,2505
2015-11-02-ccc_waste_recycling_script,2015/11/02,ccc_waste_recycling_script,0,0,0:00:00,0,0:00:00,0,0
2015-11-03-ccc_311_calgary_script,2015/11/03,ccc_311_calgary_script,3119,2794,0:01:36,96,0:09:17,326,268224
2015-11-03-ccc_311_lobby_ph_script,2015/11/03,ccc_311_lobby_ph_script,2,1,0:00:06,6,0:00:06,1,6
2015-11-03-ccc_aserv_info_script,2015/11/03,ccc_aserv_info_script,0,0,0:00:00,0,0:00:00,0,0
2015-11-03-ccc_bylaw_script,2015/11/03,ccc_bylaw_script,0,0,0:00:00,0,0:00:00,0,0
2015-11-03-ccc_city_script,2015/11/03,ccc_city_script,7,7,0:00:23,23,0:01:32,0,161
2015-11-03-ccc_cty_online_script,2015/11/03,ccc_cty_online_script,0,0,0:00:00,0,0:00:00,0,0
2015-11-03-ccc_feedback_script,2015/11/03,ccc_feedback_script,0,0,0:00:00,0,0:00:00,0,0
2015-11-03-ccc_fpb_script,2015/11/03,ccc_fpb_script,0,0,0:00:00,0,0:00:00,0,0
2015-11-03-ccc_help_script,2015/11/03,ccc_help_script,2,2,0:00:22,22,0:00:31,0,44
2015-11-03-ccc_link_script,2015/11/03,ccc_link_script,0,0,0:00:00,0,0:00:00,0,0
2015-11-03-ccc_media_line_script,2015/11/03,ccc_media_line_script,0,0,0:00:00,0,0:00:00,0,0
2015-11-03-ccc_priority_script,2015/11/03,ccc_priority_script,42,42,0:00:14,14,0:01:56,0,588
2015-11-03-ccc_tax_script,2015/11/03,ccc_tax_script,22,22,0:02:21,141,0:07:58,0,3102
2015-11-03-ccc_waste_recycling_script,2015/11/03,ccc_waste_recycling_script,0,0,0:00:00,0,0:00:00,0,0
2015-11-04-ccc_311_calgary_script,2015/11/04,ccc_311_calgary_script,3382,2929,0:01:59,119,0:08:24,453,348551
2015-11-04-ccc_311_lobby_ph_script,2015/11/04,ccc_311_lobby_ph_script,3,2,0:00:18,18,0:00:30,1,36
2015-11-04-ccc_aserv_info_script,2015/11/04,ccc_aserv_info_script,0,0,0:00:00,0,0:00:00,0,0
2015-11-04-ccc_bylaw_script,2015/11/04,ccc_bylaw_script,0,0,0:00:00,0,0:00:00,0,0
2015-11-04-ccc_city_script,2015/11/04,ccc_city_script,17,17,0:00:14,14,0:00:41,0,238
2015-11-04-ccc_cty_online_script,2015/11/04,ccc_cty_online_script,0,0,0:00:00,0,0:00:00,0,0
2015-11-04-ccc_feedback_script,2015/11/04,ccc_feedback_script,0,0,0:00:00,0,0:00:00,0,0
2015-11-04-ccc_fpb_script,2015/11/04,ccc_fpb_script,0,0,0:00:00,0,0:00:00,0,0
2015-11-04-ccc_help_script,2015/11/04,ccc_help_script,7,6,0:00:14,14,0:00:31,1,84
2015-11-04-ccc_link_script,2015/11/04,ccc_link_script,0,0,0:00:00,0,0:00:00,0,0
2015-11-04-ccc_media_line_script,2015/11/04,ccc_media_line_script,1,1,0:00:02,2,0:00:02,0,2
2015-11-04-ccc_priority_script,2015/11/04,ccc_priority_script,31,27,0:00:14,14,0:01:21,4,378
2015-11-04-ccc_tax_script,2015/11/04,ccc_tax_script,16,16,0:02:13,133,0:08:09,0,2128
2015-11-04-ccc_waste_recycling_script,2015/11/04,ccc_waste_recycling_script,0,0,0:00:00,0,0:00:00,0,0
2015-11-05-ccc_311_calgary_script,2015/11/05,ccc_311_calgary_script,3079,2754,0:01:23,83,0:06:12,325,228582
2015-11-05-ccc_311_lobby_ph_script,2015/11/05,ccc_311_lobby_ph_script,6,6,0:00:08,8,0:00:21,0,48
2015-11-05-ccc_aserv_info_script,2015/11/05,ccc_aserv_info_script,0,0,0:00:00,0,0:00:00,0,0
2015-11-05-ccc_bylaw_script,2015/11/05,ccc_bylaw_script,0,0,0:00:00,0,0:00:00,0,0
2015-11-05-ccc_city_script,2015/11/05,ccc_city_script,9,9,0:00:31,31,0:02:16,0,279
2015-11-05-ccc_cty_online_script,2015/11/05,ccc_cty_online_script,0,0,0:00:00,0,0:00:00,0,0
2015-11-05-ccc_feedback_script,2015/11/05,ccc_feedback_script,0,0,0:00:00,0,0:00:00,0,0
2015-11-05-ccc_fpb_script,2015/11/05,ccc_fpb_script,0,0,0:00:00,0,0:00:00,0,0
2015-11-05-ccc_help_script,2015/11/05,ccc_help_script,11,10,0:00:10,10,0:00:15,1,100
2015-11-05-ccc_link_script,2015/11/05,ccc_link_script,0,0,0:00:00,0,0:00:00,0,0
2015-11-05-ccc_media_line_script,2015/11/05,ccc_media_line_script,0,0,0:00:00,0,0:00:00,0,0
2015-11-05-ccc_priority_script,2015/11/05,ccc_priority_script,20,19,0:00:10,10,0:00:36,1,190
2015-11-05-ccc_tax_script,2015/11/05,ccc_tax_script,9,8,0:01:47,107,0:03:46,1,856
2015-11-05-ccc_waste_recycling_script,2015/11/05,ccc_waste_recycling_script,0,0,0:00:00,0,0:00:00,0,0
2015-11-07-ccc_311_calgary_script,2015/11/07,ccc_311_calgary_script,3336,3166,0:00:39,39,0:04:53,170,123474
2015-11-07-ccc_311_lobby_ph_script,2015/11/07,ccc_311_lobby_ph_script,5,5,0:00:07,7,0:00:11,0,35
2015-11-07-ccc_aserv_info_script,2015/11/07,ccc_aserv_info_script,0,0,0:00:00,0,0:00:00,0,0
2015-11-07-ccc_bylaw_script,2015/11/07,ccc_bylaw_script,0,0,0:00:00,0,0:00:00,0,0
2015-11-07-ccc_city_script,2015/11/07,ccc_city_script,21,20,0:00:15,15,0:01:45,1,300
2015-11-07-ccc_cty_online_script,2015/11/07,ccc_cty_online_script,0,0,0:00:00,0,0:00:00,0,0
2015-11-07-ccc_feedback_script,2015/11/07,ccc_feedback_script,0,0,0:00:00,0,0:00:00,0,0
2015-11-07-ccc_fpb_script,2015/11/07,ccc_fpb_script,1,1,0:00:05,5,0:00:05,0,5
2015-11-07-ccc_help_script,2015/11/07,ccc_help_script,14,13,0:00:06,6,0:00:14,1,78
2015-11-07-ccc_link_script,2015/11/07,ccc_link_script,0,0,0:00:00,0,0:00:00,0,0
2015-11-07-ccc_media_line_script,2015/11/07,ccc_media_line_script,1,1,0:00:10,10,0:00:10,0,10
2015-11-07-ccc_priority_script,2015/11/07,ccc_priority_script,35,35,0:00:13,13,0:01:19,0,455
2015-11-07-ccc_tax_script,2015/11/07,ccc_tax_script,9,7,0:00:47,47,0:02:10,2,329
2015-11-07-ccc_waste_recycling_script,2015/11/07,ccc_waste_recycling_script,0,0,0:00:00,0,0:00:00,0,0
2015-11-08-ccc_311_calgary_script,2015/11/08,ccc_311_calgary_script,950,916,0:00:15,15,0:04:24,34,13740
2015-11-08-ccc_311_lobby_ph_script,2015/11/08,ccc_311_lobby_ph_script,0,0,0:00:00,0,0:00:00,0,0
2015-11-08-ccc_aserv_info_script,2015/11/08,ccc_aserv_info_script,0,0,0:00:00,0,0:00:00,0,0
2015-11-08-ccc_bylaw_script,2015/11/08,ccc_bylaw_script,0,0,0:00:00,0,0:00:00,0,0
2015-11-08-ccc_city_script,2015/11/08,ccc_city_script,0,0,0:00:00,0,0:00:00,0,0
2015-11-08-ccc_cty_online_script,2015/11/08,ccc_cty_online_script,0,0,0:00:00,0,0:00:00,0,0
2015-11-08-ccc_feedback_script,2015/11/08,ccc_feedback_script,0,0,0:00:00,0,0:00:00,0,0
2015-11-08-ccc_fpb_script,2015/11/08,ccc_fpb_script,0,0,0:00:00,0,0:00:00,0,0
2015-11-08-ccc_help_script,2015/11/08,ccc_help_script,3,3,0:00:06,6,0:00:07,0,18
2015-11-08-ccc_link_script,2015/11/08,ccc_link_script,0,0,0:00:00,0,0:00:00,0,0
2015-11-08-ccc_media_line_script,2015/11/08,ccc_media_line_script,0,0,0:00:00,0,0:00:00,0,0
2015-11-08-ccc_priority_script,2015/11/08,ccc_priority_script,13,13,0:00:06,6,0:00:13,0,78
2015-11-08-ccc_tax_script,2015/11/08,ccc_tax_script,0,0,0:00:00,0,0:00:00,0,0
2015-11-08-ccc_waste_recycling_script,2015/11/08,ccc_waste_recycling_script,0,0,0:00:00,0,0:00:00,0,0
2015-11-09-ccc_311_calgary_script,2015/11/09,ccc_311_calgary_script,3145,2970,0:00:34,34,0:08:24,175,100980
2015-11-09-ccc_311_lobby_ph_script,2015/11/09,ccc_311_lobby_ph_script,7,7,0:00:07,7,0:00:13,0,49
2015-11-09-ccc_aserv_info_script,2015/11/09,ccc_aserv_info_script,0,0,0:00:00,0,0:00:00,0,0
2015-11-09-ccc_bylaw_script,2015/11/09,ccc_bylaw_script,0,0,0:00:00,0,0:00:00,0,0
2015-11-09-ccc_city_script,2015/11/09,ccc_city_script,23,23,0:00:08,8,0:00:22,0,184
2015-11-09-ccc_cty_online_script,2015/11/09,ccc_cty_online_script,0,0,0:00:00,0,0:00:00,0,0
2015-11-09-ccc_feedback_script,2015/11/09,ccc_feedback_script,0,0,0:00:00,0,0:00:00,0,0
2015-11-09-ccc_fpb_script,2015/11/09,ccc_fpb_script,1,1,0:00:02,2,0:00:02,0,2
2015-11-09-ccc_help_script,2015/11/09,ccc_help_script,4,4,0:00:14,14,0:00:25,0,56
2015-11-09-ccc_link_script,2015/11/09,ccc_link_script,0,0,0:00:00,0,0:00:00,0,0
2015-11-09-ccc_media_line_script,2015/11/09,ccc_media_line_script,2,2,0:00:09,9,0:00:15,0,18
2015-11-09-ccc_priority_script,2015/11/09,ccc_priority_script,26,25,0:00:15,15,0:01:02,1,375
2015-11-09-ccc_tax_script,2015/11/09,ccc_tax_script,20,19,0:00:31,31,0:01:44,1,589
2015-11-09-ccc_waste_recycling_script,2015/11/09,ccc_waste_recycling_script,0,0,0:00:00,0,0:00:00,0,0
2015-11-10-ccc_311_calgary_script,2015/11/10,ccc_311_calgary_script,3319,2863,0:01:43,103,0:11:50,456,294889
2015-11-10-ccc_311_lobby_ph_script,2015/11/10,ccc_311_lobby_ph_script,0,0,0:00:00,0,0:00:00,0,0
2015-11-10-ccc_aserv_info_script,2015/11/10,ccc_aserv_info_script,0,0,0:00:00,0,0:00:00,0,0
2015-11-10-ccc_bylaw_script,2015/11/10,ccc_bylaw_script,0,0,0:00:00,0,0:00:00,0,0
2015-11-10-ccc_city_script,2015/11/10,ccc_city_script,25,24,0:00:41,41,0:08:00,1,984
2015-11-10-ccc_cty_online_script,2015/11/10,ccc_cty_online_script,0,0,0:00:00,0,0:00:00,0,0
2015-11-10-ccc_feedback_script,2015/11/10,ccc_feedback_script,0,0,0:00:00,0,0:00:00,0,0
2015-11-10-ccc_fpb_script,2015/11/10,ccc_fpb_script,2,2,0:00:12,12,0:00:21,0,24
2015-11-10-ccc_help_script,2015/11/10,ccc_help_script,19,19,0:00:12,12,0:00:46,0,228
2015-11-10-ccc_link_script,2015/11/10,ccc_link_script,0,0,0:00:00,0,0:00:00,0,0
2015-11-10-ccc_media_line_script,2015/11/10,ccc_media_line_script,1,1,0:00:08,8,0:00:08,0,8
2015-11-10-ccc_priority_script,2015/11/10,ccc_priority_script,37,37,0:00:14,14,0:01:38,0,518
2015-11-10-ccc_tax_script,2015/11/10,ccc_tax_script,9,8,0:01:10,70,0:03:49,1,560
2015-11-10-ccc_waste_recycling_script,2015/11/10,ccc_waste_recycling_script,0,0,0:00:00,0,0:00:00,0,0
2015-11-11-ccc_311_calgary_script,2015/11/11,ccc_311_calgary_script,1696,1617,0:00:29,29,0:05:44,79,46893
2015-11-11-ccc_311_lobby_ph_script,2015/11/11,ccc_311_lobby_ph_script,0,0,0:00:00,0,0:00:00,0,0
2015-11-11-ccc_aserv_info_script,2015/11/11,ccc_aserv_info_script,0,0,0:00:00,0,0:00:00,0,0
2015-11-11-ccc_bylaw_script,2015/11/11,ccc_bylaw_script,0,0,0:00:00,0,0:00:00,0,0
2015-11-11-ccc_city_script,2015/11/11,ccc_city_script,0,0,0:00:00,0,0:00:00,0,0
2015-11-11-ccc_cty_online_script,2015/11/11,ccc_cty_online_script,0,0,0:00:00,0,0:00:00,0,0
2015-11-11-ccc_feedback_script,2015/11/11,ccc_feedback_script,0,0,0:00:00,0,0:00:00,0,0
2015-11-11-ccc_fpb_script,2015/11/11,ccc_fpb_script,1,1,0:00:07,7,0:00:07,0,7
2015-11-11-ccc_help_script,2015/11/11,ccc_help_script,5,5,0:00:13,13,0:00:41,0,65
2015-11-11-ccc_link_script,2015/11/11,ccc_link_script,0,0,0:00:00,0,0:00:00,0,0
2015-11-11-ccc_media_line_script,2015/11/11,ccc_media_line_script,1,1,0:00:04,4,0:00:04,0,4
2015-11-11-ccc_priority_script,2015/11/11,ccc_priority_script,20,20,0:00:09,9,0:00:44,0,180
2015-11-11-ccc_tax_script,2015/11/11,ccc_tax_script,0,0,0:00:00,0,0:00:00,0,0
2015-11-11-ccc_waste_recycling_script,2015/11/11,ccc_waste_recycling_script,0,0,0:00:00,0,0:00:00,0,0
2015-11-12-ccc_311_calgary_script,2015/11/12,ccc_311_calgary_script,3112,2871,0:01:04,64,0:08:03,241,183744
2015-11-12-ccc_311_lobby_ph_script,2015/11/12,ccc_311_lobby_ph_script,7,6,0:00:08,8,0:00:13,1,48
2015-11-12-ccc_aserv_info_script,2015/11/12,ccc_aserv_info_script,0,0,0:00:00,0,0:00:00,0,0
2015-11-12-ccc_bylaw_script,2015/11/12,ccc_bylaw_script,0,0,0:00:00,0,0:00:00,0,0
2015-11-12-ccc_city_script,2015/11/12,ccc_city_script,9,8,0:00:32,32,0:01:19,1,256
2015-11-12-ccc_cty_online_script,2015/11/12,ccc_cty_online_script,0,0,0:00:00,0,0:00:00,0,0
2015-11-12-ccc_feedback_script,2015/11/12,ccc_feedback_script,0,0,0:00:00,0,0:00:00,0,0
2015-11-12-ccc_fpb_script,2015/11/12,ccc_fpb_script,0,0,0:00:00,0,0:00:00,0,0
2015-11-12-ccc_help_script,2015/11/12,ccc_help_script,9,5,0:00:20,20,0:00:40,4,100
2015-11-12-ccc_link_script,2015/11/12,ccc_link_script,0,0,0:00:00,0,0:00:00,0,0
2015-11-12-ccc_media_line_script,2015/11/12,ccc_media_line_script,1,1,0:00:13,13,0:00:13,0,13
2015-11-12-ccc_priority_script,2015/11/12,ccc_priority_script,22,21,0:00:12,12,0:00:41,1,252
2015-11-12-ccc_tax_script,2015/11/12,ccc_tax_script,16,13,0:01:57,117,0:07:15,3,1521
2015-11-12-ccc_waste_recycling_script,2015/11/12,ccc_waste_recycling_script,0,0,0:00:00,0,0:00:00,0,0
2015-11-13-ccc_311_calgary_script,2015/11/13,ccc_311_calgary_script,3022,2711,0:01:23,83,0:11:13,311,225013
2015-11-13-ccc_311_lobby_ph_script,2015/11/13,ccc_311_lobby_ph_script,1,0,0:00:00,0,0:00:00,1,0
2015-11-13-ccc_aserv_info_script,2015/11/13,ccc_aserv_info_script,0,0,0:00:00,0,0:00:00,0,0
2015-11-13-ccc_bylaw_script,2015/11/13,ccc_bylaw_script,0,0,0:00:00,0,0:00:00,0,0
2015-11-13-ccc_city_script,2015/11/13,ccc_city_script,18,16,0:00:28,28,0:02:40,2,448
2015-11-13-ccc_cty_online_script,2015/11/13,ccc_cty_online_script,0,0,0:00:00,0,0:00:00,0,0
2015-11-13-ccc_feedback_script,2015/11/13,ccc_feedback_script,0,0,0:00:00,0,0:00:00,0,0
2015-11-13-ccc_fpb_script,2015/11/13,ccc_fpb_script,0,0,0:00:00,0,0:00:00,0,0
2015-11-13-ccc_help_script,2015/11/13,ccc_help_script,8,6,0:00:13,13,0:00:46,2,78
2015-11-13-ccc_link_script,2015/11/13,ccc_link_script,0,0,0:00:00,0,0:00:00,0,0
2015-11-13-ccc_media_line_script,2015/11/13,ccc_media_line_script,0,0,0:00:00,0,0:00:00,0,0
2015-11-13-ccc_priority_script,2015/11/13,ccc_priority_script,30,29,0:00:12,12,0:00:58,1,348
2015-11-13-ccc_tax_script,2015/11/13,ccc_tax_script,16,13,0:01:33,93,0:04:59,3,1209
2015-11-13-ccc_waste_recycling_script,2015/11/13,ccc_waste_recycling_script,0,0,0:00:00,0,0:00:00,0,0
2015-11-14-ccc_311_calgary_script,2015/11/14,ccc_311_calgary_script,955,943,0:00:11,11,0:10:28,12,10373
2015-11-14-ccc_311_lobby_ph_script,2015/11/14,ccc_311_lobby_ph_script,0,0,0:00:00,0,0:00:00,0,0
2015-11-14-ccc_aserv_info_script,2015/11/14,ccc_aserv_info_script,0,0,0:00:00,0,0:00:00,0,0
2015-11-14-ccc_bylaw_script,2015/11/14,ccc_bylaw_script,0,0,0:00:00,0,0:00:00,0,0
2015-11-14-ccc_city_script,2015/11/14,ccc_city_script,0,0,0:00:00,0,0:00:00,0,0
2015-11-14-ccc_cty_online_script,2015/11/14,ccc_cty_online_script,0,0,0:00:00,0,0:00:00,0,0
2015-11-14-ccc_feedback_script,2015/11/14,ccc_feedback_script,0,0,0:00:00,0,0:00:00,0,0
2015-11-14-ccc_fpb_script,2015/11/14,ccc_fpb_script,0,0,0:00:00,0,0:00:00,0,0
2015-11-14-ccc_help_script,2015/11/14,ccc_help_script,2,2,0:00:11,11,0:00:19,0,22
2015-11-14-ccc_link_script,2015/11/14,ccc_link_script,0,0,0:00:00,0,0:00:00,0,0
2015-11-14-ccc_media_line_script,2015/11/14,ccc_media_line_script,1,1,0:00:15,15,0:00:15,0,15
2015-11-14-ccc_priority_script,2015/11/14,ccc_priority_script,13,13,0:00:16,16,0:02:27,0,208
2015-11-14-ccc_tax_script,2015/11/14,ccc_tax_script,0,0,0:00:00,0,0:00:00,0,0
2015-11-14-ccc_waste_recycling_script,2015/11/14,ccc_waste_recycling_script,0,0,0:00:00,0,0:00:00,0,0
2015-11-15-ccc_311_calgary_script,2015/11/15,ccc_311_calgary_script,1212,763,0:00:59,59,0:23:50,448,45017
2015-11-15-ccc_311_lobby_ph_script,2015/11/15,ccc_311_lobby_ph_script,0,0,0:00:00,0,0:00:00,0,0
2015-11-15-ccc_aserv_info_script,2015/11/15,ccc_aserv_info_script,0,0,0:00:00,0,0:00:00,0,0
2015-11-15-ccc_bylaw_script,2015/11/15,ccc_bylaw_script,0,0,0:00:00,0,0:00:00,0,0
2015-11-15-ccc_city_script,2015/11/15,ccc_city_script,0,0,0:00:00,0,0:00:00,0,0
2015-11-15-ccc_cty_online_script,2015/11/15,ccc_cty_online_script,0,0,0:00:00,0,0:00:00,0,0
2015-11-15-ccc_feedback_script,2015/11/15,ccc_feedback_script,0,0,0:00:00,0,0:00:00,0,0
2015-11-15-ccc_fpb_script,2015/11/15,ccc_fpb_script,0,0,0:00:00,0,0:00:00,0,0
2015-11-15-ccc_help_script,2015/11/15,ccc_help_script,1,1,0:00:10,10,0:00:10,0,10
2015-11-15-ccc_link_script,2015/11/15,ccc_link_script,0,0,0:00:00,0,0:00:00,0,0
2015-11-15-ccc_media_line_script,2015/11/15,ccc_media_line_script,1,1,0:00:14,14,0:00:14,0,14
2015-11-15-ccc_priority_script,2015/11/15,ccc_priority_script,35,31,0:00:14,14,0:02:38,4,434
2015-11-15-ccc_tax_script,2015/11/15,ccc_tax_script,3,3,0:00:04,4,0:00:06,0,12
2015-11-15-ccc_waste_recycling_script,2015/11/15,ccc_waste_recycling_script,0,0,0:00:00,0,0:00:00,0,0
2015-11-16-ccc_311_calgary_script,2015/11/16,ccc_311_calgary_script,3143,2919,0:01:02,62,0:06:43,225,180978
2015-11-16-ccc_311_lobby_ph_script,2015/11/16,ccc_311_lobby_ph_script,3,3,0:00:13,13,0:00:22,0,39
2015-11-16-ccc_aserv_info_script,2015/11/16,ccc_aserv_info_script,0,0,0:00:00,0,0:00:00,0,0
2015-11-16-ccc_bylaw_script,2015/11/16,ccc_bylaw_script,0,0,0:00:00,0,0:00:00,0,0
2015-11-16-ccc_city_script,2015/11/16,ccc_city_script,13,13,0:00:15,15,0:00:57,0,195
2015-11-16-ccc_cty_online_script,2015/11/16,ccc_cty_online_script,0,0,0:00:00,0,0:00:00,0,0
2015-11-16-ccc_feedback_script,2015/11/16,ccc_feedback_script,1,0,0:00:00,0,0:00:00,0,0
2015-11-16-ccc_fpb_script,2015/11/16,ccc_fpb_script,1,1,0:00:03,3,0:00:03,0,3
2015-11-16-ccc_help_script,2015/11/16,ccc_help_script,14,14,0:00:18,18,0:01:04,0,252
2015-11-16-ccc_link_script,2015/11/16,ccc_link_script,0,0,0:00:00,0,0:00:00,0,0
2015-11-16-ccc_media_line_script,2015/11/16,ccc_media_line_script,0,0,0:00:00,0,0:00:00,0,0
2015-11-16-ccc_priority_script,2015/11/16,ccc_priority_script,20,19,0:00:12,12,0:00:41,1,228
2015-11-16-ccc_tax_script,2015/11/16,ccc_tax_script,27,25,0:01:32,92,0:06:27,2,2300
2015-11-16-ccc_waste_recycling_script,2015/11/16,ccc_waste_recycling_script,0,0,0:00:00,0,0:00:00,0,0
2015-11-17-ccc_311_calgary_script,2015/11/17,ccc_311_calgary_script,3113,2809,0:00:54,54,0:12:01,304,151686
2015-11-17-ccc_311_lobby_ph_script,2015/11/17,ccc_311_lobby_ph_script,4,2,0:00:12,12,0:00:13,2,24
2015-11-17-ccc_aserv_info_script,2015/11/17,ccc_aserv_info_script,0,0,0:00:00,0,0:00:00,0,0
2015-11-17-ccc_bylaw_script,2015/11/17,ccc_bylaw_script,0,0,0:00:00,0,0:00:00,0,0
2015-11-17-ccc_city_script,2015/11/17,ccc_city_script,7,7,0:00:14,14,0:00:36,0,98
2015-11-17-ccc_cty_online_script,2015/11/17,ccc_cty_online_script,0,0,0:00:00,0,0:00:00,0,0
2015-11-17-ccc_feedback_script,2015/11/17,ccc_feedback_script,0,0,0:00:00,0,0:00:00,0,0
2015-11-17-ccc_fpb_script,2015/11/17,ccc_fpb_script,1,1,0:00:03,3,0:00:03,0,3
2015-11-17-ccc_help_script,2015/11/17,ccc_help_script,7,5,0:00:11,11,0:00:22,2,55
2015-11-17-ccc_link_script,2015/11/17,ccc_link_script,0,0,0:00:00,0,0:00:00,0,0
2015-11-17-ccc_media_line_script,2015/11/17,ccc_media_line_script,2,2,0:00:11,11,0:00:13,0,22
2015-11-17-ccc_priority_script,2015/11/17,ccc_priority_script,54,51,0:00:21,21,0:01:44,3,1071
2015-11-17-ccc_tax_script,2015/11/17,ccc_tax_script,16,16,0:00:39,39,0:02:02,0,624
2015-11-17-ccc_waste_recycling_script,2015/11/17,ccc_waste_recycling_script,0,0,0:00:00,0,0:00:00,0,0
2015-11-18-ccc_311_calgary_script,2015/11/18,ccc_311_calgary_script,3361,2927,0:01:25,85,0:07:10,434,248795
2015-11-18-ccc_311_lobby_ph_script,2015/11/18,ccc_311_lobby_ph_script,4,3,0:00:10,10,0:00:20,1,30
2015-11-18-ccc_aserv_info_script,2015/11/18,ccc_aserv_info_script,0,0,0:00:00,0,0:00:00,0,0
2015-11-18-ccc_bylaw_script,2015/11/18,ccc_bylaw_script,0,0,0:00:00,0,0:00:00,0,0
2015-11-18-ccc_city_script,2015/11/18,ccc_city_script,13,13,0:00:58,58,0:03:51,0,754
2015-11-18-ccc_cty_online_script,2015/11/18,ccc_cty_online_script,0,0,0:00:00,0,0:00:00,0,0
2015-11-18-ccc_feedback_script,2015/11/18,ccc_feedback_script,0,0,0:00:00,0,0:00:00,0,0
2015-11-18-ccc_fpb_script,2015/11/18,ccc_fpb_script,0,0,0:00:00,0,0:00:00,0,0
2015-11-18-ccc_help_script,2015/11/18,ccc_help_script,14,14,0:00:15,15,0:00:42,0,210
2015-11-18-ccc_link_script,2015/11/18,ccc_link_script,0,0,0:00:00,0,0:00:00,0,0
2015-11-18-ccc_media_line_script,2015/11/18,ccc_media_line_script,3,3,0:00:14,14,0:00:35,0,42
2015-11-18-ccc_priority_script,2015/11/18,ccc_priority_script,68,66,0:00:17,17,0:02:37,2,1122
2015-11-18-ccc_tax_script,2015/11/18,ccc_tax_script,22,20,0:01:38,98,0:05:54,2,1960
2015-11-18-ccc_waste_recycling_script,2015/11/18,ccc_waste_recycling_script,0,0,0:00:00,0,0:00:00,0,0
2015-11-19-ccc_311_calgary_script,2015/11/19,ccc_311_calgary_script,3500,2782,0:03:07,187,0:14:51,718,520234
2015-11-19-ccc_311_lobby_ph_script,2015/11/19,ccc_311_lobby_ph_script,2,1,0:00:51,51,0:00:51,1,51
2015-11-19-ccc_aserv_info_script,2015/11/19,ccc_aserv_info_script,0,0,0:00:00,0,0:00:00,0,0
2015-11-19-ccc_bylaw_script,2015/11/19,ccc_bylaw_script,0,0,0:00:00,0,0:00:00,0,0
2015-11-19-ccc_city_script,2015/11/19,ccc_city_script,7,6,0:01:40,100,0:04:37,1,600
2015-11-19-ccc_cty_online_script,2015/11/19,ccc_cty_online_script,0,0,0:00:00,0,0:00:00,0,0
2015-11-19-ccc_feedback_script,2015/11/19,ccc_feedback_script,0,0,0:00:00,0,0:00:00,0,0
2015-11-19-ccc_fpb_script,2015/11/19,ccc_fpb_script,2,0,0:00:00,0,0:00:00,2,0
2015-11-19-ccc_help_script,2015/11/19,ccc_help_script,10,10,0:00:16,16,0:00:40,0,160
2015-11-19-ccc_link_script,2015/11/19,ccc_link_script,0,0,0:00:00,0,0:00:00,0,0
2015-11-19-ccc_media_line_script,2015/11/19,ccc_media_line_script,0,0,0:00:00,0,0:00:00,0,0
2015-11-19-ccc_priority_script,2015/11/19,ccc_priority_script,30,29,0:00:14,14,0:00:47,1,406
2015-11-19-ccc_tax_script,2015/11/19,ccc_tax_script,17,13,0:02:41,161,0:05:39,4,2093
2015-11-19-ccc_waste_recycling_script,2015/11/19,ccc_waste_recycling_script,0,0,0:00:00,0,0:00:00,0,0
2015-11-20-ccc_311_calgary_script,2015/11/20,ccc_311_calgary_script,2686,2580,0:00:25,25,0:04:51,106,64500
2015-11-20-ccc_311_lobby_ph_script,2015/11/20,ccc_311_lobby_ph_script,4,4,0:00:09,9,0:00:24,0,36
2015-11-20-ccc_aserv_info_script,2015/11/20,ccc_aserv_info_script,0,0,0:00:00,0,0:00:00,0,0
2015-11-20-ccc_bylaw_script,2015/11/20,ccc_bylaw_script,0,0,0:00:00,0,0:00:00,0,0
2015-11-20-ccc_city_script,2015/11/20,ccc_city_script,8,8,0:00:07,7,0:00:20,0,56
2015-11-20-ccc_cty_online_script,2015/11/20,ccc_cty_online_script,0,0,0:00:00,0,0:00:00,0,0
2015-11-20-ccc_feedback_script,2015/11/20,ccc_feedback_script,0,0,0:00:00,0,0:00:00,0,0
2015-11-20-ccc_fpb_script,2015/11/20,ccc_fpb_script,0,0,0:00:00,0,0:00:00,0,0
2015-11-20-ccc_help_script,2015/11/20,ccc_help_script,12,12,0:00:11,11,0:00:24,0,132
2015-11-20-ccc_link_script,2015/11/20,ccc_link_script,0,0,0:00:00,0,0:00:00,0,0
2015-11-20-ccc_media_line_script,2015/11/20,ccc_media_line_script,0,0,0:00:00,0,0:00:00,0,0
2015-11-20-ccc_priority_script,2015/11/20,ccc_priority_script,28,27,0:00:12,12,0:01:52,1,324
2015-11-20-ccc_tax_script,2015/11/20,ccc_tax_script,8,8,0:00:17,17,0:00:54,0,136
2015-11-20-ccc_waste_recycling_script,2015/11/20,ccc_waste_recycling_script,0,0,0:00:00,0,0:00:00,0,0
2015-11-21-ccc_311_calgary_script,2015/11/21,ccc_311_calgary_script,1031,997,0:00:21,21,0:04:22,34,20937
2015-11-21-ccc_311_lobby_ph_script,2015/11/21,ccc_311_lobby_ph_script,0,0,0:00:00,0,0:00:00,0,0
2015-11-21-ccc_aserv_info_script,2015/11/21,ccc_aserv_info_script,0,0,0:00:00,0,0:00:00,0,0
2015-11-21-ccc_bylaw_script,2015/11/21,ccc_bylaw_script,0,0,0:00:00,0,0:00:00,0,0
2015-11-21-ccc_city_script,2015/11/21,ccc_city_script,0,0,0:00:00,0,0:00:00,0,0
2015-11-21-ccc_cty_online_script,2015/11/21,ccc_cty_online_script,0,0,0:00:00,0,0:00:00,0,0
2015-11-21-ccc_feedback_script,2015/11/21,ccc_feedback_script,0,0,0:00:00,0,0:00:00,0,0
2015-11-21-ccc_fpb_script,2015/11/21,ccc_fpb_script,0,0,0:00:00,0,0:00:00,0,0
2015-11-21-ccc_help_script,2015/11/21,ccc_help_script,6,6,0:00:22,22,0:01:41,0,132
2015-11-21-ccc_link_script,2015/11/21,ccc_link_script,0,0,0:00:00,0,0:00:00,0,0
2015-11-21-ccc_media_line_script,2015/11/21,ccc_media_line_script,0,0,0:00:00,0,0:00:00,0,0
2015-11-21-ccc_priority_script,2015/11/21,ccc_priority_script,28,28,0:00:09,9,0:00:30,0,252
2015-11-21-ccc_tax_script,2015/11/21,ccc_tax_script,2,1,0:00:04,4,0:00:04,1,4
2015-11-21-ccc_waste_recycling_script,2015/11/21,ccc_waste_recycling_script,0,0,0:00:00,0,0:00:00,0,0
2015-11-22-ccc_311_calgary_script,2015/11/22,ccc_311_calgary_script,833,795,0:00:20,20,0:06:27,38,15900
2015-11-22-ccc_311_lobby_ph_script,2015/11/22,ccc_311_lobby_ph_script,0,0,0:00:00,0,0:00:00,0,0
2015-11-22-ccc_aserv_info_script,2015/11/22,ccc_aserv_info_script,0,0,0:00:00,0,0:00:00,0,0
2015-11-22-ccc_bylaw_script,2015/11/22,ccc_bylaw_script,0,0,0:00:00,0,0:00:00,0,0
2015-11-22-ccc_city_script,2015/11/22,ccc_city_script,0,0,0:00:00,0,0:00:00,0,0
2015-11-22-ccc_cty_online_script,2015/11/22,ccc_cty_online_script,0,0,0:00:00,0,0:00:00,0,0
2015-11-22-ccc_feedback_script,2015/11/22,ccc_feedback_script,0,0,0:00:00,0,0:00:00,0,0
2015-11-22-ccc_fpb_script,2015/11/22,ccc_fpb_script,0,0,0:00:00,0,0:00:00,0,0
2015-11-22-ccc_help_script,2015/11/22,ccc_help_script,1,1,0:00:17,17,0:00:17,0,17
2015-11-22-ccc_link_script,2015/11/22,ccc_link_script,0,0,0:00:00,0,0:00:00,0,0
2015-11-22-ccc_media_line_script,2015/11/22,ccc_media_line_script,0,0,0:00:00,0,0:00:00,0,0
2015-11-22-ccc_priority_script,2015/11/22,ccc_priority_script,16,15,0:00:11,11,0:00:39,1,165
2015-11-22-ccc_tax_script,2015/11/22,ccc_tax_script,0,0,0:00:00,0,0:00:00,0,0
2015-11-22-ccc_waste_recycling_script,2015/11/22,ccc_waste_recycling_script,0,0,0:00:00,0,0:00:00,0,0
2015-11-23-ccc_311_calgary_script,2015/11/23,ccc_311_calgary_script,3266,3169,0:00:22,22,0:06:19,97,69718
2015-11-23-ccc_311_lobby_ph_script,2015/11/23,ccc_311_lobby_ph_script,2,2,0:00:17,17,0:00:27,0,34
2015-11-23-ccc_aserv_info_script,2015/11/23,ccc_aserv_info_script,0,0,0:00:00,0,0:00:00,0,0
2015-11-23-ccc_bylaw_script,2015/11/23,ccc_bylaw_script,0,0,0:00:00,0,0:00:00,0,0
2015-11-23-ccc_city_script,2015/11/23,ccc_city_script,27,27,0:00:09,9,0:00:47,0,243
2015-11-23-ccc_cty_online_script,2015/11/23,ccc_cty_online_script,0,0,0:00:00,0,0:00:00,0,0
2015-11-23-ccc_feedback_script,2015/11/23,ccc_feedback_script,0,0,0:00:00,0,0:00:00,0,0
2015-11-23-ccc_fpb_script,2015/11/23,ccc_fpb_script,0,0,0:00:00,0,0:00:00,0,0
2015-11-23-ccc_help_script,2015/11/23,ccc_help_script,9,8,0:00:07,7,0:00:19,1,56
2015-11-23-ccc_link_script,2015/11/23,ccc_link_script,0,0,0:00:00,0,0:00:00,0,0
2015-11-23-ccc_media_line_script,2015/11/23,ccc_media_line_script,0,0,0:00:00,0,0:00:00,0,0
2015-11-23-ccc_priority_script,2015/11/23,ccc_priority_script,26,24,0:00:12,12,0:02:06,2,288
2015-11-23-ccc_tax_script,2015/11/23,ccc_tax_script,22,21,0:00:28,28,0:02:38,1,588
2015-11-23-ccc_waste_recycling_script,2015/11/23,ccc_waste_recycling_script,0,0,0:00:00,0,0:00:00,0,0
2015-11-24-ccc_311_calgary_script,2015/11/24,ccc_311_calgary_script,3164,3013,0:00:34,34,0:06:46,151,102442
2015-11-24-ccc_311_lobby_ph_script,2015/11/24,ccc_311_lobby_ph_script,1,1,0:00:05,5,0:00:05,0,5
2015-11-24-ccc_aserv_info_script,2015/11/24,ccc_aserv_info_script,0,0,0:00:00,0,0:00:00,0,0
2015-11-24-ccc_bylaw_script,2015/11/24,ccc_bylaw_script,0,0,0:00:00,0,0:00:00,0,0
2015-11-24-ccc_city_script,2015/11/24,ccc_city_script,20,20,0:00:19,19,0:02:40,0,380
2015-11-24-ccc_cty_online_script,2015/11/24,ccc_cty_online_script,0,0,0:00:00,0,0:00:00,0,0
2015-11-24-ccc_feedback_script,2015/11/24,ccc_feedback_script,0,0,0:00:00,0,0:00:00,0,0
2015-11-24-ccc_fpb_script,2015/11/24,ccc_fpb_script,0,0,0:00:00,0,0:00:00,0,0
2015-11-24-ccc_help_script,2015/11/24,ccc_help_script,10,10,0:00:15,15,0:01:04,0,150
2015-11-24-ccc_link_script,2015/11/24,ccc_link_script,0,0,0:00:00,0,0:00:00,0,0
2015-11-24-ccc_media_line_script,2015/11/24,ccc_media_line_script,1,1,0:00:09,9,0:00:09,0,9
2015-11-24-ccc_priority_script,2015/11/24,ccc_priority_script,29,29,0:00:20,20,0:04:35,0,580
2015-11-24-ccc_tax_script,2015/11/24,ccc_tax_script,26,25,0:00:20,20,0:01:47,1,500
2015-11-24-ccc_waste_recycling_script,2015/11/24,ccc_waste_recycling_script,0,0,0:00:00,0,0:00:00,0,0
2015-11-25-ccc_311_calgary_script,2015/11/25,ccc_311_calgary_script,3141,2832,0:01:10,70,0:08:37,309,198240
2015-11-25-ccc_311_lobby_ph_script,2015/11/25,ccc_311_lobby_ph_script,4,2,0:00:37,37,0:01:08,2,74
2015-11-25-ccc_aserv_info_script,2015/11/25,ccc_aserv_info_script,0,0,0:00:00,0,0:00:00,0,0
2015-11-25-ccc_bylaw_script,2015/11/25,ccc_bylaw_script,0,0,0:00:00,0,0:00:00,0,0
2015-11-25-ccc_city_script,2015/11/25,ccc_city_script,22,21,0:00:35,35,0:05:01,1,735
2015-11-25-ccc_cty_online_script,2015/11/25,ccc_cty_online_script,0,0,0:00:00,0,0:00:00,0,0
2015-11-25-ccc_feedback_script,2015/11/25,ccc_feedback_script,2,0,0:00:00,0,0:00:00,0,0
2015-11-25-ccc_fpb_script,2015/11/25,ccc_fpb_script,0,0,0:00:00,0,0:00:00,0,0
2015-11-25-ccc_help_script,2015/11/25,ccc_help_script,11,11,0:00:16,16,0:00:43,0,176
2015-11-25-ccc_link_script,2015/11/25,ccc_link_script,0,0,0:00:00,0,0:00:00,0,0
2015-11-25-ccc_media_line_script,2015/11/25,ccc_media_line_script,2,2,0:01:15,75,0:02:18,0,150
2015-11-25-ccc_priority_script,2015/11/25,ccc_priority_script,30,29,0:00:19,19,0:02:33,1,551
2015-11-25-ccc_tax_script,2015/11/25,ccc_tax_script,22,21,0:00:58,58,0:03:41,1,1218
2015-11-25-ccc_waste_recycling_script,2015/11/25,ccc_waste_recycling_script,0,0,0:00:00,0,0:00:00,0,0
2015-11-26-ccc_311_calgary_script,2015/11/26,ccc_311_calgary_script,3083,2800,0:01:13,73,0:07:15,283,204400
2015-11-26-ccc_311_lobby_ph_script,2015/11/26,ccc_311_lobby_ph_script,0,0,0:00:00,0,0:00:00,0,0
2015-11-26-ccc_aserv_info_script,2015/11/26,ccc_aserv_info_script,0,0,0:00:00,0,0:00:00,0,0
2015-11-26-ccc_bylaw_script,2015/11/26,ccc_bylaw_script,0,0,0:00:00,0,0:00:00,0,0
2015-11-26-ccc_city_script,2015/11/26,ccc_city_script,13,13,0:00:33,33,0:01:56,0,429
2015-11-26-ccc_cty_online_script,2015/11/26,ccc_cty_online_script,0,0,0:00:00,0,0:00:00,0,0
2015-11-26-ccc_feedback_script,2015/11/26,ccc_feedback_script,0,0,0:00:00,0,0:00:00,0,0
2015-11-26-ccc_fpb_script,2015/11/26,ccc_fpb_script,1,1,0:00:27,27,0:00:27,0,27
2015-11-26-ccc_help_script,2015/11/26,ccc_help_script,9,8,0:00:23,23,0:01:13,1,184
2015-11-26-ccc_link_script,2015/11/26,ccc_link_script,0,0,0:00:00,0,0:00:00,0,0
2015-11-26-ccc_media_line_script,2015/11/26,ccc_media_line_script,0,0,0:00:00,0,0:00:00,0,0
2015-11-26-ccc_priority_script,2015/11/26,ccc_priority_script,29,27,0:00:16,16,0:01:13,2,432
2015-11-26-ccc_tax_script,2015/11/26,ccc_tax_script,16,16,0:01:12,72,0:02:34,0,1152
2015-11-26-ccc_waste_recycling_script,2015/11/26,ccc_waste_recycling_script,0,0,0:00:00,0,0:00:00,0,0
2015-11-27-ccc_311_calgary_script,2015/11/27,ccc_311_calgary_script,2718,2497,0:01:14,74,0:08:39,221,184778
2015-11-27-ccc_311_lobby_ph_script,2015/11/27,ccc_311_lobby_ph_script,1,0,0:00:00,0,0:00:00,1,0
2015-11-27-ccc_aserv_info_script,2015/11/27,ccc_aserv_info_script,0,0,0:00:00,0,0:00:00,0,0
2015-11-27-ccc_bylaw_script,2015/11/27,ccc_bylaw_script,0,0,0:00:00,0,0:00:00,0,0
2015-11-27-ccc_city_script,2015/11/27,ccc_city_script,17,16,0:00:13,13,0:00:42,1,208
2015-11-27-ccc_cty_online_script,2015/11/27,ccc_cty_online_script,0,0,0:00:00,0,0:00:00,0,0
2015-11-27-ccc_feedback_script,2015/11/27,ccc_feedback_script,0,0,0:00:00,0,0:00:00,0,0
2015-11-27-ccc_fpb_script,2015/11/27,ccc_fpb_script,2,2,0:00:06,6,0:00:08,0,12
2015-11-27-ccc_help_script,2015/11/27,ccc_help_script,18,15,0:00:12,12,0:00:48,3,180
2015-11-27-ccc_link_script,2015/11/27,ccc_link_script,0,0,0:00:00,0,0:00:00,0,0
2015-11-27-ccc_media_line_script,2015/11/27,ccc_media_line_script,0,0,0:00:00,0,0:00:00,0,0
2015-11-27-ccc_priority_script,2015/11/27,ccc_priority_script,20,20,0:00:14,14,0:01:26,0,280
2015-11-27-ccc_tax_script,2015/11/27,ccc_tax_script,16,16,0:00:53,53,0:04:22,0,848
2015-11-27-ccc_waste_recycling_script,2015/11/27,ccc_waste_recycling_script,0,0,0:00:00,0,0:00:00,0,0
2015-11-28-ccc_311_calgary_script,2015/11/28,ccc_311_calgary_script,1006,968,0:00:20,20,0:04:27,38,19360
2015-11-28-ccc_311_lobby_ph_script,2015/11/28,ccc_311_lobby_ph_script,0,0,0:00:00,0,0:00:00,0,0
2015-11-28-ccc_aserv_info_script,2015/11/28,ccc_aserv_info_script,0,0,0:00:00,0,0:00:00,0,0
2015-11-28-ccc_bylaw_script,2015/11/28,ccc_bylaw_script,0,0,0:00:00,0,0:00:00,0,0
2015-11-28-ccc_city_script,2015/11/28,ccc_city_script,0,0,0:00:00,0,0:00:00,0,0
2015-11-28-ccc_cty_online_script,2015/11/28,ccc_cty_online_script,0,0,0:00:00,0,0:00:00,0,0
2015-11-28-ccc_feedback_script,2015/11/28,ccc_feedback_script,0,0,0:00:00,0,0:00:00,0,0
2015-11-28-ccc_fpb_script,2015/11/28,ccc_fpb_script,0,0,0:00:00,0,0:00:00,0,0
2015-11-28-ccc_help_script,2015/11/28,ccc_help_script,1,0,0:00:00,0,0:00:00,1,0
2015-11-28-ccc_link_script,2015/11/28,ccc_link_script,0,0,0:00:00,0,0:00:00,0,0
2015-11-28-ccc_media_line_script,2015/11/28,ccc_media_line_script,0,0,0:00:00,0,0:00:00,0,0
2015-11-28-ccc_priority_script,2015/11/28,ccc_priority_script,36,35,0:00:08,8,0:00:47,1,280
2015-11-28-ccc_tax_script,2015/11/28,ccc_tax_script,1,1,0:00:03,3,0:00:03,0,3
2015-11-28-ccc_waste_recycling_script,2015/11/28,ccc_waste_recycling_script,0,0,0:00:00,0,0:00:00,0,0
2015-11-29-ccc_311_calgary_script,2015/11/29,ccc_311_calgary_script,731,719,0:00:12,12,0:06:29,12,8628
2015-11-29-ccc_311_lobby_ph_script,2015/11/29,ccc_311_lobby_ph_script,0,0,0:00:00,0,0:00:00,0,0
2015-11-29-ccc_aserv_info_script,2015/11/29,ccc_aserv_info_script,0,0,0:00:00,0,0:00:00,0,0
2015-11-29-ccc_bylaw_script,2015/11/29,ccc_bylaw_script,1,0,0:00:00,0,0:00:00,1,0
2015-11-29-ccc_city_script,2015/11/29,ccc_city_script,0,0,0:00:00,0,0:00:00,0,0
2015-11-29-ccc_cty_online_script,2015/11/29,ccc_cty_online_script,0,0,0:00:00,0,0:00:00,0,0
2015-11-29-ccc_feedback_script,2015/11/29,ccc_feedback_script,0,0,0:00:00,0,0:00:00,0,0
2015-11-29-ccc_fpb_script,2015/11/29,ccc_fpb_script,0,0,0:00:00,0,0:00:00,0,0
2015-11-29-ccc_help_script,2015/11/29,ccc_help_script,1,1,0:00:03,3,0:00:03,0,3
2015-11-29-ccc_link_script,2015/11/29,ccc_link_script,0,0,0:00:00,0,0:00:00,0,0
2015-11-29-ccc_media_line_script,2015/11/29,ccc_media_line_script,0,0,0:00:00,0,0:00:00,0,0
2015-11-29-ccc_priority_script,2015/11/29,ccc_priority_script,26,26,0:00:10,10,0:01:06,0,260
2015-11-29-ccc_tax_script,2015/11/29,ccc_tax_script,1,1,0:00:04,4,0:00:04,0,4
2015-11-29-ccc_waste_recycling_script,2015/11/29,ccc_waste_recycling_script,0,0,0:00:00,0,0:00:00,0,0
2015-11-30-ccc_311_calgary_script,2015/11/30,ccc_311_calgary_script,3306,3195,0:00:25,25,0:11:18,111,79875
2015-11-30-ccc_311_lobby_ph_script,2015/11/30,ccc_311_lobby_ph_script,1,1,0:00:03,3,0:00:03,0,3
2015-11-30-ccc_aserv_info_script,2015/11/30,ccc_aserv_info_script,0,0,0:00:00,0,0:00:00,0,0
2015-11-30-ccc_bylaw_script,2015/11/30,ccc_bylaw_script,0,0,0:00:00,0,0:00:00,0,0
2015-11-30-ccc_city_script,2015/11/30,ccc_city_script,17,17,0:00:07,7,0:00:22,0,119
2015-11-30-ccc_cty_online_script,2015/11/30,ccc_cty_online_script,0,0,0:00:00,0,0:00:00,0,0
2015-11-30-ccc_feedback_script,2015/11/30,ccc_feedback_script,1,0,0:00:00,0,0:00:00,0,0
2015-11-30-ccc_fpb_script,2015/11/30,ccc_fpb_script,0,0,0:00:00,0,0:00:00,0,0
2015-11-30-ccc_help_script,2015/11/30,ccc_help_script,10,9,0:00:12,12,0:00:37,1,108
2015-11-30-ccc_link_script,2015/11/30,ccc_link_script,0,0,0:00:00,0,0:00:00,0,0
2015-11-30-ccc_media_line_script,2015/11/30,ccc_media_line_script,1,1,0:00:02,2,0:00:02,0,2
2015-11-30-ccc_priority_script,2015/11/30,ccc_priority_script,29,29,0:00:09,9,0:00:27,0,261
2015-11-30-ccc_tax_script,2015/11/30,ccc_tax_script,14,12,0:00:18,18,0:01:40,2,216
2015-11-30-ccc_waste_recycling_script,2015/11/30,ccc_waste_recycling_script,0,0,0:00:00,0,0:00:00,0,0
2015-12-01-ccc_311_calgary_script,2015/12/01,ccc_311_calgary_script,3129,2934,0:00:59,59,0:07:04,195,173106
2015-12-01-ccc_311_lobby_ph_script,2015/12/01,ccc_311_lobby_ph_script,5,5,0:00:11,11,0:00:22,0,55
2015-12-01-ccc_aserv_info_script,2015/12/01,ccc_aserv_info_script,0,0,0:00:00,0,0:00:00,0,0
2015-12-01-ccc_bylaw_script,2015/12/01,ccc_bylaw_script,0,0,0:00:00,0,0:00:00,0,0
2015-12-01-ccc_city_script,2015/12/01,ccc_city_script,5,5,0:00:12,12,0:00:28,0,60
2015-12-01-ccc_cty_online_script,2015/12/01,ccc_cty_online_script,0,0,0:00:00,0,0:00:00,0,0
2015-12-01-ccc_feedback_script,2015/12/01,ccc_feedback_script,0,0,0:00:00,0,0:00:00,0,0
2015-12-01-ccc_fpb_script,2015/12/01,ccc_fpb_script,0,0,0:00:00,0,0:00:00,0,0
2015-12-01-ccc_help_script,2015/12/01,ccc_help_script,9,8,0:00:06,6,0:00:10,1,48
2015-12-01-ccc_link_script,2015/12/01,ccc_link_script,0,0,0:00:00,0,0:00:00,0,0
2015-12-01-ccc_media_line_script,2015/12/01,ccc_media_line_script,0,0,0:00:00,0,0:00:00,0,0
2015-12-01-ccc_priority_script,2015/12/01,ccc_priority_script,28,28,0:00:11,11,0:00:40,0,308
2015-12-01-ccc_tax_script,2015/12/01,ccc_tax_script,18,18,0:01:06,66,0:03:45,0,1188
2015-12-01-ccc_waste_recycling_script,2015/12/01,ccc_waste_recycling_script,0,0,0:00:00,0,0:00:00,0,0
2015-12-02-ccc_311_calgary_script,2015/12/02,ccc_311_calgary_script,2979,2746,0:01:13,73,0:09:05,233,200458
2015-12-02-ccc_311_lobby_ph_script,2015/12/02,ccc_311_lobby_ph_script,1,1,0:00:19,19,0:00:19,0,19
2015-12-02-ccc_aserv_info_script,2015/12/02,ccc_aserv_info_script,0,0,0:00:00,0,0:00:00,0,0
2015-12-02-ccc_bylaw_script,2015/12/02,ccc_bylaw_script,0,0,0:00:00,0,0:00:00,0,0
2015-12-02-ccc_city_script,2015/12/02,ccc_city_script,13,13,0:00:28,28,0:03:27,0,364
2015-12-02-ccc_cty_online_script,2015/12/02,ccc_cty_online_script,0,0,0:00:00,0,0:00:00,0,0
2015-12-02-ccc_feedback_script,2015/12/02,ccc_feedback_script,0,0,0:00:00,0,0:00:00,0,0
2015-12-02-ccc_fpb_script,2015/12/02,ccc_fpb_script,0,0,0:00:00,0,0:00:00,0,0
2015-12-02-ccc_help_script,2015/12/02,ccc_help_script,14,14,0:00:12,12,0:00:43,0,168
2015-12-02-ccc_link_script,2015/12/02,ccc_link_script,0,0,0:00:00,0,0:00:00,0,0
2015-12-02-ccc_media_line_script,2015/12/02,ccc_media_line_script,4,4,0:00:06,6,0:00:12,0,24
2015-12-02-ccc_priority_script,2015/12/02,ccc_priority_script,26,25,0:00:07,7,0:00:40,1,175
2015-12-02-ccc_tax_script,2015/12/02,ccc_tax_script,18,17,0:01:28,88,0:07:45,1,1496
2015-12-02-ccc_waste_recycling_script,2015/12/02,ccc_waste_recycling_script,0,0,0:00:00,0,0:00:00,0,0
2015-12-03-ccc_311_calgary_script,2015/12/03,ccc_311_calgary_script,2897,2697,0:01:02,62,0:06:21,200,167214
2015-12-03-ccc_311_lobby_ph_script,2015/12/03,ccc_311_lobby_ph_script,0,0,0:00:00,0,0:00:00,0,0
2015-12-03-ccc_aserv_info_script,2015/12/03,ccc_aserv_info_script,0,0,0:00:00,0,0:00:00,0,0
2015-12-03-ccc_bylaw_script,2015/12/03,ccc_bylaw_script,0,0,0:00:00,0,0:00:00,0,0
2015-12-03-ccc_city_script,2015/12/03,ccc_city_script,17,17,0:00:34,34,0:04:38,0,578
2015-12-03-ccc_cty_online_script,2015/12/03,ccc_cty_online_script,0,0,0:00:00,0,0:00:00,0,0
2015-12-03-ccc_feedback_script,2015/12/03,ccc_feedback_script,0,0,0:00:00,0,0:00:00,0,0
2015-12-03-ccc_fpb_script,2015/12/03,ccc_fpb_script,0,0,0:00:00,0,0:00:00,0,0
2015-12-03-ccc_help_script,2015/12/03,ccc_help_script,21,15,0:00:10,10,0:00:44,6,150
2015-12-03-ccc_link_script,2015/12/03,ccc_link_script,0,0,0:00:00,0,0:00:00,0,0
2015-12-03-ccc_media_line_script,2015/12/03,ccc_media_line_script,4,4,0:00:07,7,0:00:11,0,28
2015-12-03-ccc_priority_script,2015/12/03,ccc_priority_script,34,33,0:00:17,17,0:02:53,1,561
2015-12-03-ccc_tax_script,2015/12/03,ccc_tax_script,14,14,0:00:55,55,0:05:11,0,770
2015-12-03-ccc_waste_recycling_script,2015/12/03,ccc_waste_recycling_script,0,0,0:00:00,0,0:00:00,0,0
2015-12-04-ccc_311_calgary_script,2015/12/04,ccc_311_calgary_script,2713,2394,0:01:59,119,0:11:59,319,284886
2015-12-04-ccc_311_lobby_ph_script,2015/12/04,ccc_311_lobby_ph_script,5,3,0:00:11,11,0:00:21,2,33
2015-12-04-ccc_aserv_info_script,2015/12/04,ccc_aserv_info_script,0,0,0:00:00,0,0:00:00,0,0
2015-12-04-ccc_bylaw_script,2015/12/04,ccc_bylaw_script,0,0,0:00:00,0,0:00:00,0,0
2015-12-04-ccc_city_script,2015/12/04,ccc_city_script,12,12,0:00:18,18,0:00:44,0,216
2015-12-04-ccc_cty_online_script,2015/12/04,ccc_cty_online_script,0,0,0:00:00,0,0:00:00,0,0
2015-12-04-ccc_feedback_script,2015/12/04,ccc_feedback_script,0,0,0:00:00,0,0:00:00,0,0
2015-12-04-ccc_fpb_script,2015/12/04,ccc_fpb_script,0,0,0:00:00,0,0:00:00,0,0
2015-12-04-ccc_help_script,2015/12/04,ccc_help_script,10,7,0:00:16,16,0:00:36,3,112
2015-12-04-ccc_link_script,2015/12/04,ccc_link_script,1,0,0:00:00,0,0:00:00,0,0
2015-12-04-ccc_media_line_script,2015/12/04,ccc_media_line_script,0,0,0:00:00,0,0:00:00,0,0
2015-12-04-ccc_priority_script,2015/12/04,ccc_priority_script,27,25,0:00:18,18,0:03:03,2,450
2015-12-04-ccc_tax_script,2015/12/04,ccc_tax_script,17,14,0:02:25,145,0:06:32,3,2030
2015-12-04-ccc_waste_recycling_script,2015/12/04,ccc_waste_recycling_script,0,0,0:00:00,0,0:00:00,0,0
2015-12-05-ccc_311_calgary_script,2015/12/05,ccc_311_calgary_script,1026,927,0:00:53,53,0:06:36,99,49131
2015-12-05-ccc_311_lobby_ph_script,2015/12/05,ccc_311_lobby_ph_script,0,0,0:00:00,0,0:00:00,0,0
2015-12-05-ccc_aserv_info_script,2015/12/05,ccc_aserv_info_script,0,0,0:00:00,0,0:00:00,0,0
2015-12-05-ccc_bylaw_script,2015/12/05,ccc_bylaw_script,0,0,0:00:00,0,0:00:00,0,0
2015-12-05-ccc_city_script,2015/12/05,ccc_city_script,0,0,0:00:00,0,0:00:00,0,0
2015-12-05-ccc_cty_online_script,2015/12/05,ccc_cty_online_script,0,0,0:00:00,0,0:00:00,0,0
2015-12-05-ccc_feedback_script,2015/12/05,ccc_feedback_script,0,0,0:00:00,0,0:00:00,0,0
2015-12-05-ccc_fpb_script,2015/12/05,ccc_fpb_script,0,0,0:00:00,0,0:00:00,0,0
2015-12-05-ccc_help_script,2015/12/05,ccc_help_script,1,1,0:00:08,8,0:00:08,0,8
2015-12-05-ccc_link_script,2015/12/05,ccc_link_script,0,0,0:00:00,0,0:00:00,0,0
2015-12-05-ccc_media_line_script,2015/12/05,ccc_media_line_script,1,1,0:00:03,3,0:00:03,0,3
2015-12-05-ccc_priority_script,2015/12/05,ccc_priority_script,22,22,0:00:28,28,0:03:02,0,616
2015-12-05-ccc_tax_script,2015/12/05,ccc_tax_script,1,1,0:00:08,8,0:00:08,0,8
2015-12-05-ccc_waste_recycling_script,2015/12/05,ccc_waste_recycling_script,0,0,0:00:00,0,0:00:00,0,0
2015-12-06-ccc_311_calgary_script,2015/12/06,ccc_311_calgary_script,764,744,0:00:13,13,0:07:59,20,9672
2015-12-06-ccc_311_lobby_ph_script,2015/12/06,ccc_311_lobby_ph_script,0,0,0:00:00,0,0:00:00,0,0
2015-12-06-ccc_aserv_info_script,2015/12/06,ccc_aserv_info_script,0,0,0:00:00,0,0:00:00,0,0
2015-12-06-ccc_bylaw_script,2015/12/06,ccc_bylaw_script,0,0,0:00:00,0,0:00:00,0,0
2015-12-06-ccc_city_script,2015/12/06,ccc_city_script,0,0,0:00:00,0,0:00:00,0,0
2015-12-06-ccc_cty_online_script,2015/12/06,ccc_cty_online_script,0,0,0:00:00,0,0:00:00,0,0
2015-12-06-ccc_feedback_script,2015/12/06,ccc_feedback_script,0,0,0:00:00,0,0:00:00,0,0
2015-12-06-ccc_fpb_script,2015/12/06,ccc_fpb_script,0,0,0:00:00,0,0:00:00,0,0
2015-12-06-ccc_help_script,2015/12/06,ccc_help_script,0,0,0:00:00,0,0:00:00,0,0
2015-12-06-ccc_link_script,2015/12/06,ccc_link_script,0,0,0:00:00,0,0:00:00,0,0
2015-12-06-ccc_media_line_script,2015/12/06,ccc_media_line_script,2,2,0:00:05,5,0:00:08,0,10
2015-12-06-ccc_priority_script,2015/12/06,ccc_priority_script,5,4,0:00:05,5,0:00:08,1,20
2015-12-06-ccc_tax_script,2015/12/06,ccc_tax_script,0,0,0:00:00,0,0:00:00,0,0
2015-12-06-ccc_waste_recycling_script,2015/12/06,ccc_waste_recycling_script,0,0,0:00:00,0,0:00:00,0,0
2015-12-07-ccc_311_calgary_script,2015/12/07,ccc_311_calgary_script,3015,2957,0:00:17,17,0:03:33,58,50269
2015-12-07-ccc_311_lobby_ph_script,2015/12/07,ccc_311_lobby_ph_script,1,1,0:00:04,4,0:00:04,0,4
2015-12-07-ccc_aserv_info_script,2015/12/07,ccc_aserv_info_script,0,0,0:00:00,0,0:00:00,0,0
2015-12-07-ccc_bylaw_script,2015/12/07,ccc_bylaw_script,0,0,0:00:00,0,0:00:00,0,0
2015-12-07-ccc_city_script,2015/12/07,ccc_city_script,30,30,0:00:07,7,0:00:20,0,210
2015-12-07-ccc_cty_online_script,2015/12/07,ccc_cty_online_script,0,0,0:00:00,0,0:00:00,0,0
2015-12-07-ccc_feedback_script,2015/12/07,ccc_feedback_script,0,0,0:00:00,0,0:00:00,0,0
2015-12-07-ccc_fpb_script,2015/12/07,ccc_fpb_script,0,0,0:00:00,0,0:00:00,0,0
2015-12-07-ccc_help_script,2015/12/07,ccc_help_script,7,7,0:00:09,9,0:00:14,0,63
2015-12-07-ccc_link_script,2015/12/07,ccc_link_script,0,0,0:00:00,0,0:00:00,0,0
2015-12-07-ccc_media_line_script,2015/12/07,ccc_media_line_script,0,0,0:00:00,0,0:00:00,0,0
2015-12-07-ccc_priority_script,2015/12/07,ccc_priority_script,28,27,0:00:07,7,0:00:20,1,189
2015-12-07-ccc_tax_script,2015/12/07,ccc_tax_script,19,18,0:00:12,12,0:02:02,1,216
2015-12-07-ccc_waste_recycling_script,2015/12/07,ccc_waste_recycling_script,0,0,0:00:00,0,0:00:00,0,0
2015-12-08-ccc_311_calgary_script,2015/12/08,ccc_311_calgary_script,2955,2754,0:01:05,65,0:06:07,201,179010
2015-12-08-ccc_311_lobby_ph_script,2015/12/08,ccc_311_lobby_ph_script,4,2,0:00:04,4,0:00:04,2,8
2015-12-08-ccc_aserv_info_script,2015/12/08,ccc_aserv_info_script,0,0,0:00:00,0,0:00:00,0,0
2015-12-08-ccc_bylaw_script,2015/12/08,ccc_bylaw_script,0,0,0:00:00,0,0:00:00,0,0
2015-12-08-ccc_city_script,2015/12/08,ccc_city_script,13,13,0:00:41,41,0:03:17,0,533
2015-12-08-ccc_cty_online_script,2015/12/08,ccc_cty_online_script,0,0,0:00:00,0,0:00:00,0,0
2015-12-08-ccc_feedback_script,2015/12/08,ccc_feedback_script,0,0,0:00:00,0,0:00:00,0,0
2015-12-08-ccc_fpb_script,2015/12/08,ccc_fpb_script,0,0,0:00:00,0,0:00:00,0,0
2015-12-08-ccc_help_script,2015/12/08,ccc_help_script,1,1,0:00:38,38,0:00:38,0,38
2015-12-08-ccc_link_script,2015/12/08,ccc_link_script,0,0,0:00:00,0,0:00:00,0,0
2015-12-08-ccc_media_line_script,2015/12/08,ccc_media_line_script,0,0,0:00:00,0,0:00:00,0,0
2015-12-08-ccc_priority_script,2015/12/08,ccc_priority_script,15,15,0:00:06,6,0:00:13,0,90
2015-12-08-ccc_tax_script,2015/12/08,ccc_tax_script,11,10,0:01:20,80,0:04:59,1,800
2015-12-08-ccc_waste_recycling_script,2015/12/08,ccc_waste_recycling_script,0,0,0:00:00,0,0:00:00,0,0
2015-12-09-ccc_311_calgary_script,2015/12/09,ccc_311_calgary_script,2745,2669,0:00:28,28,0:05:38,76,74732
2015-12-09-ccc_311_lobby_ph_script,2015/12/09,ccc_311_lobby_ph_script,1,0,0:00:00,0,0:00:00,1,0
2015-12-09-ccc_aserv_info_script,2015/12/09,ccc_aserv_info_script,0,0,0:00:00,0,0:00:00,0,0
2015-12-09-ccc_bylaw_script,2015/12/09,ccc_bylaw_script,0,0,0:00:00,0,0:00:00,0,0
2015-12-09-ccc_city_script,2015/12/09,ccc_city_script,21,19,0:00:06,6,0:00:36,2,114
2015-12-09-ccc_cty_online_script,2015/12/09,ccc_cty_online_script,0,0,0:00:00,0,0:00:00,0,0
2015-12-09-ccc_feedback_script,2015/12/09,ccc_feedback_script,0,0,0:00:00,0,0:00:00,0,0
2015-12-09-ccc_fpb_script,2015/12/09,ccc_fpb_script,1,1,0:00:11,11,0:00:11,0,11
2015-12-09-ccc_help_script,2015/12/09,ccc_help_script,6,6,0:00:06,6,0:00:10,0,36
2015-12-09-ccc_link_script,2015/12/09,ccc_link_script,0,0,0:00:00,0,0:00:00,0,0
2015-12-09-ccc_media_line_script,2015/12/09,ccc_media_line_script,1,1,0:00:07,7,0:00:07,0,7
2015-12-09-ccc_priority_script,2015/12/09,ccc_priority_script,17,15,0:00:07,7,0:00:28,2,105
2015-12-09-ccc_tax_script,2015/12/09,ccc_tax_script,15,13,0:00:44,44,0:03:29,2,572
2015-12-09-ccc_waste_recycling_script,2015/12/09,ccc_waste_recycling_script,0,0,0:00:00,0,0:00:00,0,0
2015-12-10-ccc_311_calgary_script,2015/12/10,ccc_311_calgary_script,2558,2506,0:00:16,16,0:03:14,52,40096
2015-12-10-ccc_311_lobby_ph_script,2015/12/10,ccc_311_lobby_ph_script,3,3,0:00:04,4,0:00:06,0,12
2015-12-10-ccc_aserv_info_script,2015/12/10,ccc_aserv_info_script,0,0,0:00:00,0,0:00:00,0,0
2015-12-10-ccc_bylaw_script,2015/12/10,ccc_bylaw_script,0,0,0:00:00,0,0:00:00,0,0
2015-12-10-ccc_city_script,2015/12/10,ccc_city_script,23,22,0:00:08,8,0:00:20,1,176
2015-12-10-ccc_cty_online_script,2015/12/10,ccc_cty_online_script,0,0,0:00:00,0,0:00:00,0,0
2015-12-10-ccc_feedback_script,2015/12/10,ccc_feedback_script,0,0,0:00:00,0,0:00:00,0,0
2015-12-10-ccc_fpb_script,2015/12/10,ccc_fpb_script,2,2,0:00:03,3,0:00:03,0,6
2015-12-10-ccc_help_script,2015/12/10,ccc_help_script,20,16,0:00:07,7,0:00:21,4,112
2015-12-10-ccc_link_script,2015/12/10,ccc_link_script,0,0,0:00:00,0,0:00:00,0,0
2015-12-10-ccc_media_line_script,2015/12/10,ccc_media_line_script,1,1,0:00:04,4,0:00:04,0,4
2015-12-10-ccc_priority_script,2015/12/10,ccc_priority_script,20,18,0:00:06,6,0:00:11,2,108
2015-12-10-ccc_tax_script,2015/12/10,ccc_tax_script,19,19,0:00:24,24,0:02:30,0,456
2015-12-10-ccc_waste_recycling_script,2015/12/10,ccc_waste_recycling_script,0,0,0:00:00,0,0:00:00,0,0
2015-12-11-ccc_311_calgary_script,2015/12/11,ccc_311_calgary_script,2307,2275,0:00:10,10,0:04:22,32,22750
2015-12-11-ccc_311_lobby_ph_script,2015/12/11,ccc_311_lobby_ph_script,1,1,0:00:09,9,0:00:09,0,9
2015-12-11-ccc_aserv_info_script,2015/12/11,ccc_aserv_info_script,0,0,0:00:00,0,0:00:00,0,0
2015-12-11-ccc_bylaw_script,2015/12/11,ccc_bylaw_script,0,0,0:00:00,0,0:00:00,0,0
2015-12-11-ccc_city_script,2015/12/11,ccc_city_script,18,18,0:00:08,8,0:00:22,0,144
2015-12-11-ccc_cty_online_script,2015/12/11,ccc_cty_online_script,0,0,0:00:00,0,0:00:00,0,0
2015-12-11-ccc_feedback_script,2015/12/11,ccc_feedback_script,0,0,0:00:00,0,0:00:00,0,0
2015-12-11-ccc_fpb_script,2015/12/11,ccc_fpb_script,0,0,0:00:00,0,0:00:00,0,0
2015-12-11-ccc_help_script,2015/12/11,ccc_help_script,6,6,0:00:16,16,0:00:35,0,96
2015-12-11-ccc_link_script,2015/12/11,ccc_link_script,0,0,0:00:00,0,0:00:00,0,0
2015-12-11-ccc_media_line_script,2015/12/11,ccc_media_line_script,0,0,0:00:00,0,0:00:00,0,0
2015-12-11-ccc_priority_script,2015/12/11,ccc_priority_script,21,21,0:00:09,9,0:01:07,0,189
2015-12-11-ccc_tax_script,2015/12/11,ccc_tax_script,6,6,0:00:07,7,0:00:11,0,42
2015-12-11-ccc_waste_recycling_script,2015/12/11,ccc_waste_recycling_script,0,0,0:00:00,0,0:00:00,0,0
2015-12-12-ccc_311_calgary_script,2015/12/12,ccc_311_calgary_script,914,904,0:00:11,11,0:03:01,10,9944
2015-12-12-ccc_311_lobby_ph_script,2015/12/12,ccc_311_lobby_ph_script,0,0,0:00:00,0,0:00:00,0,0
2015-12-12-ccc_aserv_info_script,2015/12/12,ccc_aserv_info_script,0,0,0:00:00,0,0:00:00,0,0
2015-12-12-ccc_bylaw_script,2015/12/12,ccc_bylaw_script,0,0,0:00:00,0,0:00:00,0,0
2015-12-12-ccc_city_script,2015/12/12,ccc_city_script,0,0,0:00:00,0,0:00:00,0,0
2015-12-12-ccc_cty_online_script,2015/12/12,ccc_cty_online_script,0,0,0:00:00,0,0:00:00,0,0
2015-12-12-ccc_feedback_script,2015/12/12,ccc_feedback_script,0,0,0:00:00,0,0:00:00,0,0
2015-12-12-ccc_fpb_script,2015/12/12,ccc_fpb_script,0,0,0:00:00,0,0:00:00,0,0
2015-12-12-ccc_help_script,2015/12/12,ccc_help_script,1,1,0:00:02,2,0:00:02,0,2
2015-12-12-ccc_link_script,2015/12/12,ccc_link_script,0,0,0:00:00,0,0:00:00,0,0
2015-12-12-ccc_media_line_script,2015/12/12,ccc_media_line_script,3,3,0:00:06,6,0:00:09,0,18
2015-12-12-ccc_priority_script,2015/12/12,ccc_priority_script,24,22,0:00:11,11,0:00:55,2,242
2015-12-12-ccc_tax_script,2015/12/12,ccc_tax_script,0,0,0:00:00,0,0:00:00,0,0
2015-12-12-ccc_waste_recycling_script,2015/12/12,ccc_waste_recycling_script,0,0,0:00:00,0,0:00:00,0,0
2015-12-13-ccc_311_calgary_script,2015/12/13,ccc_311_calgary_script,660,647,0:00:14,14,0:11:18,13,9058
2015-12-13-ccc_311_lobby_ph_script,2015/12/13,ccc_311_lobby_ph_script,0,0,0:00:00,0,0:00:00,0,0
2015-12-13-ccc_aserv_info_script,2015/12/13,ccc_aserv_info_script,0,0,0:00:00,0,0:00:00,0,0
2015-12-13-ccc_bylaw_script,2015/12/13,ccc_bylaw_script,0,0,0:00:00,0,0:00:00,0,0
2015-12-13-ccc_city_script,2015/12/13,ccc_city_script,0,0,0:00:00,0,0:00:00,0,0
2015-12-13-ccc_cty_online_script,2015/12/13,ccc_cty_online_script,0,0,0:00:00,0,0:00:00,0,0
2015-12-13-ccc_feedback_script,2015/12/13,ccc_feedback_script,0,0,0:00:00,0,0:00:00,0,0
2015-12-13-ccc_fpb_script,2015/12/13,ccc_fpb_script,0,0,0:00:00,0,0:00:00,0,0
2015-12-13-ccc_help_script,2015/12/13,ccc_help_script,0,0,0:00:00,0,0:00:00,0,0
2015-12-13-ccc_link_script,2015/12/13,ccc_link_script,0,0,0:00:00,0,0:00:00,0,0
2015-12-13-ccc_media_line_script,2015/12/13,ccc_media_line_script,0,0,0:00:00,0,0:00:00,0,0
2015-12-13-ccc_priority_script,2015/12/13,ccc_priority_script,16,16,0:00:07,7,0:00:19,0,112
2015-12-13-ccc_tax_script,2015/12/13,ccc_tax_script,0,0,0:00:00,0,0:00:00,0,0
2015-12-13-ccc_waste_recycling_script,2015/12/13,ccc_waste_recycling_script,0,0,0:00:00,0,0:00:00,0,0
2015-12-14-ccc_311_calgary_script,2015/12/14,ccc_311_calgary_script,2744,2695,0:00:17,17,0:02:52,49,45815
2015-12-14-ccc_311_lobby_ph_script,2015/12/14,ccc_311_lobby_ph_script,2,2,0:00:14,14,0:00:22,0,28
2015-12-14-ccc_aserv_info_script,2015/12/14,ccc_aserv_info_script,0,0,0:00:00,0,0:00:00,0,0
2015-12-14-ccc_bylaw_script,2015/12/14,ccc_bylaw_script,0,0,0:00:00,0,0:00:00,0,0
2015-12-14-ccc_city_script,2015/12/14,ccc_city_script,16,16,0:00:07,7,0:00:27,0,112
2015-12-14-ccc_cty_online_script,2015/12/14,ccc_cty_online_script,0,0,0:00:00,0,0:00:00,0,0
2015-12-14-ccc_feedback_script,2015/12/14,ccc_feedback_script,0,0,0:00:00,0,0:00:00,0,0
2015-12-14-ccc_fpb_script,2015/12/14,ccc_fpb_script,2,2,0:00:06,6,0:00:07,0,12
2015-12-14-ccc_help_script,2015/12/14,ccc_help_script,9,8,0:00:07,7,0:00:13,1,56
2015-12-14-ccc_link_script,2015/12/14,ccc_link_script,0,0,0:00:00,0,0:00:00,0,0
2015-12-14-ccc_media_line_script,2015/12/14,ccc_media_line_script,0,0,0:00:00,0,0:00:00,0,0
2015-12-14-ccc_priority_script,2015/12/14,ccc_priority_script,20,19,0:00:10,10,0:00:33,1,190
2015-12-14-ccc_tax_script,2015/12/14,ccc_tax_script,16,15,0:00:41,41,0:02:37,1,615
2015-12-14-ccc_waste_recycling_script,2015/12/14,ccc_waste_recycling_script,0,0,0:00:00,0,0:00:00,0,0
2015-12-15-ccc_311_calgary_script,2015/12/15,ccc_311_calgary_script,2687,2506,0:00:57,57,0:06:39,181,142842
2015-12-15-ccc_311_lobby_ph_script,2015/12/15,ccc_311_lobby_ph_script,2,2,0:00:11,11,0:00:14,0,22
2015-12-15-ccc_aserv_info_script,2015/12/15,ccc_aserv_info_script,0,0,0:00:00,0,0:00:00,0,0
2015-12-15-ccc_bylaw_script,2015/12/15,ccc_bylaw_script,0,0,0:00:00,0,0:00:00,0,0
2015-12-15-ccc_city_script,2015/12/15,ccc_city_script,13,12,0:00:18,18,0:00:59,1,216
2015-12-15-ccc_cty_online_script,2015/12/15,ccc_cty_online_script,0,0,0:00:00,0,0:00:00,0,0
2015-12-15-ccc_feedback_script,2015/12/15,ccc_feedback_script,0,0,0:00:00,0,0:00:00,0,0
2015-12-15-ccc_fpb_script,2015/12/15,ccc_fpb_script,0,0,0:00:00,0,0:00:00,0,0
2015-12-15-ccc_help_script,2015/12/15,ccc_help_script,1,1,0:00:18,18,0:00:18,0,18
2015-12-15-ccc_link_script,2015/12/15,ccc_link_script,0,0,0:00:00,0,0:00:00,0,0
2015-12-15-ccc_media_line_script,2015/12/15,ccc_media_line_script,3,3,0:00:06,6,0:00:10,0,18
2015-12-15-ccc_priority_script,2015/12/15,ccc_priority_script,21,21,0:00:13,13,0:01:10,0,273
2015-12-15-ccc_tax_script,2015/12/15,ccc_tax_script,20,18,0:01:14,74,0:04:44,2,1332
2015-12-15-ccc_waste_recycling_script,2015/12/15,ccc_waste_recycling_script,0,0,0:00:00,0,0:00:00,0,0
2015-12-16-ccc_311_calgary_script,2015/12/16,ccc_311_calgary_script,2653,2582,0:00:18,18,0:06:02,71,46476
2015-12-16-ccc_311_lobby_ph_script,2015/12/16,ccc_311_lobby_ph_script,5,4,0:00:06,6,0:00:14,1,24
2015-12-16-ccc_aserv_info_script,2015/12/16,ccc_aserv_info_script,0,0,0:00:00,0,0:00:00,0,0
2015-12-16-ccc_bylaw_script,2015/12/16,ccc_bylaw_script,0,0,0:00:00,0,0:00:00,0,0
2015-12-16-ccc_city_script,2015/12/16,ccc_city_script,10,9,0:00:06,6,0:00:17,1,54
2015-12-16-ccc_cty_online_script,2015/12/16,ccc_cty_online_script,0,0,0:00:00,0,0:00:00,0,0
2015-12-16-ccc_feedback_script,2015/12/16,ccc_feedback_script,0,0,0:00:00,0,0:00:00,0,0
2015-12-16-ccc_fpb_script,2015/12/16,ccc_fpb_script,0,0,0:00:00,0,0:00:00,0,0
2015-12-16-ccc_help_script,2015/12/16,ccc_help_script,4,4,0:00:24,24,0:00:40,0,96
2015-12-16-ccc_link_script,2015/12/16,ccc_link_script,0,0,0:00:00,0,0:00:00,0,0
2015-12-16-ccc_media_line_script,2015/12/16,ccc_media_line_script,2,1,0:00:13,13,0:00:13,1,13
2015-12-16-ccc_priority_script,2015/12/16,ccc_priority_script,36,35,0:00:12,12,0:00:44,1,420
2015-12-16-ccc_tax_script,2015/12/16,ccc_tax_script,26,26,0:00:11,11,0:01:23,0,286
2015-12-16-ccc_waste_recycling_script,2015/12/16,ccc_waste_recycling_script,0,0,0:00:00,0,0:00:00,0,0
2015-12-17-ccc_311_calgary_script,2015/12/17,ccc_311_calgary_script,2643,2539,0:00:26,26,0:07:11,103,66014
2015-12-17-ccc_311_lobby_ph_script,2015/12/17,ccc_311_lobby_ph_script,3,3,0:00:07,7,0:00:15,0,21
2015-12-17-ccc_aserv_info_script,2015/12/17,ccc_aserv_info_script,0,0,0:00:00,0,0:00:00,0,0
2015-12-17-ccc_bylaw_script,2015/12/17,ccc_bylaw_script,0,0,0:00:00,0,0:00:00,0,0
2015-12-17-ccc_city_script,2015/12/17,ccc_city_script,10,10,0:00:10,10,0:00:27,0,100
2015-12-17-ccc_cty_online_script,2015/12/17,ccc_cty_online_script,0,0,0:00:00,0,0:00:00,0,0
2015-12-17-ccc_feedback_script,2015/12/17,ccc_feedback_script,0,0,0:00:00,0,0:00:00,0,0
2015-12-17-ccc_fpb_script,2015/12/17,ccc_fpb_script,0,0,0:00:00,0,0:00:00,0,0
2015-12-17-ccc_help_script,2015/12/17,ccc_help_script,4,4,0:00:17,17,0:00:40,0,68
2015-12-17-ccc_link_script,2015/12/17,ccc_link_script,0,0,0:00:00,0,0:00:00,0,0
2015-12-17-ccc_media_line_script,2015/12/17,ccc_media_line_script,0,0,0:00:00,0,0:00:00,0,0
2015-12-17-ccc_priority_script,2015/12/17,ccc_priority_script,27,27,0:00:11,11,0:01:44,0,297
2015-12-17-ccc_tax_script,2015/12/17,ccc_tax_script,18,16,0:00:25,25,0:02:12,2,400
2015-12-17-ccc_waste_recycling_script,2015/12/17,ccc_waste_recycling_script,0,0,0:00:00,0,0:00:00,0,0
2015-12-18-ccc_311_calgary_script,2015/12/18,ccc_311_calgary_script,2520,2406,0:00:29,29,0:06:55,115,69774
2015-12-18-ccc_311_lobby_ph_script,2015/12/18,ccc_311_lobby_ph_script,8,7,0:00:11,11,0:00:36,1,77
2015-12-18-ccc_aserv_info_script,2015/12/18,ccc_aserv_info_script,0,0,0:00:00,0,0:00:00,0,0
2015-12-18-ccc_bylaw_script,2015/12/18,ccc_bylaw_script,0,0,0:00:00,0,0:00:00,0,0
2015-12-18-ccc_city_script,2015/12/18,ccc_city_script,15,13,0:00:10,10,0:00:41,2,130
2015-12-18-ccc_cty_online_script,2015/12/18,ccc_cty_online_script,0,0,0:00:00,0,0:00:00,0,0
2015-12-18-ccc_feedback_script,2015/12/18,ccc_feedback_script,0,0,0:00:00,0,0:00:00,0,0
2015-12-18-ccc_fpb_script,2015/12/18,ccc_fpb_script,0,0,0:00:00,0,0:00:00,0,0
2015-12-18-ccc_help_script,2015/12/18,ccc_help_script,5,5,0:00:11,11,0:00:41,0,55
2015-12-18-ccc_link_script,2015/12/18,ccc_link_script,0,0,0:00:00,0,0:00:00,0,0
2015-12-18-ccc_media_line_script,2015/12/18,ccc_media_line_script,4,4,0:00:11,11,0:00:25,0,44
2015-12-18-ccc_priority_script,2015/12/18,ccc_priority_script,43,40,0:00:09,9,0:00:31,3,360
2015-12-18-ccc_tax_script,2015/12/18,ccc_tax_script,21,21,0:00:37,37,0:02:52,0,777
2015-12-18-ccc_waste_recycling_script,2015/12/18,ccc_waste_recycling_script,0,0,0:00:00,0,0:00:00,0,0
2015-12-19-ccc_311_calgary_script,2015/12/19,ccc_311_calgary_script,976,961,0:00:12,12,0:04:28,15,11532
2015-12-19-ccc_311_lobby_ph_script,2015/12/19,ccc_311_lobby_ph_script,0,0,0:00:00,0,0:00:00,0,0
2015-12-19-ccc_aserv_info_script,2015/12/19,ccc_aserv_info_script,0,0,0:00:00,0,0:00:00,0,0
2015-12-19-ccc_bylaw_script,2015/12/19,ccc_bylaw_script,0,0,0:00:00,0,0:00:00,0,0
2015-12-19-ccc_city_script,2015/12/19,ccc_city_script,0,0,0:00:00,0,0:00:00,0,0
2015-12-19-ccc_cty_online_script,2015/12/19,ccc_cty_online_script,0,0,0:00:00,0,0:00:00,0,0
2015-12-19-ccc_feedback_script,2015/12/19,ccc_feedback_script,0,0,0:00:00,0,0:00:00,0,0
2015-12-19-ccc_fpb_script,2015/12/19,ccc_fpb_script,0,0,0:00:00,0,0:00:00,0,0
2015-12-19-ccc_help_script,2015/12/19,ccc_help_script,0,0,0:00:00,0,0:00:00,0,0
2015-12-19-ccc_link_script,2015/12/19,ccc_link_script,0,0,0:00:00,0,0:00:00,0,0
2015-12-19-ccc_media_line_script,2015/12/19,ccc_media_line_script,0,0,0:00:00,0,0:00:00,0,0
2015-12-19-ccc_priority_script,2015/12/19,ccc_priority_script,36,35,0:00:09,9,0:00:54,1,315
2015-12-19-ccc_tax_script,2015/12/19,ccc_tax_script,0,0,0:00:00,0,0:00:00,0,0
2015-12-19-ccc_waste_recycling_script,2015/12/19,ccc_waste_recycling_script,0,0,0:00:00,0,0:00:00,0,0
2015-12-20-ccc_311_calgary_script,2015/12/20,ccc_311_calgary_script,733,721,0:00:08,8,0:03:06,12,5768
2015-12-20-ccc_311_lobby_ph_script,2015/12/20,ccc_311_lobby_ph_script,0,0,0:00:00,0,0:00:00,0,0
2015-12-20-ccc_aserv_info_script,2015/12/20,ccc_aserv_info_script,0,0,0:00:00,0,0:00:00,0,0
2015-12-20-ccc_bylaw_script,2015/12/20,ccc_bylaw_script,0,0,0:00:00,0,0:00:00,0,0
2015-12-20-ccc_city_script,2015/12/20,ccc_city_script,0,0,0:00:00,0,0:00:00,0,0
2015-12-20-ccc_cty_online_script,2015/12/20,ccc_cty_online_script,0,0,0:00:00,0,0:00:00,0,0
2015-12-20-ccc_feedback_script,2015/12/20,ccc_feedback_script,0,0,0:00:00,0,0:00:00,0,0
2015-12-20-ccc_fpb_script,2015/12/20,ccc_fpb_script,0,0,0:00:00,0,0:00:00,0,0
2015-12-20-ccc_help_script,2015/12/20,ccc_help_script,1,1,0:00:02,2,0:00:02,0,2
2015-12-20-ccc_link_script,2015/12/20,ccc_link_script,0,0,0:00:00,0,0:00:00,0,0
2015-12-20-ccc_media_line_script,2015/12/20,ccc_media_line_script,1,1,0:00:04,4,0:00:04,0,4
2015-12-20-ccc_priority_script,2015/12/20,ccc_priority_script,15,14,0:00:05,5,0:00:14,1,70
2015-12-20-ccc_tax_script,2015/12/20,ccc_tax_script,0,0,0:00:00,0,0:00:00,0,0
2015-12-20-ccc_waste_recycling_script,2015/12/20,ccc_waste_recycling_script,0,0,0:00:00,0,0:00:00,0,0
2015-12-21-ccc_311_calgary_script,2015/12/21,ccc_311_calgary_script,2608,2574,0:00:13,13,0:03:54,34,33462
2015-12-21-ccc_311_lobby_ph_script,2015/12/21,ccc_311_lobby_ph_script,5,5,0:00:07,7,0:00:17,0,35
2015-12-21-ccc_aserv_info_script,2015/12/21,ccc_aserv_info_script,0,0,0:00:00,0,0:00:00,0,0
2015-12-21-ccc_bylaw_script,2015/12/21,ccc_bylaw_script,0,0,0:00:00,0,0:00:00,0,0
2015-12-21-ccc_city_script,2015/12/21,ccc_city_script,14,12,0:00:09,9,0:00:26,2,108
2015-12-21-ccc_cty_online_script,2015/12/21,ccc_cty_online_script,0,0,0:00:00,0,0:00:00,0,0
2015-12-21-ccc_feedback_script,2015/12/21,ccc_feedback_script,1,0,0:00:00,0,0:00:00,0,0
2015-12-21-ccc_fpb_script,2015/12/21,ccc_fpb_script,0,0,0:00:00,0,0:00:00,0,0
2015-12-21-ccc_help_script,2015/12/21,ccc_help_script,20,20,0:00:09,9,0:00:36,0,180
2015-12-21-ccc_link_script,2015/12/21,ccc_link_script,0,0,0:00:00,0,0:00:00,0,0
2015-12-21-ccc_media_line_script,2015/12/21,ccc_media_line_script,1,1,0:00:05,5,0:00:05,0,5
2015-12-21-ccc_priority_script,2015/12/21,ccc_priority_script,24,24,0:00:07,7,0:00:22,0,168
2015-12-21-ccc_tax_script,2015/12/21,ccc_tax_script,13,13,0:00:09,9,0:00:34,0,117
2015-12-21-ccc_waste_recycling_script,2015/12/21,ccc_waste_recycling_script,0,0,0:00:00,0,0:00:00,0,0
2015-12-22-ccc_311_calgary_script,2015/12/22,ccc_311_calgary_script,2529,2473,0:00:21,21,0:11:06,56,51933
2015-12-22-ccc_311_lobby_ph_script,2015/12/22,ccc_311_lobby_ph_script,3,3,0:00:08,8,0:00:10,0,24
2015-12-22-ccc_aserv_info_script,2015/12/22,ccc_aserv_info_script,0,0,0:00:00,0,0:00:00,0,0
2015-12-22-ccc_bylaw_script,2015/12/22,ccc_bylaw_script,0,0,0:00:00,0,0:00:00,0,0
2015-12-22-ccc_city_script,2015/12/22,ccc_city_script,24,24,0:00:09,9,0:00:20,0,216
2015-12-22-ccc_cty_online_script,2015/12/22,ccc_cty_online_script,0,0,0:00:00,0,0:00:00,0,0
2015-12-22-ccc_feedback_script,2015/12/22,ccc_feedback_script,0,0,0:00:00,0,0:00:00,0,0
2015-12-22-ccc_fpb_script,2015/12/22,ccc_fpb_script,1,1,0:00:07,7,0:00:07,0,7
2015-12-22-ccc_help_script,2015/12/22,ccc_help_script,6,6,0:00:10,10,0:00:34,0,60
2015-12-22-ccc_link_script,2015/12/22,ccc_link_script,0,0,0:00:00,0,0:00:00,0,0
2015-12-22-ccc_media_line_script,2015/12/22,ccc_media_line_script,0,0,0:00:00,0,0:00:00,0,0
2015-12-22-ccc_priority_script,2015/12/22,ccc_priority_script,24,23,0:00:09,9,0:01:14,1,207
2015-12-22-ccc_tax_script,2015/12/22,ccc_tax_script,13,13,0:00:19,19,0:01:03,0,247
2015-12-22-ccc_waste_recycling_script,2015/12/22,ccc_waste_recycling_script,0,0,0:00:00,0,0:00:00,0,0
2015-12-23-ccc_311_calgary_script,2015/12/23,ccc_311_calgary_script,2254,2221,0:00:10,10,0:04:58,31,22210
2015-12-23-ccc_311_lobby_ph_script,2015/12/23,ccc_311_lobby_ph_script,3,3,0:00:06,6,0:00:08,0,18
2015-12-23-ccc_aserv_info_script,2015/12/23,ccc_aserv_info_script,0,0,0:00:00,0,0:00:00,0,0
2015-12-23-ccc_bylaw_script,2015/12/23,ccc_bylaw_script,0,0,0:00:00,0,0:00:00,0,0
2015-12-23-ccc_city_script,2015/12/23,ccc_city_script,3,3,0:00:03,3,0:00:03,0,9
2015-12-23-ccc_cty_online_script,2015/12/23,ccc_cty_online_script,0,0,0:00:00,0,0:00:00,0,0
2015-12-23-ccc_feedback_script,2015/12/23,ccc_feedback_script,1,0,0:00:00,0,0:00:00,0,0
2015-12-23-ccc_fpb_script,2015/12/23,ccc_fpb_script,0,0,0:00:00,0,0:00:00,0,0
2015-12-23-ccc_help_script,2015/12/23,ccc_help_script,8,7,0:00:19,19,0:01:05,1,133
2015-12-23-ccc_link_script,2015/12/23,ccc_link_script,0,0,0:00:00,0,0:00:00,0,0
2015-12-23-ccc_media_line_script,2015/12/23,ccc_media_line_script,2,2,0:00:55,55,0:01:40,0,110
2015-12-23-ccc_priority_script,2015/12/23,ccc_priority_script,26,24,0:00:05,5,0:00:15,2,120
2015-12-23-ccc_tax_script,2015/12/23,ccc_tax_script,13,13,0:00:12,12,0:01:34,0,156
2015-12-23-ccc_waste_recycling_script,2015/12/23,ccc_waste_recycling_script,0,0,0:00:00,0,0:00:00,0,0
2015-12-24-ccc_311_calgary_script,2015/12/24,ccc_311_calgary_script,1342,1327,0:00:10,10,0:06:09,17,13270
2015-12-24-ccc_311_lobby_ph_script,2015/12/24,ccc_311_lobby_ph_script,1,1,0:00:05,5,0:00:05,0,5
2015-12-24-ccc_aserv_info_script,2015/12/24,ccc_aserv_info_script,0,0,0:00:00,0,0:00:00,0,0
2015-12-24-ccc_bylaw_script,2015/12/24,ccc_bylaw_script,1,1,0:00:10,10,0:00:10,0,10
2015-12-24-ccc_city_script,2015/12/24,ccc_city_script,1,1,0:00:10,10,0:00:10,0,10
2015-12-24-ccc_cty_online_script,2015/12/24,ccc_cty_online_script,0,0,0:00:00,0,0:00:00,0,0
2015-12-24-ccc_feedback_script,2015/12/24,ccc_feedback_script,0,0,0:00:00,0,0:00:00,0,0
2015-12-24-ccc_fpb_script,2015/12/24,ccc_fpb_script,0,0,0:00:00,0,0:00:00,0,0
2015-12-24-ccc_help_script,2015/12/24,ccc_help_script,6,5,0:00:06,6,0:00:09,1,30
2015-12-24-ccc_link_script,2015/12/24,ccc_link_script,0,0,0:00:00,0,0:00:00,0,0
2015-12-24-ccc_media_line_script,2015/12/24,ccc_media_line_script,8,6,0:00:05,5,0:00:09,2,30
2015-12-24-ccc_priority_script,2015/12/24,ccc_priority_script,47,45,0:00:11,11,0:01:58,2,495
2015-12-24-ccc_tax_script,2015/12/24,ccc_tax_script,0,0,0:00:00,0,0:00:00,0,0
2015-12-24-ccc_waste_recycling_script,2015/12/24,ccc_waste_recycling_script,0,0,0:00:00,0,0:00:00,0,0
2015-12-25-ccc_311_calgary_script,2015/12/25,ccc_311_calgary_script,462,455,0:00:09,9,0:02:50,7,4095
2015-12-25-ccc_311_lobby_ph_script,2015/12/25,ccc_311_lobby_ph_script,0,0,0:00:00,0,0:00:00,0,0
2015-12-25-ccc_aserv_info_script,2015/12/25,ccc_aserv_info_script,0,0,0:00:00,0,0:00:00,0,0
2015-12-25-ccc_bylaw_script,2015/12/25,ccc_bylaw_script,0,0,0:00:00,0,0:00:00,0,0
2015-12-25-ccc_city_script,2015/12/25,ccc_city_script,0,0,0:00:00,0,0:00:00,0,0
2015-12-25-ccc_cty_online_script,2015/12/25,ccc_cty_online_script,0,0,0:00:00,0,0:00:00,0,0
2015-12-25-ccc_feedback_script,2015/12/25,ccc_feedback_script,0,0,0:00:00,0,0:00:00,0,0
2015-12-25-ccc_fpb_script,2015/12/25,ccc_fpb_script,0,0,0:00:00,0,0:00:00,0,0
2015-12-25-ccc_help_script,2015/12/25,ccc_help_script,0,0,0:00:00,0,0:00:00,0,0
2015-12-25-ccc_link_script,2015/12/25,ccc_link_script,0,0,0:00:00,0,0:00:00,0,0
2015-12-25-ccc_media_line_script,2015/12/25,ccc_media_line_script,1,1,0:00:04,4,0:00:04,0,4
2015-12-25-ccc_priority_script,2015/12/25,ccc_priority_script,56,55,0:00:06,6,0:00:18,1,330
2015-12-25-ccc_tax_script,2015/12/25,ccc_tax_script,0,0,0:00:00,0,0:00:00,0,0
2015-12-25-ccc_waste_recycling_script,2015/12/25,ccc_waste_recycling_script,0,0,0:00:00,0,0:00:00,0,0
2015-12-26-ccc_311_calgary_script,2015/12/26,ccc_311_calgary_script,801,784,0:00:17,17,0:05:47,17,13328
2015-12-26-ccc_311_lobby_ph_script,2015/12/26,ccc_311_lobby_ph_script,0,0,0:00:00,0,0:00:00,0,0
2015-12-26-ccc_aserv_info_script,2015/12/26,ccc_aserv_info_script,0,0,0:00:00,0,0:00:00,0,0
2015-12-26-ccc_bylaw_script,2015/12/26,ccc_bylaw_script,0,0,0:00:00,0,0:00:00,0,0
2015-12-26-ccc_city_script,2015/12/26,ccc_city_script,0,0,0:00:00,0,0:00:00,0,0
2015-12-26-ccc_cty_online_script,2015/12/26,ccc_cty_online_script,0,0,0:00:00,0,0:00:00,0,0
2015-12-26-ccc_feedback_script,2015/12/26,ccc_feedback_script,0,0,0:00:00,0,0:00:00,0,0
2015-12-26-ccc_fpb_script,2015/12/26,ccc_fpb_script,0,0,0:00:00,0,0:00:00,0,0
2015-12-26-ccc_help_script,2015/12/26,ccc_help_script,0,0,0:00:00,0,0:00:00,0,0
2015-12-26-ccc_link_script,2015/12/26,ccc_link_script,0,0,0:00:00,0,0:00:00,0,0
2015-12-26-ccc_media_line_script,2015/12/26,ccc_media_line_script,1,1,0:00:05,5,0:00:05,0,5
2015-12-26-ccc_priority_script,2015/12/26,ccc_priority_script,46,45,0:00:07,7,0:01:01,1,315
2015-12-26-ccc_tax_script,2015/12/26,ccc_tax_script,0,0,0:00:00,0,0:00:00,0,0
2015-12-26-ccc_waste_recycling_script,2015/12/26,ccc_waste_recycling_script,0,0,0:00:00,0,0:00:00,0,0
2015-12-27-ccc_311_calgary_script,2015/12/27,ccc_311_calgary_script,832,819,0:00:07,7,0:01:33,13,5733
2015-12-27-ccc_311_lobby_ph_script,2015/12/27,ccc_311_lobby_ph_script,0,0,0:00:00,0,0:00:00,0,0
2015-12-27-ccc_aserv_info_script,2015/12/27,ccc_aserv_info_script,0,0,0:00:00,0,0:00:00,0,0
2015-12-27-ccc_bylaw_script,2015/12/27,ccc_bylaw_script,0,0,0:00:00,0,0:00:00,0,0
2015-12-27-ccc_city_script,2015/12/27,ccc_city_script,0,0,0:00:00,0,0:00:00,0,0
2015-12-27-ccc_cty_online_script,2015/12/27,ccc_cty_online_script,0,0,0:00:00,0,0:00:00,0,0
2015-12-27-ccc_feedback_script,2015/12/27,ccc_feedback_script,0,0,0:00:00,0,0:00:00,0,0
2015-12-27-ccc_fpb_script,2015/12/27,ccc_fpb_script,0,0,0:00:00,0,0:00:00,0,0
2015-12-27-ccc_help_script,2015/12/27,ccc_help_script,0,0,0:00:00,0,0:00:00,0,0
2015-12-27-ccc_link_script,2015/12/27,ccc_link_script,0,0,0:00:00,0,0:00:00,0,0
2015-12-27-ccc_media_line_script,2015/12/27,ccc_media_line_script,1,1,0:00:03,3,0:00:03,0,3
2015-12-27-ccc_priority_script,2015/12/27,ccc_priority_script,24,24,0:00:06,6,0:00:30,0,144
2015-12-27-ccc_tax_script,2015/12/27,ccc_tax_script,0,0,0:00:00,0,0:00:00,0,0
2015-12-27-ccc_waste_recycling_script,2015/12/27,ccc_waste_recycling_script,0,0,0:00:00,0,0:00:00,0,0
2015-12-28-ccc_311_calgary_script,2015/12/28,ccc_311_calgary_script,2095,2085,0:00:07,7,0:02:02,10,14595
2015-12-28-ccc_311_lobby_ph_script,2015/12/28,ccc_311_lobby_ph_script,2,2,0:00:03,3,0:00:03,0,6
2015-12-28-ccc_aserv_info_script,2015/12/28,ccc_aserv_info_script,0,0,0:00:00,0,0:00:00,0,0
2015-12-28-ccc_bylaw_script,2015/12/28,ccc_bylaw_script,0,0,0:00:00,0,0:00:00,0,0
2015-12-28-ccc_city_script,2015/12/28,ccc_city_script,8,8,0:00:06,6,0:00:13,0,48
2015-12-28-ccc_cty_online_script,2015/12/28,ccc_cty_online_script,0,0,0:00:00,0,0:00:00,0,0
2015-12-28-ccc_feedback_script,2015/12/28,ccc_feedback_script,0,0,0:00:00,0,0:00:00,0,0
2015-12-28-ccc_fpb_script,2015/12/28,ccc_fpb_script,0,0,0:00:00,0,0:00:00,0,0
2015-12-28-ccc_help_script,2015/12/28,ccc_help_script,8,8,0:00:12,12,0:00:41,0,96
2015-12-28-ccc_link_script,2015/12/28,ccc_link_script,0,0,0:00:00,0,0:00:00,0,0
2015-12-28-ccc_media_line_script,2015/12/28,ccc_media_line_script,5,4,0:00:05,5,0:00:09,1,20
2015-12-28-ccc_priority_script,2015/12/28,ccc_priority_script,27,27,0:00:14,14,0:01:33,0,378
2015-12-28-ccc_tax_script,2015/12/28,ccc_tax_script,2,2,0:00:03,3,0:00:03,0,6
2015-12-28-ccc_waste_recycling_script,2015/12/28,ccc_waste_recycling_script,0,0,0:00:00,0,0:00:00,0,0
2015-12-29-ccc_311_calgary_script,2015/12/29,ccc_311_calgary_script,2359,2319,0:00:13,13,0:02:50,40,30147
2015-12-29-ccc_311_lobby_ph_script,2015/12/29,ccc_311_lobby_ph_script,0,0,0:00:00,0,0:00:00,0,0
2015-12-29-ccc_aserv_info_script,2015/12/29,ccc_aserv_info_script,0,0,0:00:00,0,0:00:00,0,0
2015-12-29-ccc_bylaw_script,2015/12/29,ccc_bylaw_script,0,0,0:00:00,0,0:00:00,0,0
2015-12-29-ccc_city_script,2015/12/29,ccc_city_script,18,18,0:00:09,9,0:00:28,0,162
2015-12-29-ccc_cty_online_script,2015/12/29,ccc_cty_online_script,0,0,0:00:00,0,0:00:00,0,0
2015-12-29-ccc_feedback_script,2015/12/29,ccc_feedback_script,0,0,0:00:00,0,0:00:00,0,0
2015-12-29-ccc_fpb_script,2015/12/29,ccc_fpb_script,0,0,0:00:00,0,0:00:00,0,0
2015-12-29-ccc_help_script,2015/12/29,ccc_help_script,7,7,0:00:12,12,0:00:36,0,84
2015-12-29-ccc_link_script,2015/12/29,ccc_link_script,0,0,0:00:00,0,0:00:00,0,0
2015-12-29-ccc_media_line_script,2015/12/29,ccc_media_line_script,0,0,0:00:00,0,0:00:00,0,0
2015-12-29-ccc_priority_script,2015/12/29,ccc_priority_script,31,31,0:00:08,8,0:00:47,0,248
2015-12-29-ccc_tax_script,2015/12/29,ccc_tax_script,3,3,0:00:08,8,0:00:10,0,24
2015-12-29-ccc_waste_recycling_script,2015/12/29,ccc_waste_recycling_script,0,0,0:00:00,0,0:00:00,0,0
2015-12-30-ccc_311_calgary_script,2015/12/30,ccc_311_calgary_script,2374,2298,0:00:24,24,0:04:02,76,55152
2015-12-30-ccc_311_lobby_ph_script,2015/12/30,ccc_311_lobby_ph_script,1,1,0:00:09,9,0:00:09,0,9
2015-12-30-ccc_aserv_info_script,2015/12/30,ccc_aserv_info_script,0,0,0:00:00,0,0:00:00,0,0
2015-12-30-ccc_bylaw_script,2015/12/30,ccc_bylaw_script,0,0,0:00:00,0,0:00:00,0,0
2015-12-30-ccc_city_script,2015/12/30,ccc_city_script,12,12,0:00:09,9,0:00:26,0,108
2015-12-30-ccc_cty_online_script,2015/12/30,ccc_cty_online_script,0,0,0:00:00,0,0:00:00,0,0
2015-12-30-ccc_feedback_script,2015/12/30,ccc_feedback_script,0,0,0:00:00,0,0:00:00,0,0
2015-12-30-ccc_fpb_script,2015/12/30,ccc_fpb_script,0,0,0:00:00,0,0:00:00,0,0
2015-12-30-ccc_help_script,2015/12/30,ccc_help_script,15,13,0:00:10,10,0:00:20,2,130
2015-12-30-ccc_link_script,2015/12/30,ccc_link_script,0,0,0:00:00,0,0:00:00,0,0
2015-12-30-ccc_media_line_script,2015/12/30,ccc_media_line_script,0,0,0:00:00,0,0:00:00,0,0
2015-12-30-ccc_priority_script,2015/12/30,ccc_priority_script,23,22,0:00:10,10,0:01:00,1,220
2015-12-30-ccc_tax_script,2015/12/30,ccc_tax_script,5,5,0:00:36,36,0:01:57,0,180
2015-12-30-ccc_waste_recycling_script,2015/12/30,ccc_waste_recycling_script,0,0,0:00:00,0,0:00:00,0,0
2015-12-31-ccc_311_calgary_script,2015/12/31,ccc_311_calgary_script,2059,2026,0:00:11,11,0:02:25,33,22286
2015-12-31-ccc_311_lobby_ph_script,2015/12/31,ccc_311_lobby_ph_script,2,1,0:00:05,5,0:00:05,1,5
2015-12-31-ccc_aserv_info_script,2015/12/31,ccc_aserv_info_script,0,0,0:00:00,0,0:00:00,0,0
2015-12-31-ccc_bylaw_script,2015/12/31,ccc_bylaw_script,0,0,0:00:00,0,0:00:00,0,0
2015-12-31-ccc_city_script,2015/12/31,ccc_city_script,7,7,0:00:08,8,0:00:18,0,56
2015-12-31-ccc_cty_online_script,2015/12/31,ccc_cty_online_script,0,0,0:00:00,0,0:00:00,0,0
2015-12-31-ccc_feedback_script,2015/12/31,ccc_feedback_script,0,0,0:00:00,0,0:00:00,0,0
2015-12-31-ccc_fpb_script,2015/12/31,ccc_fpb_script,0,0,0:00:00,0,0:00:00,0,0
2015-12-31-ccc_help_script,2015/12/31,ccc_help_script,10,10,0:00:12,12,0:00:55,0,120
2015-12-31-ccc_link_script,2015/12/31,ccc_link_script,0,0,0:00:00,0,0:00:00,0,0
2015-12-31-ccc_media_line_script,2015/12/31,ccc_media_line_script,0,0,0:00:00,0,0:00:00,0,0
2015-12-31-ccc_priority_script,2015/12/31,ccc_priority_script,18,18,0:00:07,7,0:00:14,0,126
2015-12-31-ccc_tax_script,2015/12/31,ccc_tax_script,1,1,0:00:05,5,0:00:05,0,5
2015-12-31-ccc_waste_recycling_script,2015/12/31,ccc_waste_recycling_script,0,0,0:00:00,0,0:00:00,0,0
2016-01-01-ccc_311_calgary_script,2016/01/01,ccc_311_calgary_script,733,667,0:00:39,39,0:09:57,63,26013
2016-01-01-ccc_311_lobby_ph_script,2016/01/01,ccc_311_lobby_ph_script,0,0,0:00:00,0,0:00:00,0,0
2016-01-01-ccc_aserv_info_script,2016/01/01,ccc_aserv_info_script,0,0,0:00:00,0,0:00:00,0,0
2016-01-01-ccc_bylaw_script,2016/01/01,ccc_bylaw_script,0,0,0:00:00,0,0:00:00,0,0
2016-01-01-ccc_city_script,2016/01/01,ccc_city_script,0,0,0:00:00,0,0:00:00,0,0
2016-01-01-ccc_cty_online_script,2016/01/01,ccc_cty_online_script,0,0,0:00:00,0,0:00:00,0,0
2016-01-01-ccc_feedback_script,2016/01/01,ccc_feedback_script,0,0,0:00:00,0,0:00:00,0,0
2016-01-01-ccc_fpb_script,2016/01/01,ccc_fpb_script,0,0,0:00:00,0,0:00:00,0,0
2016-01-01-ccc_help_script,2016/01/01,ccc_help_script,0,0,0:00:00,0,0:00:00,0,0
2016-01-01-ccc_link_script,2016/01/01,ccc_link_script,0,0,0:00:00,0,0:00:00,0,0
2016-01-01-ccc_media_line_script,2016/01/01,ccc_media_line_script,0,0,0:00:00,0,0:00:00,0,0
2016-01-01-ccc_priority_script,2016/01/01,ccc_priority_script,22,20,0:00:28,28,0:03:22,2,560
2016-01-01-ccc_tax_script,2016/01/01,ccc_tax_script,0,0,0:00:00,0,0:00:00,0,0
2016-01-01-ccc_waste_recycling_script,2016/01/01,ccc_waste_recycling_script,0,0,0:00:00,0,0:00:00,0,0
2016-01-02-ccc_311_calgary_script,2016/01/02,ccc_311_calgary_script,992,953,0:00:24,24,0:05:50,39,22872
2016-01-02-ccc_311_lobby_ph_script,2016/01/02,ccc_311_lobby_ph_script,0,0,0:00:00,0,0:00:00,0,0
2016-01-02-ccc_aserv_info_script,2016/01/02,ccc_aserv_info_script,0,0,0:00:00,0,0:00:00,0,0
2016-01-02-ccc_bylaw_script,2016/01/02,ccc_bylaw_script,0,0,0:00:00,0,0:00:00,0,0
2016-01-02-ccc_city_script,2016/01/02,ccc_city_script,0,0,0:00:00,0,0:00:00,0,0
2016-01-02-ccc_cty_online_script,2016/01/02,ccc_cty_online_script,0,0,0:00:00,0,0:00:00,0,0
2016-01-02-ccc_feedback_script,2016/01/02,ccc_feedback_script,0,0,0:00:00,0,0:00:00,0,0
2016-01-02-ccc_fpb_script,2016/01/02,ccc_fpb_script,0,0,0:00:00,0,0:00:00,0,0
2016-01-02-ccc_help_script,2016/01/02,ccc_help_script,1,1,0:00:07,7,0:00:07,0,7
2016-01-02-ccc_link_script,2016/01/02,ccc_link_script,0,0,0:00:00,0,0:00:00,0,0
2016-01-02-ccc_media_line_script,2016/01/02,ccc_media_line_script,2,1,0:00:06,6,0:00:06,1,6
2016-01-02-ccc_priority_script,2016/01/02,ccc_priority_script,26,26,0:00:08,8,0:01:14,0,208
2016-01-02-ccc_tax_script,2016/01/02,ccc_tax_script,0,0,0:00:00,0,0:00:00,0,0
2016-01-02-ccc_waste_recycling_script,2016/01/02,ccc_waste_recycling_script,0,0,0:00:00,0,0:00:00,0,0
2016-01-03-ccc_311_calgary_script,2016/01/03,ccc_311_calgary_script,797,787,0:00:09,9,0:04:32,8,7083
2016-01-03-ccc_311_lobby_ph_script,2016/01/03,ccc_311_lobby_ph_script,0,0,0:00:00,0,0:00:00,0,0
2016-01-03-ccc_aserv_info_script,2016/01/03,ccc_aserv_info_script,0,0,0:00:00,0,0:00:00,0,0
2016-01-03-ccc_bylaw_script,2016/01/03,ccc_bylaw_script,0,0,0:00:00,0,0:00:00,0,0
2016-01-03-ccc_city_script,2016/01/03,ccc_city_script,0,0,0:00:00,0,0:00:00,0,0
2016-01-03-ccc_cty_online_script,2016/01/03,ccc_cty_online_script,0,0,0:00:00,0,0:00:00,0,0
2016-01-03-ccc_feedback_script,2016/01/03,ccc_feedback_script,0,0,0:00:00,0,0:00:00,0,0
2016-01-03-ccc_fpb_script,2016/01/03,ccc_fpb_script,0,0,0:00:00,0,0:00:00,0,0
2016-01-03-ccc_help_script,2016/01/03,ccc_help_script,3,3,0:00:19,19,0:00:52,0,57
2016-01-03-ccc_link_script,2016/01/03,ccc_link_script,0,0,0:00:00,0,0:00:00,0,0
2016-01-03-ccc_media_line_script,2016/01/03,ccc_media_line_script,3,3,0:00:07,7,0:00:13,0,21
2016-01-03-ccc_priority_script,2016/01/03,ccc_priority_script,16,16,0:00:14,14,0:02:21,0,224
2016-01-03-ccc_tax_script,2016/01/03,ccc_tax_script,1,1,0:00:06,6,0:00:06,0,6
2016-01-03-ccc_waste_recycling_script,2016/01/03,ccc_waste_recycling_script,0,0,0:00:00,0,0:00:00,0,0
2016-01-04-ccc_311_calgary_script,2016/01/04,ccc_311_calgary_script,3521,3392,0:00:35,35,0:06:14,131,118720
2016-01-04-ccc_311_lobby_ph_script,2016/01/04,ccc_311_lobby_ph_script,2,2,0:00:04,4,0:00:05,0,8
2016-01-04-ccc_aserv_info_script,2016/01/04,ccc_aserv_info_script,0,0,0:00:00,0,0:00:00,0,0
2016-01-04-ccc_bylaw_script,2016/01/04,ccc_bylaw_script,1,1,0:00:03,3,0:00:03,0,3
2016-01-04-ccc_city_script,2016/01/04,ccc_city_script,22,22,0:00:10,10,0:02:00,0,220
2016-01-04-ccc_cty_online_script,2016/01/04,ccc_cty_online_script,0,0,0:00:00,0,0:00:00,0,0
2016-01-04-ccc_feedback_script,2016/01/04,ccc_feedback_script,0,0,0:00:00,0,0:00:00,0,0
2016-01-04-ccc_fpb_script,2016/01/04,ccc_fpb_script,2,2,0:00:02,2,0:00:02,0,4
2016-01-04-ccc_help_script,2016/01/04,ccc_help_script,32,32,0:00:11,11,0:00:52,0,352
2016-01-04-ccc_link_script,2016/01/04,ccc_link_script,1,0,0:00:00,0,0:00:00,0,0
2016-01-04-ccc_media_line_script,2016/01/04,ccc_media_line_script,4,4,0:00:05,5,0:00:08,0,20
2016-01-04-ccc_priority_script,2016/01/04,ccc_priority_script,35,35,0:00:12,12,0:01:20,0,420
2016-01-04-ccc_tax_script,2016/01/04,ccc_tax_script,11,11,0:00:18,18,0:01:45,0,198
2016-01-04-ccc_waste_recycling_script,2016/01/04,ccc_waste_recycling_script,0,0,0:00:00,0,0:00:00,0,0
2016-01-05-ccc_311_calgary_script,2016/01/05,ccc_311_calgary_script,3250,3143,0:00:29,29,0:03:23,107,91147
2016-01-05-ccc_311_lobby_ph_script,2016/01/05,ccc_311_lobby_ph_script,6,6,0:00:13,13,0:00:23,0,78
2016-01-05-ccc_aserv_info_script,2016/01/05,ccc_aserv_info_script,0,0,0:00:00,0,0:00:00,0,0
2016-01-05-ccc_bylaw_script,2016/01/05,ccc_bylaw_script,0,0,0:00:00,0,0:00:00,0,0
2016-01-05-ccc_city_script,2016/01/05,ccc_city_script,15,15,0:00:13,13,0:00:37,0,195
2016-01-05-ccc_cty_online_script,2016/01/05,ccc_cty_online_script,0,0,0:00:00,0,0:00:00,0,0
2016-01-05-ccc_feedback_script,2016/01/05,ccc_feedback_script,0,0,0:00:00,0,0:00:00,0,0
2016-01-05-ccc_fpb_script,2016/01/05,ccc_fpb_script,0,0,0:00:00,0,0:00:00,0,0
2016-01-05-ccc_help_script,2016/01/05,ccc_help_script,25,24,0:00:14,14,0:01:06,1,336
2016-01-05-ccc_link_script,2016/01/05,ccc_link_script,1,0,0:00:00,0,0:00:00,1,0
2016-01-05-ccc_media_line_script,2016/01/05,ccc_media_line_script,0,0,0:00:00,0,0:00:00,0,0
2016-01-05-ccc_priority_script,2016/01/05,ccc_priority_script,28,27,0:00:15,15,0:01:07,1,405
2016-01-05-ccc_tax_script,2016/01/05,ccc_tax_script,18,18,0:00:35,35,0:01:52,0,630
2016-01-05-ccc_waste_recycling_script,2016/01/05,ccc_waste_recycling_script,0,0,0:00:00,0,0:00:00,0,0
2016-01-06-ccc_311_calgary_script,2016/01/06,ccc_311_calgary_script,3069,2929,0:00:39,39,0:07:42,140,114231
2016-01-06-ccc_311_lobby_ph_script,2016/01/06,ccc_311_lobby_ph_script,1,0,0:00:00,0,0:00:00,1,0
2016-01-06-ccc_aserv_info_script,2016/01/06,ccc_aserv_info_script,0,0,0:00:00,0,0:00:00,0,0
2016-01-06-ccc_bylaw_script,2016/01/06,ccc_bylaw_script,0,0,0:00:00,0,0:00:00,0,0
2016-01-06-ccc_city_script,2016/01/06,ccc_city_script,9,8,0:00:09,9,0:00:30,1,72
2016-01-06-ccc_cty_online_script,2016/01/06,ccc_cty_online_script,0,0,0:00:00,0,0:00:00,0,0
2016-01-06-ccc_feedback_script,2016/01/06,ccc_feedback_script,0,0,0:00:00,0,0:00:00,0,0
2016-01-06-ccc_fpb_script,2016/01/06,ccc_fpb_script,0,0,0:00:00,0,0:00:00,0,0
2016-01-06-ccc_help_script,2016/01/06,ccc_help_script,9,9,0:00:19,19,0:00:45,0,171
2016-01-06-ccc_link_script,2016/01/06,ccc_link_script,0,0,0:00:00,0,0:00:00,0,0
2016-01-06-ccc_media_line_script,2016/01/06,ccc_media_line_script,0,0,0:00:00,0,0:00:00,0,0
2016-01-06-ccc_priority_script,2016/01/06,ccc_priority_script,34,32,0:00:18,18,0:03:34,2,576
2016-01-06-ccc_tax_script,2016/01/06,ccc_tax_script,20,18,0:00:31,31,0:01:19,2,558
2016-01-06-ccc_waste_recycling_script,2016/01/06,ccc_waste_recycling_script,0,0,0:00:00,0,0:00:00,0,0
2016-01-07-ccc_311_calgary_script,2016/01/07,ccc_311_calgary_script,3039,2980,0:00:17,17,0:03:41,59,50660
2016-01-07-ccc_311_lobby_ph_script,2016/01/07,ccc_311_lobby_ph_script,0,0,0:00:00,0,0:00:00,0,0
2016-01-07-ccc_aserv_info_script,2016/01/07,ccc_aserv_info_script,0,0,0:00:00,0,0:00:00,0,0
2016-01-07-ccc_bylaw_script,2016/01/07,ccc_bylaw_script,0,0,0:00:00,0,0:00:00,0,0
2016-01-07-ccc_city_script,2016/01/07,ccc_city_script,20,20,0:00:10,10,0:00:49,0,200
2016-01-07-ccc_cty_online_script,2016/01/07,ccc_cty_online_script,0,0,0:00:00,0,0:00:00,0,0
2016-01-07-ccc_feedback_script,2016/01/07,ccc_feedback_script,1,0,0:00:00,0,0:00:00,1,0
2016-01-07-ccc_fpb_script,2016/01/07,ccc_fpb_script,0,0,0:00:00,0,0:00:00,0,0
2016-01-07-ccc_help_script,2016/01/07,ccc_help_script,10,9,0:00:16,16,0:00:47,1,144
2016-01-07-ccc_link_script,2016/01/07,ccc_link_script,0,0,0:00:00,0,0:00:00,0,0
2016-01-07-ccc_media_line_script,2016/01/07,ccc_media_line_script,0,0,0:00:00,0,0:00:00,0,0
2016-01-07-ccc_priority_script,2016/01/07,ccc_priority_script,40,40,0:00:08,8,0:00:34,0,320
2016-01-07-ccc_tax_script,2016/01/07,ccc_tax_script,18,17,0:00:10,10,0:00:31,1,170
2016-01-07-ccc_waste_recycling_script,2016/01/07,ccc_waste_recycling_script,0,0,0:00:00,0,0:00:00,0,0
2016-01-08-ccc_311_calgary_script,2016/01/08,ccc_311_calgary_script,2984,2819,0:00:44,44,0:08:09,165,124036
2016-01-08-ccc_311_lobby_ph_script,2016/01/08,ccc_311_lobby_ph_script,1,0,0:00:00,0,0:00:00,1,0
2016-01-08-ccc_aserv_info_script,2016/01/08,ccc_aserv_info_script,0,0,0:00:00,0,0:00:00,0,0
2016-01-08-ccc_bylaw_script,2016/01/08,ccc_bylaw_script,0,0,0:00:00,0,0:00:00,0,0
2016-01-08-ccc_city_script,2016/01/08,ccc_city_script,14,14,0:00:17,17,0:01:22,0,238
2016-01-08-ccc_cty_online_script,2016/01/08,ccc_cty_online_script,0,0,0:00:00,0,0:00:00,0,0
2016-01-08-ccc_feedback_script,2016/01/08,ccc_feedback_script,1,0,0:00:00,0,0:00:00,0,0
2016-01-08-ccc_fpb_script,2016/01/08,ccc_fpb_script,0,0,0:00:00,0,0:00:00,0,0
2016-01-08-ccc_help_script,2016/01/08,ccc_help_script,10,8,0:00:11,11,0:00:37,2,88
2016-01-08-ccc_link_script,2016/01/08,ccc_link_script,0,0,0:00:00,0,0:00:00,0,0
2016-01-08-ccc_media_line_script,2016/01/08,ccc_media_line_script,3,3,0:00:04,4,0:00:07,0,12
2016-01-08-ccc_priority_script,2016/01/08,ccc_priority_script,25,25,0:00:10,10,0:00:59,0,250
2016-01-08-ccc_tax_script,2016/01/08,ccc_tax_script,14,10,0:00:31,31,0:02:26,4,310
2016-01-08-ccc_waste_recycling_script,2016/01/08,ccc_waste_recycling_script,0,0,0:00:00,0,0:00:00,0,0
2016-01-09-ccc_311_calgary_script,2016/01/09,ccc_311_calgary_script,1219,1096,0:00:22,22,0:09:42,123,24112
2016-01-09-ccc_311_lobby_ph_script,2016/01/09,ccc_311_lobby_ph_script,0,0,0:00:00,0,0:00:00,0,0
2016-01-09-ccc_aserv_info_script,2016/01/09,ccc_aserv_info_script,0,0,0:00:00,0,0:00:00,0,0
2016-01-09-ccc_bylaw_script,2016/01/09,ccc_bylaw_script,0,0,0:00:00,0,0:00:00,0,0
2016-01-09-ccc_city_script,2016/01/09,ccc_city_script,0,0,0:00:00,0,0:00:00,0,0
2016-01-09-ccc_cty_online_script,2016/01/09,ccc_cty_online_script,0,0,0:00:00,0,0:00:00,0,0
2016-01-09-ccc_feedback_script,2016/01/09,ccc_feedback_script,0,0,0:00:00,0,0:00:00,0,0
2016-01-09-ccc_fpb_script,2016/01/09,ccc_fpb_script,0,0,0:00:00,0,0:00:00,0,0
2016-01-09-ccc_help_script,2016/01/09,ccc_help_script,3,3,0:00:07,7,0:00:10,0,21
2016-01-09-ccc_link_script,2016/01/09,ccc_link_script,0,0,0:00:00,0,0:00:00,0,0
2016-01-09-ccc_media_line_script,2016/01/09,ccc_media_line_script,3,3,0:00:06,6,0:00:09,0,18
2016-01-09-ccc_priority_script,2016/01/09,ccc_priority_script,30,29,0:00:10,10,0:01:29,1,290
2016-01-09-ccc_tax_script,2016/01/09,ccc_tax_script,0,0,0:00:00,0,0:00:00,0,0
2016-01-09-ccc_waste_recycling_script,2016/01/09,ccc_waste_recycling_script,0,0,0:00:00,0,0:00:00,0,0
2016-01-10-ccc_311_calgary_script,2016/01/10,ccc_311_calgary_script,834,823,0:00:09,9,0:05:25,10,7407
2016-01-10-ccc_311_lobby_ph_script,2016/01/10,ccc_311_lobby_ph_script,0,0,0:00:00,0,0:00:00,0,0
2016-01-10-ccc_aserv_info_script,2016/01/10,ccc_aserv_info_script,0,0,0:00:00,0,0:00:00,0,0
2016-01-10-ccc_bylaw_script,2016/01/10,ccc_bylaw_script,0,0,0:00:00,0,0:00:00,0,0
2016-01-10-ccc_city_script,2016/01/10,ccc_city_script,0,0,0:00:00,0,0:00:00,0,0
2016-01-10-ccc_cty_online_script,2016/01/10,ccc_cty_online_script,0,0,0:00:00,0,0:00:00,0,0
2016-01-10-ccc_feedback_script,2016/01/10,ccc_feedback_script,0,0,0:00:00,0,0:00:00,0,0
2016-01-10-ccc_fpb_script,2016/01/10,ccc_fpb_script,0,0,0:00:00,0,0:00:00,0,0
2016-01-10-ccc_help_script,2016/01/10,ccc_help_script,5,5,0:00:04,4,0:00:06,0,20
2016-01-10-ccc_link_script,2016/01/10,ccc_link_script,0,0,0:00:00,0,0:00:00,0,0
2016-01-10-ccc_media_line_script,2016/01/10,ccc_media_line_script,1,1,0:00:04,4,0:00:04,0,4
2016-01-10-ccc_priority_script,2016/01/10,ccc_priority_script,24,24,0:00:06,6,0:00:18,0,144
2016-01-10-ccc_tax_script,2016/01/10,ccc_tax_script,0,0,0:00:00,0,0:00:00,0,0
2016-01-10-ccc_waste_recycling_script,2016/01/10,ccc_waste_recycling_script,0,0,0:00:00,0,0:00:00,0,0
2016-01-11-ccc_311_calgary_script,2016/01/11,ccc_311_calgary_script,3192,3156,0:00:11,11,0:02:42,37,34716
2016-01-11-ccc_311_lobby_ph_script,2016/01/11,ccc_311_lobby_ph_script,2,2,0:00:11,11,0:00:18,0,22
2016-01-11-ccc_aserv_info_script,2016/01/11,ccc_aserv_info_script,0,0,0:00:00,0,0:00:00,0,0
2016-01-11-ccc_bylaw_script,2016/01/11,ccc_bylaw_script,0,0,0:00:00,0,0:00:00,0,0
2016-01-11-ccc_city_script,2016/01/11,ccc_city_script,18,18,0:00:06,6,0:00:19,0,108
2016-01-11-ccc_cty_online_script,2016/01/11,ccc_cty_online_script,0,0,0:00:00,0,0:00:00,0,0
2016-01-11-ccc_feedback_script,2016/01/11,ccc_feedback_script,0,0,0:00:00,0,0:00:00,0,0
2016-01-11-ccc_fpb_script,2016/01/11,ccc_fpb_script,1,1,0:00:12,12,0:00:12,0,12
2016-01-11-ccc_help_script,2016/01/11,ccc_help_script,19,19,0:00:08,8,0:00:35,0,152
2016-01-11-ccc_link_script,2016/01/11,ccc_link_script,0,0,0:00:00,0,0:00:00,0,0
2016-01-11-ccc_media_line_script,2016/01/11,ccc_media_line_script,0,0,0:00:00,0,0:00:00,0,0
2016-01-11-ccc_priority_script,2016/01/11,ccc_priority_script,23,23,0:00:07,7,0:00:19,0,161
2016-01-11-ccc_tax_script,2016/01/11,ccc_tax_script,21,21,0:00:13,13,0:01:44,0,273
2016-01-11-ccc_waste_recycling_script,2016/01/11,ccc_waste_recycling_script,0,0,0:00:00,0,0:00:00,0,0
2016-01-12-ccc_311_calgary_script,2016/01/12,ccc_311_calgary_script,2952,2865,0:00:20,20,0:04:13,87,57300
2016-01-12-ccc_311_lobby_ph_script,2016/01/12,ccc_311_lobby_ph_script,4,1,0:00:13,13,0:00:13,3,13
2016-01-12-ccc_aserv_info_script,2016/01/12,ccc_aserv_info_script,0,0,0:00:00,0,0:00:00,0,0
2016-01-12-ccc_bylaw_script,2016/01/12,ccc_bylaw_script,0,0,0:00:00,0,0:00:00,0,0
2016-01-12-ccc_city_script,2016/01/12,ccc_city_script,6,6,0:00:06,6,0:00:18,0,36
2016-01-12-ccc_cty_online_script,2016/01/12,ccc_cty_online_script,0,0,0:00:00,0,0:00:00,0,0
2016-01-12-ccc_feedback_script,2016/01/12,ccc_feedback_script,0,0,0:00:00,0,0:00:00,0,0
2016-01-12-ccc_fpb_script,2016/01/12,ccc_fpb_script,0,0,0:00:00,0,0:00:00,0,0
2016-01-12-ccc_help_script,2016/01/12,ccc_help_script,8,8,0:00:12,12,0:00:34,0,96
2016-01-12-ccc_link_script,2016/01/12,ccc_link_script,0,0,0:00:00,0,0:00:00,0,0
2016-01-12-ccc_media_line_script,2016/01/12,ccc_media_line_script,0,0,0:00:00,0,0:00:00,0,0
2016-01-12-ccc_priority_script,2016/01/12,ccc_priority_script,14,14,0:00:11,11,0:00:43,0,154
2016-01-12-ccc_tax_script,2016/01/12,ccc_tax_script,24,22,0:00:28,28,0:02:33,2,616
2016-01-12-ccc_waste_recycling_script,2016/01/12,ccc_waste_recycling_script,0,0,0:00:00,0,0:00:00,0,0
2016-01-13-ccc_311_calgary_script,2016/01/13,ccc_311_calgary_script,2796,2765,0:00:09,9,0:06:56,31,24885
2016-01-13-ccc_311_lobby_ph_script,2016/01/13,ccc_311_lobby_ph_script,4,3,0:00:06,6,0:00:08,1,18
2016-01-13-ccc_aserv_info_script,2016/01/13,ccc_aserv_info_script,0,0,0:00:00,0,0:00:00,0,0
2016-01-13-ccc_bylaw_script,2016/01/13,ccc_bylaw_script,0,0,0:00:00,0,0:00:00,0,0
2016-01-13-ccc_city_script,2016/01/13,ccc_city_script,19,18,0:00:06,6,0:00:21,1,108
2016-01-13-ccc_cty_online_script,2016/01/13,ccc_cty_online_script,0,0,0:00:00,0,0:00:00,0,0
2016-01-13-ccc_feedback_script,2016/01/13,ccc_feedback_script,0,0,0:00:00,0,0:00:00,0,0
2016-01-13-ccc_fpb_script,2016/01/13,ccc_fpb_script,0,0,0:00:00,0,0:00:00,0,0
2016-01-13-ccc_help_script,2016/01/13,ccc_help_script,13,13,0:00:10,10,0:01:09,0,130
2016-01-13-ccc_link_script,2016/01/13,ccc_link_script,0,0,0:00:00,0,0:00:00,0,0
2016-01-13-ccc_media_line_script,2016/01/13,ccc_media_line_script,0,0,0:00:00,0,0:00:00,0,0
2016-01-13-ccc_priority_script,2016/01/13,ccc_priority_script,20,20,0:00:14,14,0:01:20,0,280
2016-01-13-ccc_tax_script,2016/01/13,ccc_tax_script,14,14,0:00:08,8,0:00:47,0,112
2016-01-13-ccc_waste_recycling_script,2016/01/13,ccc_waste_recycling_script,0,0,0:00:00,0,0:00:00,0,0
2016-01-14-ccc_311_calgary_script,2016/01/14,ccc_311_calgary_script,2929,2827,0:00:24,24,0:04:12,102,67848
2016-01-14-ccc_311_lobby_ph_script,2016/01/14,ccc_311_lobby_ph_script,0,0,0:00:00,0,0:00:00,0,0
2016-01-14-ccc_aserv_info_script,2016/01/14,ccc_aserv_info_script,0,0,0:00:00,0,0:00:00,0,0
2016-01-14-ccc_bylaw_script,2016/01/14,ccc_bylaw_script,0,0,0:00:00,0,0:00:00,0,0
2016-01-14-ccc_city_script,2016/01/14,ccc_city_script,10,10,0:00:14,14,0:00:43,0,140
2016-01-14-ccc_cty_online_script,2016/01/14,ccc_cty_online_script,0,0,0:00:00,0,0:00:00,0,0
2016-01-14-ccc_feedback_script,2016/01/14,ccc_feedback_script,0,0,0:00:00,0,0:00:00,0,0
2016-01-14-ccc_fpb_script,2016/01/14,ccc_fpb_script,0,0,0:00:00,0,0:00:00,0,0
2016-01-14-ccc_help_script,2016/01/14,ccc_help_script,11,8,0:00:09,9,0:00:41,3,72
2016-01-14-ccc_link_script,2016/01/14,ccc_link_script,0,0,0:00:00,0,0:00:00,0,0
2016-01-14-ccc_media_line_script,2016/01/14,ccc_media_line_script,0,0,0:00:00,0,0:00:00,0,0
2016-01-14-ccc_priority_script,2016/01/14,ccc_priority_script,24,24,0:00:08,8,0:00:28,0,192
2016-01-14-ccc_tax_script,2016/01/14,ccc_tax_script,22,22,0:00:12,12,0:01:14,0,264
2016-01-14-ccc_waste_recycling_script,2016/01/14,ccc_waste_recycling_script,0,0,0:00:00,0,0:00:00,0,0
2016-01-15-ccc_311_calgary_script,2016/01/15,ccc_311_calgary_script,2692,2603,0:00:32,32,0:04:48,87,83296
2016-01-15-ccc_311_lobby_ph_script,2016/01/15,ccc_311_lobby_ph_script,5,4,0:00:06,6,0:00:09,1,24
2016-01-15-ccc_aserv_info_script,2016/01/15,ccc_aserv_info_script,0,0,0:00:00,0,0:00:00,0,0
2016-01-15-ccc_bylaw_script,2016/01/15,ccc_bylaw_script,0,0,0:00:00,0,0:00:00,0,0
2016-01-15-ccc_city_script,2016/01/15,ccc_city_script,14,14,0:00:10,10,0:00:25,0,140
2016-01-15-ccc_cty_online_script,2016/01/15,ccc_cty_online_script,0,0,0:00:00,0,0:00:00,0,0
2016-01-15-ccc_feedback_script,2016/01/15,ccc_feedback_script,0,0,0:00:00,0,0:00:00,0,0
2016-01-15-ccc_fpb_script,2016/01/15,ccc_fpb_script,0,0,0:00:00,0,0:00:00,0,0
2016-01-15-ccc_help_script,2016/01/15,ccc_help_script,8,8,0:00:07,7,0:00:19,0,56
2016-01-15-ccc_link_script,2016/01/15,ccc_link_script,0,0,0:00:00,0,0:00:00,0,0
2016-01-15-ccc_media_line_script,2016/01/15,ccc_media_line_script,2,2,0:00:07,7,0:00:09,0,14
2016-01-15-ccc_priority_script,2016/01/15,ccc_priority_script,36,33,0:00:18,18,0:01:47,1,594
2016-01-15-ccc_tax_script,2016/01/15,ccc_tax_script,25,24,0:00:32,32,0:04:53,1,768
2016-01-15-ccc_waste_recycling_script,2016/01/15,ccc_waste_recycling_script,0,0,0:00:00,0,0:00:00,0,0
2016-01-16-ccc_311_calgary_script,2016/01/16,ccc_311_calgary_script,875,869,0:00:07,7,0:03:44,7,6083
2016-01-16-ccc_311_lobby_ph_script,2016/01/16,ccc_311_lobby_ph_script,0,0,0:00:00,0,0:00:00,0,0
2016-01-16-ccc_aserv_info_script,2016/01/16,ccc_aserv_info_script,0,0,0:00:00,0,0:00:00,0,0
2016-01-16-ccc_bylaw_script,2016/01/16,ccc_bylaw_script,0,0,0:00:00,0,0:00:00,0,0
2016-01-16-ccc_city_script,2016/01/16,ccc_city_script,0,0,0:00:00,0,0:00:00,0,0
2016-01-16-ccc_cty_online_script,2016/01/16,ccc_cty_online_script,0,0,0:00:00,0,0:00:00,0,0
2016-01-16-ccc_feedback_script,2016/01/16,ccc_feedback_script,0,0,0:00:00,0,0:00:00,0,0
2016-01-16-ccc_fpb_script,2016/01/16,ccc_fpb_script,0,0,0:00:00,0,0:00:00,0,0
2016-01-16-ccc_help_script,2016/01/16,ccc_help_script,5,5,0:00:06,6,0:00:10,0,30
2016-01-16-ccc_link_script,2016/01/16,ccc_link_script,0,0,0:00:00,0,0:00:00,0,0
2016-01-16-ccc_media_line_script,2016/01/16,ccc_media_line_script,1,1,0:00:05,5,0:00:05,0,5
2016-01-16-ccc_priority_script,2016/01/16,ccc_priority_script,19,19,0:00:06,6,0:00:18,0,114
2016-01-16-ccc_tax_script,2016/01/16,ccc_tax_script,0,0,0:00:00,0,0:00:00,0,0
2016-01-16-ccc_waste_recycling_script,2016/01/16,ccc_waste_recycling_script,0,0,0:00:00,0,0:00:00,0,0
2016-01-17-ccc_311_calgary_script,2016/01/17,ccc_311_calgary_script,750,739,0:00:07,7,0:02:27,11,5173
2016-01-17-ccc_311_lobby_ph_script,2016/01/17,ccc_311_lobby_ph_script,0,0,0:00:00,0,0:00:00,0,0
2016-01-17-ccc_aserv_info_script,2016/01/17,ccc_aserv_info_script,0,0,0:00:00,0,0:00:00,0,0
2016-01-17-ccc_bylaw_script,2016/01/17,ccc_bylaw_script,0,0,0:00:00,0,0:00:00,0,0
2016-01-17-ccc_city_script,2016/01/17,ccc_city_script,0,0,0:00:00,0,0:00:00,0,0
2016-01-17-ccc_cty_online_script,2016/01/17,ccc_cty_online_script,0,0,0:00:00,0,0:00:00,0,0
2016-01-17-ccc_feedback_script,2016/01/17,ccc_feedback_script,0,0,0:00:00,0,0:00:00,0,0
2016-01-17-ccc_fpb_script,2016/01/17,ccc_fpb_script,0,0,0:00:00,0,0:00:00,0,0
2016-01-17-ccc_help_script,2016/01/17,ccc_help_script,2,2,0:00:04,4,0:00:05,0,8
2016-01-17-ccc_link_script,2016/01/17,ccc_link_script,0,0,0:00:00,0,0:00:00,0,0
2016-01-17-ccc_media_line_script,2016/01/17,ccc_media_line_script,1,1,0:00:10,10,0:00:10,0,10
2016-01-17-ccc_priority_script,2016/01/17,ccc_priority_script,13,13,0:00:08,8,0:00:46,0,104
2016-01-17-ccc_tax_script,2016/01/17,ccc_tax_script,0,0,0:00:00,0,0:00:00,0,0
2016-01-17-ccc_waste_recycling_script,2016/01/17,ccc_waste_recycling_script,0,0,0:00:00,0,0:00:00,0,0
2016-01-18-ccc_311_calgary_script,2016/01/18,ccc_311_calgary_script,3076,2973,0:00:26,26,0:10:38,103,77298
2016-01-18-ccc_311_lobby_ph_script,2016/01/18,ccc_311_lobby_ph_script,5,5,0:00:13,13,0:00:21,0,65
2016-01-18-ccc_aserv_info_script,2016/01/18,ccc_aserv_info_script,0,0,0:00:00,0,0:00:00,0,0
2016-01-18-ccc_bylaw_script,2016/01/18,ccc_bylaw_script,0,0,0:00:00,0,0:00:00,0,0
2016-01-18-ccc_city_script,2016/01/18,ccc_city_script,25,25,0:00:11,11,0:00:30,0,275
2016-01-18-ccc_cty_online_script,2016/01/18,ccc_cty_online_script,0,0,0:00:00,0,0:00:00,0,0
2016-01-18-ccc_feedback_script,2016/01/18,ccc_feedback_script,0,0,0:00:00,0,0:00:00,0,0
2016-01-18-ccc_fpb_script,2016/01/18,ccc_fpb_script,1,1,0:00:05,5,0:00:05,0,5
2016-01-18-ccc_help_script,2016/01/18,ccc_help_script,18,16,0:00:09,9,0:00:25,2,144
2016-01-18-ccc_link_script,2016/01/18,ccc_link_script,0,0,0:00:00,0,0:00:00,0,0
2016-01-18-ccc_media_line_script,2016/01/18,ccc_media_line_script,0,0,0:00:00,0,0:00:00,0,0
2016-01-18-ccc_priority_script,2016/01/18,ccc_priority_script,22,22,0:00:11,11,0:00:39,0,242
2016-01-18-ccc_tax_script,2016/01/18,ccc_tax_script,9,9,0:00:38,38,0:01:51,0,342
2016-01-18-ccc_waste_recycling_script,2016/01/18,ccc_waste_recycling_script,0,0,0:00:00,0,0:00:00,0,0
2016-01-19-ccc_311_calgary_script,2016/01/19,ccc_311_calgary_script,2980,2901,0:00:24,24,0:04:26,79,69624
2016-01-19-ccc_311_lobby_ph_script,2016/01/19,ccc_311_lobby_ph_script,6,6,0:00:10,10,0:00:30,0,60
2016-01-19-ccc_aserv_info_script,2016/01/19,ccc_aserv_info_script,0,0,0:00:00,0,0:00:00,0,0
2016-01-19-ccc_bylaw_script,2016/01/19,ccc_bylaw_script,0,0,0:00:00,0,0:00:00,0,0
2016-01-19-ccc_city_script,2016/01/19,ccc_city_script,19,18,0:00:14,14,0:00:44,1,252
2016-01-19-ccc_cty_online_script,2016/01/19,ccc_cty_online_script,0,0,0:00:00,0,0:00:00,0,0
2016-01-19-ccc_feedback_script,2016/01/19,ccc_feedback_script,0,0,0:00:00,0,0:00:00,0,0
2016-01-19-ccc_fpb_script,2016/01/19,ccc_fpb_script,0,0,0:00:00,0,0:00:00,0,0
2016-01-19-ccc_help_script,2016/01/19,ccc_help_script,14,14,0:00:15,15,0:01:09,0,210
2016-01-19-ccc_link_script,2016/01/19,ccc_link_script,0,0,0:00:00,0,0:00:00,0,0
2016-01-19-ccc_media_line_script,2016/01/19,ccc_media_line_script,1,1,0:00:04,4,0:00:04,0,4
2016-01-19-ccc_priority_script,2016/01/19,ccc_priority_script,25,24,0:00:09,9,0:00:34,1,216
2016-01-19-ccc_tax_script,2016/01/19,ccc_tax_script,15,14,0:00:35,35,0:02:12,1,490
2016-01-19-ccc_waste_recycling_script,2016/01/19,ccc_waste_recycling_script,0,0,0:00:00,0,0:00:00,0,0
2016-01-20-ccc_311_calgary_script,2016/01/20,ccc_311_calgary_script,2843,2683,0:00:43,43,0:05:53,160,115369
2016-01-20-ccc_311_lobby_ph_script,2016/01/20,ccc_311_lobby_ph_script,2,2,0:00:13,13,0:00:22,0,26
2016-01-20-ccc_aserv_info_script,2016/01/20,ccc_aserv_info_script,0,0,0:00:00,0,0:00:00,0,0
2016-01-20-ccc_bylaw_script,2016/01/20,ccc_bylaw_script,0,0,0:00:00,0,0:00:00,0,0
2016-01-20-ccc_city_script,2016/01/20,ccc_city_script,11,11,0:00:14,14,0:00:28,0,154
2016-01-20-ccc_cty_online_script,2016/01/20,ccc_cty_online_script,0,0,0:00:00,0,0:00:00,0,0
2016-01-20-ccc_feedback_script,2016/01/20,ccc_feedback_script,0,0,0:00:00,0,0:00:00,0,0
2016-01-20-ccc_fpb_script,2016/01/20,ccc_fpb_script,1,1,0:01:07,67,0:01:07,0,67
2016-01-20-ccc_help_script,2016/01/20,ccc_help_script,8,8,0:00:21,21,0:01:07,0,168
2016-01-20-ccc_link_script,2016/01/20,ccc_link_script,0,0,0:00:00,0,0:00:00,0,0
2016-01-20-ccc_media_line_script,2016/01/20,ccc_media_line_script,0,0,0:00:00,0,0:00:00,0,0
2016-01-20-ccc_priority_script,2016/01/20,ccc_priority_script,31,30,0:00:12,12,0:00:47,1,360
2016-01-20-ccc_tax_script,2016/01/20,ccc_tax_script,24,23,0:01:01,61,0:03:00,1,1403
2016-01-20-ccc_waste_recycling_script,2016/01/20,ccc_waste_recycling_script,0,0,0:00:00,0,0:00:00,0,0
2016-01-21-ccc_311_calgary_script,2016/01/21,ccc_311_calgary_script,2684,2626,0:00:19,19,0:05:05,58,49894
2016-01-21-ccc_311_lobby_ph_script,2016/01/21,ccc_311_lobby_ph_script,1,1,0:00:04,4,0:00:04,0,4
2016-01-21-ccc_aserv_info_script,2016/01/21,ccc_aserv_info_script,0,0,0:00:00,0,0:00:00,0,0
2016-01-21-ccc_bylaw_script,2016/01/21,ccc_bylaw_script,0,0,0:00:00,0,0:00:00,0,0
2016-01-21-ccc_city_script,2016/01/21,ccc_city_script,26,26,0:00:10,10,0:00:37,0,260
2016-01-21-ccc_cty_online_script,2016/01/21,ccc_cty_online_script,0,0,0:00:00,0,0:00:00,0,0
2016-01-21-ccc_feedback_script,2016/01/21,ccc_feedback_script,0,0,0:00:00,0,0:00:00,0,0
2016-01-21-ccc_fpb_script,2016/01/21,ccc_fpb_script,1,1,0:00:16,16,0:00:16,0,16
2016-01-21-ccc_help_script,2016/01/21,ccc_help_script,20,18,0:00:09,9,0:00:35,2,162
2016-01-21-ccc_link_script,2016/01/21,ccc_link_script,1,0,0:00:00,0,0:00:00,1,0
2016-01-21-ccc_media_line_script,2016/01/21,ccc_media_line_script,1,1,0:00:37,37,0:00:37,0,37
2016-01-21-ccc_priority_script,2016/01/21,ccc_priority_script,18,17,0:00:06,6,0:00:14,1,102
2016-01-21-ccc_tax_script,2016/01/21,ccc_tax_script,16,15,0:00:20,20,0:01:53,1,300
2016-01-21-ccc_waste_recycling_script,2016/01/21,ccc_waste_recycling_script,0,0,0:00:00,0,0:00:00,0,0
2016-01-22-ccc_311_calgary_script,2016/01/22,ccc_311_calgary_script,2563,2507,0:00:15,15,0:04:49,56,37605
2016-01-22-ccc_311_lobby_ph_script,2016/01/22,ccc_311_lobby_ph_script,1,1,0:00:03,3,0:00:03,0,3
2016-01-22-ccc_aserv_info_script,2016/01/22,ccc_aserv_info_script,0,0,0:00:00,0,0:00:00,0,0
2016-01-22-ccc_bylaw_script,2016/01/22,ccc_bylaw_script,0,0,0:00:00,0,0:00:00,0,0
2016-01-22-ccc_city_script,2016/01/22,ccc_city_script,18,18,0:00:09,9,0:00:58,0,162
2016-01-22-ccc_cty_online_script,2016/01/22,ccc_cty_online_script,0,0,0:00:00,0,0:00:00,0,0
2016-01-22-ccc_feedback_script,2016/01/22,ccc_feedback_script,0,0,0:00:00,0,0:00:00,0,0
2016-01-22-ccc_fpb_script,2016/01/22,ccc_fpb_script,1,1,0:00:03,3,0:00:03,0,3
2016-01-22-ccc_help_script,2016/01/22,ccc_help_script,6,6,0:00:13,13,0:00:35,0,78
2016-01-22-ccc_link_script,2016/01/22,ccc_link_script,0,0,0:00:00,0,0:00:00,0,0
2016-01-22-ccc_media_line_script,2016/01/22,ccc_media_line_script,1,1,0:00:05,5,0:00:05,0,5
2016-01-22-ccc_priority_script,2016/01/22,ccc_priority_script,28,28,0:00:10,10,0:00:50,0,280
2016-01-22-ccc_tax_script,2016/01/22,ccc_tax_script,14,14,0:00:14,14,0:01:02,0,196
2016-01-22-ccc_waste_recycling_script,2016/01/22,ccc_waste_recycling_script,0,0,0:00:00,0,0:00:00,0,0
2016-01-23-ccc_311_calgary_script,2016/01/23,ccc_311_calgary_script,1055,1035,0:00:15,15,0:03:24,20,15525
2016-01-23-ccc_311_lobby_ph_script,2016/01/23,ccc_311_lobby_ph_script,0,0,0:00:00,0,0:00:00,0,0
2016-01-23-ccc_aserv_info_script,2016/01/23,ccc_aserv_info_script,0,0,0:00:00,0,0:00:00,0,0
2016-01-23-ccc_bylaw_script,2016/01/23,ccc_bylaw_script,0,0,0:00:00,0,0:00:00,0,0
2016-01-23-ccc_city_script,2016/01/23,ccc_city_script,0,0,0:00:00,0,0:00:00,0,0
2016-01-23-ccc_cty_online_script,2016/01/23,ccc_cty_online_script,0,0,0:00:00,0,0:00:00,0,0
2016-01-23-ccc_feedback_script,2016/01/23,ccc_feedback_script,2,0,0:00:00,0,0:00:00,0,0
2016-01-23-ccc_fpb_script,2016/01/23,ccc_fpb_script,0,0,0:00:00,0,0:00:00,0,0
2016-01-23-ccc_help_script,2016/01/23,ccc_help_script,5,5,0:00:22,22,0:01:23,0,110
2016-01-23-ccc_link_script,2016/01/23,ccc_link_script,0,0,0:00:00,0,0:00:00,0,0
2016-01-23-ccc_media_line_script,2016/01/23,ccc_media_line_script,0,0,0:00:00,0,0:00:00,0,0
2016-01-23-ccc_priority_script,2016/01/23,ccc_priority_script,21,21,0:00:21,21,0:02:31,0,441
2016-01-23-ccc_tax_script,2016/01/23,ccc_tax_script,1,1,0:00:09,9,0:00:09,0,9
2016-01-23-ccc_waste_recycling_script,2016/01/23,ccc_waste_recycling_script,0,0,0:00:00,0,0:00:00,0,0
2016-01-24-ccc_311_calgary_script,2016/01/24,ccc_311_calgary_script,908,894,0:00:12,12,0:06:23,14,10728
2016-01-24-ccc_311_lobby_ph_script,2016/01/24,ccc_311_lobby_ph_script,0,0,0:00:00,0,0:00:00,0,0
2016-01-24-ccc_aserv_info_script,2016/01/24,ccc_aserv_info_script,0,0,0:00:00,0,0:00:00,0,0
2016-01-24-ccc_bylaw_script,2016/01/24,ccc_bylaw_script,0,0,0:00:00,0,0:00:00,0,0
2016-01-24-ccc_city_script,2016/01/24,ccc_city_script,0,0,0:00:00,0,0:00:00,0,0
2016-01-24-ccc_cty_online_script,2016/01/24,ccc_cty_online_script,0,0,0:00:00,0,0:00:00,0,0
2016-01-24-ccc_feedback_script,2016/01/24,ccc_feedback_script,0,0,0:00:00,0,0:00:00,0,0
2016-01-24-ccc_fpb_script,2016/01/24,ccc_fpb_script,0,0,0:00:00,0,0:00:00,0,0
2016-01-24-ccc_help_script,2016/01/24,ccc_help_script,3,3,0:00:06,6,0:00:08,0,18
2016-01-24-ccc_link_script,2016/01/24,ccc_link_script,0,0,0:00:00,0,0:00:00,0,0
2016-01-24-ccc_media_line_script,2016/01/24,ccc_media_line_script,0,0,0:00:00,0,0:00:00,0,0
2016-01-24-ccc_priority_script,2016/01/24,ccc_priority_script,15,15,0:00:14,14,0:01:43,0,210
2016-01-24-ccc_tax_script,2016/01/24,ccc_tax_script,0,0,0:00:00,0,0:00:00,0,0
2016-01-24-ccc_waste_recycling_script,2016/01/24,ccc_waste_recycling_script,0,0,0:00:00,0,0:00:00,0,0
2016-01-25-ccc_311_calgary_script,2016/01/25,ccc_311_calgary_script,3204,3149,0:00:11,11,0:02:31,55,34639
2016-01-25-ccc_311_lobby_ph_script,2016/01/25,ccc_311_lobby_ph_script,1,1,0:00:05,5,0:00:05,0,5
2016-01-25-ccc_aserv_info_script,2016/01/25,ccc_aserv_info_script,0,0,0:00:00,0,0:00:00,0,0
2016-01-25-ccc_bylaw_script,2016/01/25,ccc_bylaw_script,0,0,0:00:00,0,0:00:00,0,0
2016-01-25-ccc_city_script,2016/01/25,ccc_city_script,14,13,0:00:05,5,0:00:10,1,65
2016-01-25-ccc_cty_online_script,2016/01/25,ccc_cty_online_script,0,0,0:00:00,0,0:00:00,0,0
2016-01-25-ccc_feedback_script,2016/01/25,ccc_feedback_script,0,0,0:00:00,0,0:00:00,0,0
2016-01-25-ccc_fpb_script,2016/01/25,ccc_fpb_script,0,0,0:00:00,0,0:00:00,0,0
2016-01-25-ccc_help_script,2016/01/25,ccc_help_script,11,11,0:00:09,9,0:00:21,0,99
2016-01-25-ccc_link_script,2016/01/25,ccc_link_script,0,0,0:00:00,0,0:00:00,0,0
2016-01-25-ccc_media_line_script,2016/01/25,ccc_media_line_script,0,0,0:00:00,0,0:00:00,0,0
2016-01-25-ccc_priority_script,2016/01/25,ccc_priority_script,25,25,0:00:04,4,0:00:09,0,100
2016-01-25-ccc_tax_script,2016/01/25,ccc_tax_script,17,16,0:00:14,14,0:01:24,1,224
2016-01-25-ccc_waste_recycling_script,2016/01/25,ccc_waste_recycling_script,0,0,0:00:00,0,0:00:00,0,0
2016-01-26-ccc_311_calgary_script,2016/01/26,ccc_311_calgary_script,3021,2799,0:01:01,61,0:08:01,222,170739
2016-01-26-ccc_311_lobby_ph_script,2016/01/26,ccc_311_lobby_ph_script,2,2,0:00:05,5,0:00:05,0,10
2016-01-26-ccc_aserv_info_script,2016/01/26,ccc_aserv_info_script,0,0,0:00:00,0,0:00:00,0,0
2016-01-26-ccc_bylaw_script,2016/01/26,ccc_bylaw_script,0,0,0:00:00,0,0:00:00,0,0
2016-01-26-ccc_city_script,2016/01/26,ccc_city_script,12,12,0:00:23,23,0:02:36,0,276
2016-01-26-ccc_cty_online_script,2016/01/26,ccc_cty_online_script,0,0,0:00:00,0,0:00:00,0,0
2016-01-26-ccc_feedback_script,2016/01/26,ccc_feedback_script,0,0,0:00:00,0,0:00:00,0,0
2016-01-26-ccc_fpb_script,2016/01/26,ccc_fpb_script,0,0,0:00:00,0,0:00:00,0,0
2016-01-26-ccc_help_script,2016/01/26,ccc_help_script,12,11,0:00:21,21,0:01:04,1,231
2016-01-26-ccc_link_script,2016/01/26,ccc_link_script,0,0,0:00:00,0,0:00:00,0,0
2016-01-26-ccc_media_line_script,2016/01/26,ccc_media_line_script,1,1,0:00:07,7,0:00:07,0,7
2016-01-26-ccc_priority_script,2016/01/26,ccc_priority_script,42,41,0:00:13,13,0:01:18,1,533
2016-01-26-ccc_tax_script,2016/01/26,ccc_tax_script,14,14,0:01:30,90,0:04:31,0,1260
2016-01-26-ccc_waste_recycling_script,2016/01/26,ccc_waste_recycling_script,0,0,0:00:00,0,0:00:00,0,0
2016-01-27-ccc_311_calgary_script,2016/01/27,ccc_311_calgary_script,3046,2923,0:00:26,26,0:05:52,123,75998
2016-01-27-ccc_311_lobby_ph_script,2016/01/27,ccc_311_lobby_ph_script,1,1,0:00:04,4,0:00:04,0,4
2016-01-27-ccc_aserv_info_script,2016/01/27,ccc_aserv_info_script,0,0,0:00:00,0,0:00:00,0,0
2016-01-27-ccc_bylaw_script,2016/01/27,ccc_bylaw_script,0,0,0:00:00,0,0:00:00,0,0
2016-01-27-ccc_city_script,2016/01/27,ccc_city_script,15,15,0:00:04,4,0:00:11,0,60
2016-01-27-ccc_cty_online_script,2016/01/27,ccc_cty_online_script,0,0,0:00:00,0,0:00:00,0,0
2016-01-27-ccc_feedback_script,2016/01/27,ccc_feedback_script,0,0,0:00:00,0,0:00:00,0,0
2016-01-27-ccc_fpb_script,2016/01/27,ccc_fpb_script,1,1,0:00:05,5,0:00:05,0,5
2016-01-27-ccc_help_script,2016/01/27,ccc_help_script,11,11,0:00:17,17,0:00:50,0,187
2016-01-27-ccc_link_script,2016/01/27,ccc_link_script,0,0,0:00:00,0,0:00:00,0,0
2016-01-27-ccc_media_line_script,2016/01/27,ccc_media_line_script,1,1,0:00:08,8,0:00:08,0,8
2016-01-27-ccc_priority_script,2016/01/27,ccc_priority_script,31,30,0:00:16,16,0:01:48,1,480
2016-01-27-ccc_tax_script,2016/01/27,ccc_tax_script,17,17,0:00:09,9,0:01:05,0,153
2016-01-27-ccc_waste_recycling_script,2016/01/27,ccc_waste_recycling_script,0,0,0:00:00,0,0:00:00,0,0
2016-01-28-ccc_311_calgary_script,2016/01/28,ccc_311_calgary_script,2969,2811,0:00:41,41,0:09:18,158,115251
2016-01-28-ccc_311_lobby_ph_script,2016/01/28,ccc_311_lobby_ph_script,5,4,0:00:06,6,0:00:13,1,24
2016-01-28-ccc_aserv_info_script,2016/01/28,ccc_aserv_info_script,0,0,0:00:00,0,0:00:00,0,0
2016-01-28-ccc_bylaw_script,2016/01/28,ccc_bylaw_script,0,0,0:00:00,0,0:00:00,0,0
2016-01-28-ccc_city_script,2016/01/28,ccc_city_script,14,14,0:00:26,26,0:03:58,0,364
2016-01-28-ccc_cty_online_script,2016/01/28,ccc_cty_online_script,0,0,0:00:00,0,0:00:00,0,0
2016-01-28-ccc_feedback_script,2016/01/28,ccc_feedback_script,0,0,0:00:00,0,0:00:00,0,0
2016-01-28-ccc_fpb_script,2016/01/28,ccc_fpb_script,0,0,0:00:00,0,0:00:00,0,0
2016-01-28-ccc_help_script,2016/01/28,ccc_help_script,10,10,0:00:14,14,0:01:15,0,140
2016-01-28-ccc_link_script,2016/01/28,ccc_link_script,0,0,0:00:00,0,0:00:00,0,0
2016-01-28-ccc_media_line_script,2016/01/28,ccc_media_line_script,0,0,0:00:00,0,0:00:00,0,0
2016-01-28-ccc_priority_script,2016/01/28,ccc_priority_script,34,34,0:00:23,23,0:03:18,0,782
2016-01-28-ccc_tax_script,2016/01/28,ccc_tax_script,23,21,0:00:36,36,0:02:10,2,756
2016-01-28-ccc_waste_recycling_script,2016/01/28,ccc_waste_recycling_script,0,0,0:00:00,0,0:00:00,0,0
2016-01-29-ccc_311_calgary_script,2016/01/29,ccc_311_calgary_script,2714,2584,0:00:35,35,0:09:17,130,90440
2016-01-29-ccc_311_lobby_ph_script,2016/01/29,ccc_311_lobby_ph_script,4,4,0:00:10,10,0:00:18,0,40
2016-01-29-ccc_aserv_info_script,2016/01/29,ccc_aserv_info_script,0,0,0:00:00,0,0:00:00,0,0
2016-01-29-ccc_bylaw_script,2016/01/29,ccc_bylaw_script,0,0,0:00:00,0,0:00:00,0,0
2016-01-29-ccc_city_script,2016/01/29,ccc_city_script,20,20,0:00:08,8,0:00:25,0,160
2016-01-29-ccc_cty_online_script,2016/01/29,ccc_cty_online_script,0,0,0:00:00,0,0:00:00,0,0
2016-01-29-ccc_feedback_script,2016/01/29,ccc_feedback_script,0,0,0:00:00,0,0:00:00,0,0
2016-01-29-ccc_fpb_script,2016/01/29,ccc_fpb_script,0,0,0:00:00,0,0:00:00,0,0
2016-01-29-ccc_help_script,2016/01/29,ccc_help_script,6,6,0:00:08,8,0:00:15,0,48
2016-01-29-ccc_link_script,2016/01/29,ccc_link_script,0,0,0:00:00,0,0:00:00,0,0
2016-01-29-ccc_media_line_script,2016/01/29,ccc_media_line_script,0,0,0:00:00,0,0:00:00,0,0
2016-01-29-ccc_priority_script,2016/01/29,ccc_priority_script,19,19,0:00:19,19,0:02:28,0,361
2016-01-29-ccc_tax_script,2016/01/29,ccc_tax_script,20,19,0:00:23,23,0:02:24,1,437
2016-01-29-ccc_waste_recycling_script,2016/01/29,ccc_waste_recycling_script,0,0,0:00:00,0,0:00:00,0,0
2016-01-30-ccc_311_calgary_script,2016/01/30,ccc_311_calgary_script,1124,1113,0:00:10,10,0:04:10,11,11130
2016-01-30-ccc_311_lobby_ph_script,2016/01/30,ccc_311_lobby_ph_script,0,0,0:00:00,0,0:00:00,0,0
2016-01-30-ccc_aserv_info_script,2016/01/30,ccc_aserv_info_script,0,0,0:00:00,0,0:00:00,0,0
2016-01-30-ccc_bylaw_script,2016/01/30,ccc_bylaw_script,0,0,0:00:00,0,0:00:00,0,0
2016-01-30-ccc_city_script,2016/01/30,ccc_city_script,0,0,0:00:00,0,0:00:00,0,0
2016-01-30-ccc_cty_online_script,2016/01/30,ccc_cty_online_script,0,0,0:00:00,0,0:00:00,0,0
2016-01-30-ccc_feedback_script,2016/01/30,ccc_feedback_script,0,0,0:00:00,0,0:00:00,0,0
2016-01-30-ccc_fpb_script,2016/01/30,ccc_fpb_script,0,0,0:00:00,0,0:00:00,0,0
2016-01-30-ccc_help_script,2016/01/30,ccc_help_script,7,7,0:00:08,8,0:00:17,0,56
2016-01-30-ccc_link_script,2016/01/30,ccc_link_script,0,0,0:00:00,0,0:00:00,0,0
2016-01-30-ccc_media_line_script,2016/01/30,ccc_media_line_script,0,0,0:00:00,0,0:00:00,0,0
2016-01-30-ccc_priority_script,2016/01/30,ccc_priority_script,17,17,0:00:11,11,0:01:42,0,187
2016-01-30-ccc_tax_script,2016/01/30,ccc_tax_script,2,2,0:00:07,7,0:00:11,0,14
2016-01-30-ccc_waste_recycling_script,2016/01/30,ccc_waste_recycling_script,0,0,0:00:00,0,0:00:00,0,0
2016-01-31-ccc_311_calgary_script,2016/01/31,ccc_311_calgary_script,892,869,0:00:16,16,0:05:13,23,13904
2016-01-31-ccc_311_lobby_ph_script,2016/01/31,ccc_311_lobby_ph_script,1,1,0:00:05,5,0:00:05,0,5
2016-01-31-ccc_aserv_info_script,2016/01/31,ccc_aserv_info_script,0,0,0:00:00,0,0:00:00,0,0
2016-01-31-ccc_bylaw_script,2016/01/31,ccc_bylaw_script,0,0,0:00:00,0,0:00:00,0,0
2016-01-31-ccc_city_script,2016/01/31,ccc_city_script,0,0,0:00:00,0,0:00:00,0,0
2016-01-31-ccc_cty_online_script,2016/01/31,ccc_cty_online_script,0,0,0:00:00,0,0:00:00,0,0
2016-01-31-ccc_feedback_script,2016/01/31,ccc_feedback_script,0,0,0:00:00,0,0:00:00,0,0
2016-01-31-ccc_fpb_script,2016/01/31,ccc_fpb_script,0,0,0:00:00,0,0:00:00,0,0
2016-01-31-ccc_help_script,2016/01/31,ccc_help_script,4,4,0:00:14,14,0:00:28,0,56
2016-01-31-ccc_link_script,2016/01/31,ccc_link_script,0,0,0:00:00,0,0:00:00,0,0
2016-01-31-ccc_media_line_script,2016/01/31,ccc_media_line_script,1,1,0:00:02,2,0:00:02,0,2
2016-01-31-ccc_priority_script,2016/01/31,ccc_priority_script,21,20,0:00:06,6,0:00:14,1,120
2016-01-31-ccc_tax_script,2016/01/31,ccc_tax_script,0,0,0:00:00,0,0:00:00,0,0
2016-01-31-ccc_waste_recycling_script,2016/01/31,ccc_waste_recycling_script,0,0,0:00:00,0,0:00:00,0,0
2016-02-01-ccc_311_calgary_script,2016/02/01,ccc_311_calgary_script,3046,2965,0:00:19,19,0:03:12,81,56335
2016-02-01-ccc_311_lobby_ph_script,2016/02/01,ccc_311_lobby_ph_script,7,7,0:00:11,11,0:00:26,0,77
2016-02-01-ccc_aserv_info_script,2016/02/01,ccc_aserv_info_script,0,0,0:00:00,0,0:00:00,0,0
2016-02-01-ccc_bylaw_script,2016/02/01,ccc_bylaw_script,0,0,0:00:00,0,0:00:00,0,0
2016-02-01-ccc_city_script,2016/02/01,ccc_city_script,20,20,0:00:11,11,0:01:41,0,220
2016-02-01-ccc_cty_online_script,2016/02/01,ccc_cty_online_script,0,0,0:00:00,0,0:00:00,0,0
2016-02-01-ccc_feedback_script,2016/02/01,ccc_feedback_script,0,0,0:00:00,0,0:00:00,0,0
2016-02-01-ccc_fpb_script,2016/02/01,ccc_fpb_script,0,0,0:00:00,0,0:00:00,0,0
2016-02-01-ccc_help_script,2016/02/01,ccc_help_script,20,19,0:00:11,11,0:00:49,1,209
2016-02-01-ccc_link_script,2016/02/01,ccc_link_script,0,0,0:00:00,0,0:00:00,0,0
2016-02-01-ccc_media_line_script,2016/02/01,ccc_media_line_script,1,1,0:00:02,2,0:00:02,0,2
2016-02-01-ccc_priority_script,2016/02/01,ccc_priority_script,22,20,0:00:08,8,0:00:18,2,160
2016-02-01-ccc_tax_script,2016/02/01,ccc_tax_script,23,23,0:00:19,19,0:03:07,0,437
2016-02-01-ccc_waste_recycling_script,2016/02/01,ccc_waste_recycling_script,0,0,0:00:00,0,0:00:00,0,0
2016-02-02-ccc_311_calgary_script,2016/02/02,ccc_311_calgary_script,3062,2892,0:00:37,37,0:06:43,170,107004
2016-02-02-ccc_311_lobby_ph_script,2016/02/02,ccc_311_lobby_ph_script,3,2,0:00:08,8,0:00:08,1,16
2016-02-02-ccc_aserv_info_script,2016/02/02,ccc_aserv_info_script,0,0,0:00:00,0,0:00:00,0,0
2016-02-02-ccc_bylaw_script,2016/02/02,ccc_bylaw_script,0,0,0:00:00,0,0:00:00,0,0
2016-02-02-ccc_city_script,2016/02/02,ccc_city_script,14,14,0:00:29,29,0:05:02,0,406
2016-02-02-ccc_cty_online_script,2016/02/02,ccc_cty_online_script,0,0,0:00:00,0,0:00:00,0,0
2016-02-02-ccc_feedback_script,2016/02/02,ccc_feedback_script,0,0,0:00:00,0,0:00:00,0,0
2016-02-02-ccc_fpb_script,2016/02/02,ccc_fpb_script,1,1,0:00:07,7,0:00:07,0,7
2016-02-02-ccc_help_script,2016/02/02,ccc_help_script,9,9,0:00:20,20,0:01:00,0,180
2016-02-02-ccc_link_script,2016/02/02,ccc_link_script,0,0,0:00:00,0,0:00:00,0,0
2016-02-02-ccc_media_line_script,2016/02/02,ccc_media_line_script,0,0,0:00:00,0,0:00:00,0,0
2016-02-02-ccc_priority_script,2016/02/02,ccc_priority_script,27,26,0:00:08,8,0:00:27,1,208
2016-02-02-ccc_tax_script,2016/02/02,ccc_tax_script,9,9,0:00:25,25,0:01:04,0,225
2016-02-02-ccc_waste_recycling_script,2016/02/02,ccc_waste_recycling_script,0,0,0:00:00,0,0:00:00,0,0
2016-02-03-ccc_311_calgary_script,2016/02/03,ccc_311_calgary_script,2780,2700,0:00:17,17,0:06:36,80,45900
2016-02-03-ccc_311_lobby_ph_script,2016/02/03,ccc_311_lobby_ph_script,4,4,0:00:04,4,0:00:06,0,16
2016-02-03-ccc_aserv_info_script,2016/02/03,ccc_aserv_info_script,0,0,0:00:00,0,0:00:00,0,0
2016-02-03-ccc_bylaw_script,2016/02/03,ccc_bylaw_script,0,0,0:00:00,0,0:00:00,0,0
2016-02-03-ccc_city_script,2016/02/03,ccc_city_script,14,14,0:00:12,12,0:01:27,0,168
2016-02-03-ccc_cty_online_script,2016/02/03,ccc_cty_online_script,0,0,0:00:00,0,0:00:00,0,0
2016-02-03-ccc_feedback_script,2016/02/03,ccc_feedback_script,0,0,0:00:00,0,0:00:00,0,0
2016-02-03-ccc_fpb_script,2016/02/03,ccc_fpb_script,0,0,0:00:00,0,0:00:00,0,0
2016-02-03-ccc_help_script,2016/02/03,ccc_help_script,12,12,0:00:12,12,0:00:39,0,144
2016-02-03-ccc_link_script,2016/02/03,ccc_link_script,0,0,0:00:00,0,0:00:00,0,0
2016-02-03-ccc_media_line_script,2016/02/03,ccc_media_line_script,1,1,0:00:06,6,0:00:06,0,6
2016-02-03-ccc_priority_script,2016/02/03,ccc_priority_script,25,25,0:00:12,12,0:00:47,0,300
2016-02-03-ccc_tax_script,2016/02/03,ccc_tax_script,19,18,0:00:06,6,0:00:21,1,108
2016-02-03-ccc_waste_recycling_script,2016/02/03,ccc_waste_recycling_script,0,0,0:00:00,0,0:00:00,0,0
2016-02-04-ccc_311_calgary_script,2016/02/04,ccc_311_calgary_script,2701,2670,0:00:15,15,0:03:39,31,40050
2016-02-04-ccc_311_lobby_ph_script,2016/02/04,ccc_311_lobby_ph_script,2,1,0:00:02,2,0:00:02,1,2
2016-02-04-ccc_aserv_info_script,2016/02/04,ccc_aserv_info_script,0,0,0:00:00,0,0:00:00,0,0
2016-02-04-ccc_bylaw_script,2016/02/04,ccc_bylaw_script,0,0,0:00:00,0,0:00:00,0,0
2016-02-04-ccc_city_script,2016/02/04,ccc_city_script,12,12,0:00:09,9,0:00:28,0,108
2016-02-04-ccc_cty_online_script,2016/02/04,ccc_cty_online_script,0,0,0:00:00,0,0:00:00,0,0
2016-02-04-ccc_feedback_script,2016/02/04,ccc_feedback_script,0,0,0:00:00,0,0:00:00,0,0
2016-02-04-ccc_fpb_script,2016/02/04,ccc_fpb_script,0,0,0:00:00,0,0:00:00,0,0
2016-02-04-ccc_help_script,2016/02/04,ccc_help_script,18,17,0:00:06,6,0:00:10,1,102
2016-02-04-ccc_link_script,2016/02/04,ccc_link_script,0,0,0:00:00,0,0:00:00,0,0
2016-02-04-ccc_media_line_script,2016/02/04,ccc_media_line_script,0,0,0:00:00,0,0:00:00,0,0
2016-02-04-ccc_priority_script,2016/02/04,ccc_priority_script,31,28,0:00:08,8,0:00:24,3,224
2016-02-04-ccc_tax_script,2016/02/04,ccc_tax_script,23,23,0:00:16,16,0:01:50,0,368
2016-02-04-ccc_waste_recycling_script,2016/02/04,ccc_waste_recycling_script,0,0,0:00:00,0,0:00:00,0,0
2016-02-05-ccc_311_calgary_script,2016/02/05,ccc_311_calgary_script,2523,2457,0:00:28,28,0:06:20,66,68796
2016-02-05-ccc_311_lobby_ph_script,2016/02/05,ccc_311_lobby_ph_script,5,5,0:00:10,10,0:00:23,0,50
2016-02-05-ccc_aserv_info_script,2016/02/05,ccc_aserv_info_script,0,0,0:00:00,0,0:00:00,0,0
2016-02-05-ccc_bylaw_script,2016/02/05,ccc_bylaw_script,0,0,0:00:00,0,0:00:00,0,0
2016-02-05-ccc_city_script,2016/02/05,ccc_city_script,6,6,0:00:06,6,0:00:09,0,36
2016-02-05-ccc_cty_online_script,2016/02/05,ccc_cty_online_script,0,0,0:00:00,0,0:00:00,0,0
2016-02-05-ccc_feedback_script,2016/02/05,ccc_feedback_script,0,0,0:00:00,0,0:00:00,0,0
2016-02-05-ccc_fpb_script,2016/02/05,ccc_fpb_script,0,0,0:00:00,0,0:00:00,0,0
2016-02-05-ccc_help_script,2016/02/05,ccc_help_script,5,5,0:00:22,22,0:01:05,0,110
2016-02-05-ccc_link_script,2016/02/05,ccc_link_script,1,0,0:00:00,0,0:00:00,0,0
2016-02-05-ccc_media_line_script,2016/02/05,ccc_media_line_script,0,0,0:00:00,0,0:00:00,0,0
2016-02-05-ccc_priority_script,2016/02/05,ccc_priority_script,19,19,0:00:09,9,0:00:31,0,171
2016-02-05-ccc_tax_script,2016/02/05,ccc_tax_script,19,18,0:01:09,69,0:05:25,1,1242
2016-02-05-ccc_waste_recycling_script,2016/02/05,ccc_waste_recycling_script,0,0,0:00:00,0,0:00:00,0,0
2016-02-06-ccc_311_calgary_script,2016/02/06,ccc_311_calgary_script,1052,1036,0:00:07,7,0:03:41,16,7252
2016-02-06-ccc_311_lobby_ph_script,2016/02/06,ccc_311_lobby_ph_script,0,0,0:00:00,0,0:00:00,0,0
2016-02-06-ccc_aserv_info_script,2016/02/06,ccc_aserv_info_script,0,0,0:00:00,0,0:00:00,0,0
2016-02-06-ccc_bylaw_script,2016/02/06,ccc_bylaw_script,0,0,0:00:00,0,0:00:00,0,0
2016-02-06-ccc_city_script,2016/02/06,ccc_city_script,0,0,0:00:00,0,0:00:00,0,0
2016-02-06-ccc_cty_online_script,2016/02/06,ccc_cty_online_script,0,0,0:00:00,0,0:00:00,0,0
2016-02-06-ccc_feedback_script,2016/02/06,ccc_feedback_script,0,0,0:00:00,0,0:00:00,0,0
2016-02-06-ccc_fpb_script,2016/02/06,ccc_fpb_script,0,0,0:00:00,0,0:00:00,0,0
2016-02-06-ccc_help_script,2016/02/06,ccc_help_script,2,2,0:00:09,9,0:00:09,0,18
2016-02-06-ccc_link_script,2016/02/06,ccc_link_script,0,0,0:00:00,0,0:00:00,0,0
2016-02-06-ccc_media_line_script,2016/02/06,ccc_media_line_script,3,3,0:00:06,6,0:00:08,0,18
2016-02-06-ccc_priority_script,2016/02/06,ccc_priority_script,24,24,0:00:12,12,0:02:19,0,288
2016-02-06-ccc_tax_script,2016/02/06,ccc_tax_script,3,2,0:00:04,4,0:00:04,1,8
2016-02-06-ccc_waste_recycling_script,2016/02/06,ccc_waste_recycling_script,0,0,0:00:00,0,0:00:00,0,0
2016-02-07-ccc_311_calgary_script,2016/02/07,ccc_311_calgary_script,788,773,0:00:08,8,0:07:12,15,6184
2016-02-07-ccc_311_lobby_ph_script,2016/02/07,ccc_311_lobby_ph_script,0,0,0:00:00,0,0:00:00,0,0
2016-02-07-ccc_aserv_info_script,2016/02/07,ccc_aserv_info_script,0,0,0:00:00,0,0:00:00,0,0
2016-02-07-ccc_bylaw_script,2016/02/07,ccc_bylaw_script,0,0,0:00:00,0,0:00:00,0,0
2016-02-07-ccc_city_script,2016/02/07,ccc_city_script,0,0,0:00:00,0,0:00:00,0,0
2016-02-07-ccc_cty_online_script,2016/02/07,ccc_cty_online_script,0,0,0:00:00,0,0:00:00,0,0
2016-02-07-ccc_feedback_script,2016/02/07,ccc_feedback_script,0,0,0:00:00,0,0:00:00,0,0
2016-02-07-ccc_fpb_script,2016/02/07,ccc_fpb_script,0,0,0:00:00,0,0:00:00,0,0
2016-02-07-ccc_help_script,2016/02/07,ccc_help_script,2,2,0:00:24,24,0:00:24,0,48
2016-02-07-ccc_link_script,2016/02/07,ccc_link_script,0,0,0:00:00,0,0:00:00,0,0
2016-02-07-ccc_media_line_script,2016/02/07,ccc_media_line_script,1,1,0:00:06,6,0:00:06,0,6
2016-02-07-ccc_priority_script,2016/02/07,ccc_priority_script,17,17,0:00:05,5,0:00:11,0,85
2016-02-07-ccc_tax_script,2016/02/07,ccc_tax_script,0,0,0:00:00,0,0:00:00,0,0
2016-02-07-ccc_waste_recycling_script,2016/02/07,ccc_waste_recycling_script,0,0,0:00:00,0,0:00:00,0,0
2016-02-08-ccc_311_calgary_script,2016/02/08,ccc_311_calgary_script,3215,3155,0:00:20,20,0:05:07,60,63100
2016-02-08-ccc_311_lobby_ph_script,2016/02/08,ccc_311_lobby_ph_script,1,1,0:00:14,14,0:00:14,0,14
2016-02-08-ccc_aserv_info_script,2016/02/08,ccc_aserv_info_script,0,0,0:00:00,0,0:00:00,0,0
2016-02-08-ccc_bylaw_script,2016/02/08,ccc_bylaw_script,0,0,0:00:00,0,0:00:00,0,0
2016-02-08-ccc_city_script,2016/02/08,ccc_city_script,16,16,0:00:13,13,0:01:47,0,208
2016-02-08-ccc_cty_online_script,2016/02/08,ccc_cty_online_script,0,0,0:00:00,0,0:00:00,0,0
2016-02-08-ccc_feedback_script,2016/02/08,ccc_feedback_script,0,0,0:00:00,0,0:00:00,0,0
2016-02-08-ccc_fpb_script,2016/02/08,ccc_fpb_script,0,0,0:00:00,0,0:00:00,0,0
2016-02-08-ccc_help_script,2016/02/08,ccc_help_script,16,16,0:00:17,17,0:01:12,0,272
2016-02-08-ccc_link_script,2016/02/08,ccc_link_script,0,0,0:00:00,0,0:00:00,0,0
2016-02-08-ccc_media_line_script,2016/02/08,ccc_media_line_script,1,1,0:00:19,19,0:00:19,0,19
2016-02-08-ccc_priority_script,2016/02/08,ccc_priority_script,19,19,0:00:11,11,0:01:03,0,209
2016-02-08-ccc_tax_script,2016/02/08,ccc_tax_script,11,10,0:00:35,35,0:04:10,1,350
2016-02-08-ccc_waste_recycling_script,2016/02/08,ccc_waste_recycling_script,0,0,0:00:00,0,0:00:00,0,0
2016-02-09-ccc_311_calgary_script,2016/02/09,ccc_311_calgary_script,3260,3064,0:00:52,52,0:04:47,196,159328
2016-02-09-ccc_311_lobby_ph_script,2016/02/09,ccc_311_lobby_ph_script,2,2,0:00:13,13,0:00:20,0,26
2016-02-09-ccc_aserv_info_script,2016/02/09,ccc_aserv_info_script,0,0,0:00:00,0,0:00:00,0,0
2016-02-09-ccc_bylaw_script,2016/02/09,ccc_bylaw_script,0,0,0:00:00,0,0:00:00,0,0
2016-02-09-ccc_city_script,2016/02/09,ccc_city_script,21,21,0:00:18,18,0:02:00,0,378
2016-02-09-ccc_cty_online_script,2016/02/09,ccc_cty_online_script,0,0,0:00:00,0,0:00:00,0,0
2016-02-09-ccc_feedback_script,2016/02/09,ccc_feedback_script,0,0,0:00:00,0,0:00:00,0,0
2016-02-09-ccc_fpb_script,2016/02/09,ccc_fpb_script,0,0,0:00:00,0,0:00:00,0,0
2016-02-09-ccc_help_script,2016/02/09,ccc_help_script,8,7,0:00:17,17,0:00:43,1,119
2016-02-09-ccc_link_script,2016/02/09,ccc_link_script,0,0,0:00:00,0,0:00:00,0,0
2016-02-09-ccc_media_line_script,2016/02/09,ccc_media_line_script,1,1,0:00:02,2,0:00:02,0,2
2016-02-09-ccc_priority_script,2016/02/09,ccc_priority_script,34,33,0:00:07,7,0:00:25,1,231
2016-02-09-ccc_tax_script,2016/02/09,ccc_tax_script,16,16,0:01:06,66,0:03:00,0,1056
2016-02-09-ccc_waste_recycling_script,2016/02/09,ccc_waste_recycling_script,0,0,0:00:00,0,0:00:00,0,0
2016-02-10-ccc_311_calgary_script,2016/02/10,ccc_311_calgary_script,2884,2817,0:00:15,15,0:04:13,67,42255
2016-02-10-ccc_311_lobby_ph_script,2016/02/10,ccc_311_lobby_ph_script,3,3,0:00:06,6,0:00:08,0,18
2016-02-10-ccc_aserv_info_script,2016/02/10,ccc_aserv_info_script,0,0,0:00:00,0,0:00:00,0,0
2016-02-10-ccc_bylaw_script,2016/02/10,ccc_bylaw_script,0,0,0:00:00,0,0:00:00,0,0
2016-02-10-ccc_city_script,2016/02/10,ccc_city_script,18,17,0:00:09,9,0:00:22,1,153
2016-02-10-ccc_cty_online_script,2016/02/10,ccc_cty_online_script,0,0,0:00:00,0,0:00:00,0,0
2016-02-10-ccc_feedback_script,2016/02/10,ccc_feedback_script,1,0,0:00:00,0,0:00:00,0,0
2016-02-10-ccc_fpb_script,2016/02/10,ccc_fpb_script,2,2,0:00:06,6,0:00:06,0,12
2016-02-10-ccc_help_script,2016/02/10,ccc_help_script,22,21,0:00:14,14,0:00:43,1,294
2016-02-10-ccc_link_script,2016/02/10,ccc_link_script,0,0,0:00:00,0,0:00:00,0,0
2016-02-10-ccc_media_line_script,2016/02/10,ccc_media_line_script,0,0,0:00:00,0,0:00:00,0,0
2016-02-10-ccc_priority_script,2016/02/10,ccc_priority_script,19,17,0:00:08,8,0:00:24,2,136
2016-02-10-ccc_tax_script,2016/02/10,ccc_tax_script,16,16,0:00:21,21,0:02:01,0,336
2016-02-10-ccc_waste_recycling_script,2016/02/10,ccc_waste_recycling_script,0,0,0:00:00,0,0:00:00,0,0
2016-02-11-ccc_311_calgary_script,2016/02/11,ccc_311_calgary_script,2811,2753,0:00:15,15,0:11:17,58,41295
2016-02-11-ccc_311_lobby_ph_script,2016/02/11,ccc_311_lobby_ph_script,2,2,0:00:04,4,0:00:05,0,8
2016-02-11-ccc_aserv_info_script,2016/02/11,ccc_aserv_info_script,0,0,0:00:00,0,0:00:00,0,0
2016-02-11-ccc_bylaw_script,2016/02/11,ccc_bylaw_script,0,0,0:00:00,0,0:00:00,0,0
2016-02-11-ccc_city_script,2016/02/11,ccc_city_script,16,16,0:00:12,12,0:01:14,0,192
2016-02-11-ccc_cty_online_script,2016/02/11,ccc_cty_online_script,0,0,0:00:00,0,0:00:00,0,0
2016-02-11-ccc_feedback_script,2016/02/11,ccc_feedback_script,0,0,0:00:00,0,0:00:00,0,0
2016-02-11-ccc_fpb_script,2016/02/11,ccc_fpb_script,1,1,0:00:06,6,0:00:06,0,6
2016-02-11-ccc_help_script,2016/02/11,ccc_help_script,26,26,0:00:06,6,0:00:23,0,156
2016-02-11-ccc_link_script,2016/02/11,ccc_link_script,0,0,0:00:00,0,0:00:00,0,0
2016-02-11-ccc_media_line_script,2016/02/11,ccc_media_line_script,0,0,0:00:00,0,0:00:00,0,0
2016-02-11-ccc_priority_script,2016/02/11,ccc_priority_script,32,31,0:00:13,13,0:01:08,1,403
2016-02-11-ccc_tax_script,2016/02/11,ccc_tax_script,21,21,0:00:17,17,0:01:38,0,357
2016-02-11-ccc_waste_recycling_script,2016/02/11,ccc_waste_recycling_script,0,0,0:00:00,0,0:00:00,0,0
2016-02-12-ccc_311_calgary_script,2016/02/12,ccc_311_calgary_script,2490,2454,0:00:14,14,0:03:49,36,34356
2016-02-12-ccc_311_lobby_ph_script,2016/02/12,ccc_311_lobby_ph_script,5,5,0:00:10,10,0:00:29,0,50
2016-02-12-ccc_aserv_info_script,2016/02/12,ccc_aserv_info_script,0,0,0:00:00,0,0:00:00,0,0
2016-02-12-ccc_bylaw_script,2016/02/12,ccc_bylaw_script,0,0,0:00:00,0,0:00:00,0,0
2016-02-12-ccc_city_script,2016/02/12,ccc_city_script,14,14,0:00:10,10,0:00:29,0,140
2016-02-12-ccc_cty_online_script,2016/02/12,ccc_cty_online_script,0,0,0:00:00,0,0:00:00,0,0
2016-02-12-ccc_feedback_script,2016/02/12,ccc_feedback_script,0,0,0:00:00,0,0:00:00,0,0
2016-02-12-ccc_fpb_script,2016/02/12,ccc_fpb_script,0,0,0:00:00,0,0:00:00,0,0
2016-02-12-ccc_help_script,2016/02/12,ccc_help_script,15,15,0:00:05,5,0:00:12,0,75
2016-02-12-ccc_link_script,2016/02/12,ccc_link_script,0,0,0:00:00,0,0:00:00,0,0
2016-02-12-ccc_media_line_script,2016/02/12,ccc_media_line_script,3,3,0:00:09,9,0:00:18,0,27
2016-02-12-ccc_priority_script,2016/02/12,ccc_priority_script,17,13,0:00:09,9,0:00:43,4,117
2016-02-12-ccc_tax_script,2016/02/12,ccc_tax_script,9,9,0:00:26,26,0:01:17,0,234
2016-02-12-ccc_waste_recycling_script,2016/02/12,ccc_waste_recycling_script,0,0,0:00:00,0,0:00:00,0,0
2016-02-13-ccc_311_calgary_script,2016/02/13,ccc_311_calgary_script,989,972,0:00:10,10,0:07:01,17,9720
2016-02-13-ccc_311_lobby_ph_script,2016/02/13,ccc_311_lobby_ph_script,0,0,0:00:00,0,0:00:00,0,0
2016-02-13-ccc_aserv_info_script,2016/02/13,ccc_aserv_info_script,0,0,0:00:00,0,0:00:00,0,0
2016-02-13-ccc_bylaw_script,2016/02/13,ccc_bylaw_script,0,0,0:00:00,0,0:00:00,0,0
2016-02-13-ccc_city_script,2016/02/13,ccc_city_script,0,0,0:00:00,0,0:00:00,0,0
2016-02-13-ccc_cty_online_script,2016/02/13,ccc_cty_online_script,0,0,0:00:00,0,0:00:00,0,0
2016-02-13-ccc_feedback_script,2016/02/13,ccc_feedback_script,0,0,0:00:00,0,0:00:00,0,0
2016-02-13-ccc_fpb_script,2016/02/13,ccc_fpb_script,0,0,0:00:00,0,0:00:00,0,0
2016-02-13-ccc_help_script,2016/02/13,ccc_help_script,4,4,0:00:04,4,0:00:09,0,16
2016-02-13-ccc_link_script,2016/02/13,ccc_link_script,0,0,0:00:00,0,0:00:00,0,0
2016-02-13-ccc_media_line_script,2016/02/13,ccc_media_line_script,0,0,0:00:00,0,0:00:00,0,0
2016-02-13-ccc_priority_script,2016/02/13,ccc_priority_script,19,19,0:00:04,4,0:00:10,0,76
2016-02-13-ccc_tax_script,2016/02/13,ccc_tax_script,1,1,0:00:11,11,0:00:11,0,11
2016-02-13-ccc_waste_recycling_script,2016/02/13,ccc_waste_recycling_script,0,0,0:00:00,0,0:00:00,0,0
2016-02-14-ccc_311_calgary_script,2016/02/14,ccc_311_calgary_script,849,838,0:00:12,12,0:05:48,11,10056
2016-02-14-ccc_311_lobby_ph_script,2016/02/14,ccc_311_lobby_ph_script,0,0,0:00:00,0,0:00:00,0,0
2016-02-14-ccc_aserv_info_script,2016/02/14,ccc_aserv_info_script,0,0,0:00:00,0,0:00:00,0,0
2016-02-14-ccc_bylaw_script,2016/02/14,ccc_bylaw_script,0,0,0:00:00,0,0:00:00,0,0
2016-02-14-ccc_city_script,2016/02/14,ccc_city_script,0,0,0:00:00,0,0:00:00,0,0
2016-02-14-ccc_cty_online_script,2016/02/14,ccc_cty_online_script,0,0,0:00:00,0,0:00:00,0,0
2016-02-14-ccc_feedback_script,2016/02/14,ccc_feedback_script,0,0,0:00:00,0,0:00:00,0,0
2016-02-14-ccc_fpb_script,2016/02/14,ccc_fpb_script,1,1,0:00:02,2,0:00:02,0,2
2016-02-14-ccc_help_script,2016/02/14,ccc_help_script,0,0,0:00:00,0,0:00:00,0,0
2016-02-14-ccc_link_script,2016/02/14,ccc_link_script,0,0,0:00:00,0,0:00:00,0,0
2016-02-14-ccc_media_line_script,2016/02/14,ccc_media_line_script,0,0,0:00:00,0,0:00:00,0,0
2016-02-14-ccc_priority_script,2016/02/14,ccc_priority_script,20,19,0:00:10,10,0:01:33,1,190
2016-02-14-ccc_tax_script,2016/02/14,ccc_tax_script,0,0,0:00:00,0,0:00:00,0,0
2016-02-14-ccc_waste_recycling_script,2016/02/14,ccc_waste_recycling_script,0,0,0:00:00,0,0:00:00,0,0
2016-02-15-ccc_311_calgary_script,2016/02/15,ccc_311_calgary_script,1369,1350,0:00:09,9,0:06:56,19,12150
2016-02-15-ccc_311_lobby_ph_script,2016/02/15,ccc_311_lobby_ph_script,0,0,0:00:00,0,0:00:00,0,0
2016-02-15-ccc_aserv_info_script,2016/02/15,ccc_aserv_info_script,0,0,0:00:00,0,0:00:00,0,0
2016-02-15-ccc_bylaw_script,2016/02/15,ccc_bylaw_script,0,0,0:00:00,0,0:00:00,0,0
2016-02-15-ccc_city_script,2016/02/15,ccc_city_script,0,0,0:00:00,0,0:00:00,0,0
2016-02-15-ccc_cty_online_script,2016/02/15,ccc_cty_online_script,0,0,0:00:00,0,0:00:00,0,0
2016-02-15-ccc_feedback_script,2016/02/15,ccc_feedback_script,0,0,0:00:00,0,0:00:00,0,0
2016-02-15-ccc_fpb_script,2016/02/15,ccc_fpb_script,0,0,0:00:00,0,0:00:00,0,0
2016-02-15-ccc_help_script,2016/02/15,ccc_help_script,2,2,0:00:09,9,0:00:10,0,18
2016-02-15-ccc_link_script,2016/02/15,ccc_link_script,0,0,0:00:00,0,0:00:00,0,0
2016-02-15-ccc_media_line_script,2016/02/15,ccc_media_line_script,2,2,0:00:05,5,0:00:07,0,10
2016-02-15-ccc_priority_script,2016/02/15,ccc_priority_script,10,8,0:00:14,14,0:00:35,2,112
2016-02-15-ccc_tax_script,2016/02/15,ccc_tax_script,0,0,0:00:00,0,0:00:00,0,0
2016-02-15-ccc_waste_recycling_script,2016/02/15,ccc_waste_recycling_script,0,0,0:00:00,0,0:00:00,0,0
2016-02-16-ccc_311_calgary_script,2016/02/16,ccc_311_calgary_script,3320,3213,0:00:24,24,0:04:10,107,77112
2016-02-16-ccc_311_lobby_ph_script,2016/02/16,ccc_311_lobby_ph_script,5,3,0:00:15,15,0:00:19,2,45
2016-02-16-ccc_aserv_info_script,2016/02/16,ccc_aserv_info_script,0,0,0:00:00,0,0:00:00,0,0
2016-02-16-ccc_bylaw_script,2016/02/16,ccc_bylaw_script,0,0,0:00:00,0,0:00:00,0,0
2016-02-16-ccc_city_script,2016/02/16,ccc_city_script,18,18,0:00:11,11,0:01:18,0,198
2016-02-16-ccc_cty_online_script,2016/02/16,ccc_cty_online_script,0,0,0:00:00,0,0:00:00,0,0
2016-02-16-ccc_feedback_script,2016/02/16,ccc_feedback_script,0,0,0:00:00,0,0:00:00,0,0
2016-02-16-ccc_fpb_script,2016/02/16,ccc_fpb_script,0,0,0:00:00,0,0:00:00,0,0
2016-02-16-ccc_help_script,2016/02/16,ccc_help_script,5,4,0:00:11,11,0:00:16,1,44
2016-02-16-ccc_link_script,2016/02/16,ccc_link_script,0,0,0:00:00,0,0:00:00,0,0
2016-02-16-ccc_media_line_script,2016/02/16,ccc_media_line_script,1,1,0:00:10,10,0:00:10,0,10
2016-02-16-ccc_priority_script,2016/02/16,ccc_priority_script,26,26,0:00:09,9,0:00:45,0,234
2016-02-16-ccc_tax_script,2016/02/16,ccc_tax_script,8,8,0:00:16,16,0:01:23,0,128
2016-02-16-ccc_waste_recycling_script,2016/02/16,ccc_waste_recycling_script,0,0,0:00:00,0,0:00:00,0,0
2016-02-17-ccc_311_calgary_script,2016/02/17,ccc_311_calgary_script,2960,2804,0:00:39,39,0:06:07,156,109356
2016-02-17-ccc_311_lobby_ph_script,2016/02/17,ccc_311_lobby_ph_script,4,4,0:00:07,7,0:00:17,0,28
2016-02-17-ccc_aserv_info_script,2016/02/17,ccc_aserv_info_script,0,0,0:00:00,0,0:00:00,0,0
2016-02-17-ccc_bylaw_script,2016/02/17,ccc_bylaw_script,0,0,0:00:00,0,0:00:00,0,0
2016-02-17-ccc_city_script,2016/02/17,ccc_city_script,13,13,0:00:09,9,0:00:26,0,117
2016-02-17-ccc_cty_online_script,2016/02/17,ccc_cty_online_script,0,0,0:00:00,0,0:00:00,0,0
2016-02-17-ccc_feedback_script,2016/02/17,ccc_feedback_script,0,0,0:00:00,0,0:00:00,0,0
2016-02-17-ccc_fpb_script,2016/02/17,ccc_fpb_script,1,1,0:00:23,23,0:00:23,0,23
2016-02-17-ccc_help_script,2016/02/17,ccc_help_script,10,9,0:00:17,17,0:01:08,1,153
2016-02-17-ccc_link_script,2016/02/17,ccc_link_script,1,0,0:00:00,0,0:00:00,1,0
2016-02-17-ccc_media_line_script,2016/02/17,ccc_media_line_script,3,3,0:00:10,10,0:00:18,0,30
2016-02-17-ccc_priority_script,2016/02/17,ccc_priority_script,16,16,0:00:21,21,0:02:07,0,336
2016-02-17-ccc_tax_script,2016/02/17,ccc_tax_script,18,16,0:00:27,27,0:03:02,2,432
2016-02-17-ccc_waste_recycling_script,2016/02/17,ccc_waste_recycling_script,0,0,0:00:00,0,0:00:00,0,0
2016-02-18-ccc_311_calgary_script,2016/02/18,ccc_311_calgary_script,2723,2647,0:00:21,21,0:04:02,76,55587
2016-02-18-ccc_311_lobby_ph_script,2016/02/18,ccc_311_lobby_ph_script,7,7,0:00:05,5,0:00:13,0,35
2016-02-18-ccc_aserv_info_script,2016/02/18,ccc_aserv_info_script,0,0,0:00:00,0,0:00:00,0,0
2016-02-18-ccc_bylaw_script,2016/02/18,ccc_bylaw_script,0,0,0:00:00,0,0:00:00,0,0
2016-02-18-ccc_city_script,2016/02/18,ccc_city_script,21,21,0:00:08,8,0:00:42,0,168
2016-02-18-ccc_cty_online_script,2016/02/18,ccc_cty_online_script,0,0,0:00:00,0,0:00:00,0,0
2016-02-18-ccc_feedback_script,2016/02/18,ccc_feedback_script,0,0,0:00:00,0,0:00:00,0,0
2016-02-18-ccc_fpb_script,2016/02/18,ccc_fpb_script,0,0,0:00:00,0,0:00:00,0,0
2016-02-18-ccc_help_script,2016/02/18,ccc_help_script,12,12,0:00:19,19,0:00:41,0,228
2016-02-18-ccc_link_script,2016/02/18,ccc_link_script,0,0,0:00:00,0,0:00:00,0,0
2016-02-18-ccc_media_line_script,2016/02/18,ccc_media_line_script,3,3,0:00:11,11,0:00:20,0,33
2016-02-18-ccc_priority_script,2016/02/18,ccc_priority_script,33,33,0:00:08,8,0:00:54,0,264
2016-02-18-ccc_tax_script,2016/02/18,ccc_tax_script,12,11,0:00:45,45,0:03:20,1,495
2016-02-18-ccc_waste_recycling_script,2016/02/18,ccc_waste_recycling_script,0,0,0:00:00,0,0:00:00,0,0
2016-02-19-ccc_311_calgary_script,2016/02/19,ccc_311_calgary_script,2743,2599,0:00:46,46,0:05:14,144,119554
2016-02-19-ccc_311_lobby_ph_script,2016/02/19,ccc_311_lobby_ph_script,0,0,0:00:00,0,0:00:00,0,0
2016-02-19-ccc_aserv_info_script,2016/02/19,ccc_aserv_info_script,0,0,0:00:00,0,0:00:00,0,0
2016-02-19-ccc_bylaw_script,2016/02/19,ccc_bylaw_script,0,0,0:00:00,0,0:00:00,0,0
2016-02-19-ccc_city_script,2016/02/19,ccc_city_script,16,16,0:00:32,32,0:03:49,0,512
2016-02-19-ccc_cty_online_script,2016/02/19,ccc_cty_online_script,0,0,0:00:00,0,0:00:00,0,0
2016-02-19-ccc_feedback_script,2016/02/19,ccc_feedback_script,0,0,0:00:00,0,0:00:00,0,0
2016-02-19-ccc_fpb_script,2016/02/19,ccc_fpb_script,0,0,0:00:00,0,0:00:00,0,0
2016-02-19-ccc_help_script,2016/02/19,ccc_help_script,19,16,0:00:21,21,0:02:31,3,336
2016-02-19-ccc_link_script,2016/02/19,ccc_link_script,0,0,0:00:00,0,0:00:00,0,0
2016-02-19-ccc_media_line_script,2016/02/19,ccc_media_line_script,0,0,0:00:00,0,0:00:00,0,0
2016-02-19-ccc_priority_script,2016/02/19,ccc_priority_script,29,29,0:00:09,9,0:00:24,0,261
2016-02-19-ccc_tax_script,2016/02/19,ccc_tax_script,18,18,0:00:47,47,0:03:29,0,846
2016-02-19-ccc_waste_recycling_script,2016/02/19,ccc_waste_recycling_script,0,0,0:00:00,0,0:00:00,0,0
2016-02-20-ccc_311_calgary_script,2016/02/20,ccc_311_calgary_script,949,926,0:00:22,22,0:05:28,23,20372
2016-02-20-ccc_311_lobby_ph_script,2016/02/20,ccc_311_lobby_ph_script,0,0,0:00:00,0,0:00:00,0,0
2016-02-20-ccc_aserv_info_script,2016/02/20,ccc_aserv_info_script,0,0,0:00:00,0,0:00:00,0,0
2016-02-20-ccc_bylaw_script,2016/02/20,ccc_bylaw_script,0,0,0:00:00,0,0:00:00,0,0
2016-02-20-ccc_city_script,2016/02/20,ccc_city_script,0,0,0:00:00,0,0:00:00,0,0
2016-02-20-ccc_cty_online_script,2016/02/20,ccc_cty_online_script,0,0,0:00:00,0,0:00:00,0,0
2016-02-20-ccc_feedback_script,2016/02/20,ccc_feedback_script,2,0,0:00:00,0,0:00:00,0,0
2016-02-20-ccc_fpb_script,2016/02/20,ccc_fpb_script,0,0,0:00:00,0,0:00:00,0,0
2016-02-20-ccc_help_script,2016/02/20,ccc_help_script,0,0,0:00:00,0,0:00:00,0,0
2016-02-20-ccc_link_script,2016/02/20,ccc_link_script,0,0,0:00:00,0,0:00:00,0,0
2016-02-20-ccc_media_line_script,2016/02/20,ccc_media_line_script,0,0,0:00:00,0,0:00:00,0,0
2016-02-20-ccc_priority_script,2016/02/20,ccc_priority_script,17,17,0:00:04,4,0:00:12,0,68
2016-02-20-ccc_tax_script,2016/02/20,ccc_tax_script,3,2,0:00:08,8,0:00:09,1,16
2016-02-20-ccc_waste_recycling_script,2016/02/20,ccc_waste_recycling_script,0,0,0:00:00,0,0:00:00,0,0
2016-02-21-ccc_311_calgary_script,2016/02/21,ccc_311_calgary_script,826,814,0:00:12,12,0:04:42,12,9768
2016-02-21-ccc_311_lobby_ph_script,2016/02/21,ccc_311_lobby_ph_script,0,0,0:00:00,0,0:00:00,0,0
2016-02-21-ccc_aserv_info_script,2016/02/21,ccc_aserv_info_script,0,0,0:00:00,0,0:00:00,0,0
2016-02-21-ccc_bylaw_script,2016/02/21,ccc_bylaw_script,0,0,0:00:00,0,0:00:00,0,0
2016-02-21-ccc_city_script,2016/02/21,ccc_city_script,0,0,0:00:00,0,0:00:00,0,0
2016-02-21-ccc_cty_online_script,2016/02/21,ccc_cty_online_script,0,0,0:00:00,0,0:00:00,0,0
2016-02-21-ccc_feedback_script,2016/02/21,ccc_feedback_script,0,0,0:00:00,0,0:00:00,0,0
2016-02-21-ccc_fpb_script,2016/02/21,ccc_fpb_script,0,0,0:00:00,0,0:00:00,0,0
2016-02-21-ccc_help_script,2016/02/21,ccc_help_script,3,3,0:00:04,4,0:00:06,0,12
2016-02-21-ccc_link_script,2016/02/21,ccc_link_script,0,0,0:00:00,0,0:00:00,0,0
2016-02-21-ccc_media_line_script,2016/02/21,ccc_media_line_script,0,0,0:00:00,0,0:00:00,0,0
2016-02-21-ccc_priority_script,2016/02/21,ccc_priority_script,18,18,0:00:16,16,0:02:17,0,288
2016-02-21-ccc_tax_script,2016/02/21,ccc_tax_script,0,0,0:00:00,0,0:00:00,0,0
2016-02-21-ccc_waste_recycling_script,2016/02/21,ccc_waste_recycling_script,0,0,0:00:00,0,0:00:00,0,0
2016-02-22-ccc_311_calgary_script,2016/02/22,ccc_311_calgary_script,3020,2982,0:00:10,10,0:01:54,38,29820
2016-02-22-ccc_311_lobby_ph_script,2016/02/22,ccc_311_lobby_ph_script,2,2,0:00:07,7,0:00:10,0,14
2016-02-22-ccc_aserv_info_script,2016/02/22,ccc_aserv_info_script,0,0,0:00:00,0,0:00:00,0,0
2016-02-22-ccc_bylaw_script,2016/02/22,ccc_bylaw_script,0,0,0:00:00,0,0:00:00,0,0
2016-02-22-ccc_city_script,2016/02/22,ccc_city_script,19,17,0:00:08,8,0:00:17,2,136
2016-02-22-ccc_cty_online_script,2016/02/22,ccc_cty_online_script,0,0,0:00:00,0,0:00:00,0,0
2016-02-22-ccc_feedback_script,2016/02/22,ccc_feedback_script,0,0,0:00:00,0,0:00:00,0,0
2016-02-22-ccc_fpb_script,2016/02/22,ccc_fpb_script,1,1,0:00:02,2,0:00:02,0,2
2016-02-22-ccc_help_script,2016/02/22,ccc_help_script,19,19,0:00:07,7,0:00:20,0,133
2016-02-22-ccc_link_script,2016/02/22,ccc_link_script,0,0,0:00:00,0,0:00:00,0,0
2016-02-22-ccc_media_line_script,2016/02/22,ccc_media_line_script,1,1,0:00:14,14,0:00:14,0,14
2016-02-22-ccc_priority_script,2016/02/22,ccc_priority_script,26,26,0:00:06,6,0:00:24,0,156
2016-02-22-ccc_tax_script,2016/02/22,ccc_tax_script,22,21,0:00:18,18,0:01:25,1,378
2016-02-22-ccc_waste_recycling_script,2016/02/22,ccc_waste_recycling_script,0,0,0:00:00,0,0:00:00,0,0
2016-02-23-ccc_311_calgary_script,2016/02/23,ccc_311_calgary_script,2763,2720,0:00:10,10,0:03:23,43,27200
2016-02-23-ccc_311_lobby_ph_script,2016/02/23,ccc_311_lobby_ph_script,3,3,0:00:02,2,0:00:04,0,6
2016-02-23-ccc_aserv_info_script,2016/02/23,ccc_aserv_info_script,0,0,0:00:00,0,0:00:00,0,0
2016-02-23-ccc_bylaw_script,2016/02/23,ccc_bylaw_script,0,0,0:00:00,0,0:00:00,0,0
2016-02-23-ccc_city_script,2016/02/23,ccc_city_script,28,27,0:00:07,7,0:00:38,1,189
2016-02-23-ccc_cty_online_script,2016/02/23,ccc_cty_online_script,0,0,0:00:00,0,0:00:00,0,0
2016-02-23-ccc_feedback_script,2016/02/23,ccc_feedback_script,2,0,0:00:00,0,0:00:00,0,0
2016-02-23-ccc_fpb_script,2016/02/23,ccc_fpb_script,0,0,0:00:00,0,0:00:00,0,0
2016-02-23-ccc_help_script,2016/02/23,ccc_help_script,17,17,0:00:09,9,0:01:05,0,153
2016-02-23-ccc_link_script,2016/02/23,ccc_link_script,0,0,0:00:00,0,0:00:00,0,0
2016-02-23-ccc_media_line_script,2016/02/23,ccc_media_line_script,1,1,0:00:01,1,0:00:01,0,1
2016-02-23-ccc_priority_script,2016/02/23,ccc_priority_script,21,21,0:00:05,5,0:00:16,0,105
2016-02-23-ccc_tax_script,2016/02/23,ccc_tax_script,20,20,0:00:11,11,0:01:09,0,220
2016-02-23-ccc_waste_recycling_script,2016/02/23,ccc_waste_recycling_script,0,0,0:00:00,0,0:00:00,0,0
2016-02-24-ccc_311_calgary_script,2016/02/24,ccc_311_calgary_script,2780,2701,0:00:19,19,0:05:47,79,51319
2016-02-24-ccc_311_lobby_ph_script,2016/02/24,ccc_311_lobby_ph_script,7,7,0:00:06,6,0:00:10,0,42
2016-02-24-ccc_aserv_info_script,2016/02/24,ccc_aserv_info_script,0,0,0:00:00,0,0:00:00,0,0
2016-02-24-ccc_bylaw_script,2016/02/24,ccc_bylaw_script,0,0,0:00:00,0,0:00:00,0,0
2016-02-24-ccc_city_script,2016/02/24,ccc_city_script,24,24,0:00:07,7,0:00:37,0,168
2016-02-24-ccc_cty_online_script,2016/02/24,ccc_cty_online_script,0,0,0:00:00,0,0:00:00,0,0
2016-02-24-ccc_feedback_script,2016/02/24,ccc_feedback_script,0,0,0:00:00,0,0:00:00,0,0
2016-02-24-ccc_fpb_script,2016/02/24,ccc_fpb_script,1,1,0:00:15,15,0:00:15,0,15
2016-02-24-ccc_help_script,2016/02/24,ccc_help_script,14,14,0:00:17,17,0:01:52,0,238
2016-02-24-ccc_link_script,2016/02/24,ccc_link_script,0,0,0:00:00,0,0:00:00,0,0
2016-02-24-ccc_media_line_script,2016/02/24,ccc_media_line_script,4,4,0:00:04,4,0:00:08,0,16
2016-02-24-ccc_priority_script,2016/02/24,ccc_priority_script,29,29,0:00:07,7,0:00:18,0,203
2016-02-24-ccc_tax_script,2016/02/24,ccc_tax_script,24,23,0:00:32,32,0:02:11,1,736
2016-02-24-ccc_waste_recycling_script,2016/02/24,ccc_waste_recycling_script,0,0,0:00:00,0,0:00:00,0,0
2016-02-25-ccc_311_calgary_script,2016/02/25,ccc_311_calgary_script,2992,2791,0:00:37,37,0:08:01,201,103267
2016-02-25-ccc_311_lobby_ph_script,2016/02/25,ccc_311_lobby_ph_script,9,7,0:00:07,7,0:00:21,2,49
2016-02-25-ccc_aserv_info_script,2016/02/25,ccc_aserv_info_script,0,0,0:00:00,0,0:00:00,0,0
2016-02-25-ccc_bylaw_script,2016/02/25,ccc_bylaw_script,0,0,0:00:00,0,0:00:00,0,0
2016-02-25-ccc_city_script,2016/02/25,ccc_city_script,17,17,0:00:07,7,0:00:27,0,119
2016-02-25-ccc_cty_online_script,2016/02/25,ccc_cty_online_script,0,0,0:00:00,0,0:00:00,0,0
2016-02-25-ccc_feedback_script,2016/02/25,ccc_feedback_script,1,0,0:00:00,0,0:00:00,0,0
2016-02-25-ccc_fpb_script,2016/02/25,ccc_fpb_script,2,2,0:00:10,10,0:00:16,0,20
2016-02-25-ccc_help_script,2016/02/25,ccc_help_script,21,21,0:00:05,5,0:00:13,0,105
2016-02-25-ccc_link_script,2016/02/25,ccc_link_script,0,0,0:00:00,0,0:00:00,0,0
2016-02-25-ccc_media_line_script,2016/02/25,ccc_media_line_script,0,0,0:00:00,0,0:00:00,0,0
2016-02-25-ccc_priority_script,2016/02/25,ccc_priority_script,29,28,0:00:08,8,0:00:24,1,224
2016-02-25-ccc_tax_script,2016/02/25,ccc_tax_script,18,18,0:00:59,59,0:04:00,0,1062
2016-02-25-ccc_waste_recycling_script,2016/02/25,ccc_waste_recycling_script,0,0,0:00:00,0,0:00:00,0,0
2016-02-26-ccc_311_calgary_script,2016/02/26,ccc_311_calgary_script,2594,2536,0:00:14,14,0:04:01,57,35504
2016-02-26-ccc_311_lobby_ph_script,2016/02/26,ccc_311_lobby_ph_script,2,2,0:00:05,5,0:00:07,0,10
2016-02-26-ccc_aserv_info_script,2016/02/26,ccc_aserv_info_script,0,0,0:00:00,0,0:00:00,0,0
2016-02-26-ccc_bylaw_script,2016/02/26,ccc_bylaw_script,0,0,0:00:00,0,0:00:00,0,0
2016-02-26-ccc_city_script,2016/02/26,ccc_city_script,14,14,0:00:07,7,0:00:16,0,98
2016-02-26-ccc_cty_online_script,2016/02/26,ccc_cty_online_script,0,0,0:00:00,0,0:00:00,0,0
2016-02-26-ccc_feedback_script,2016/02/26,ccc_feedback_script,0,0,0:00:00,0,0:00:00,0,0
2016-02-26-ccc_fpb_script,2016/02/26,ccc_fpb_script,0,0,0:00:00,0,0:00:00,0,0
2016-02-26-ccc_help_script,2016/02/26,ccc_help_script,14,14,0:00:12,12,0:01:13,0,168
2016-02-26-ccc_link_script,2016/02/26,ccc_link_script,0,0,0:00:00,0,0:00:00,0,0
2016-02-26-ccc_media_line_script,2016/02/26,ccc_media_line_script,0,0,0:00:00,0,0:00:00,0,0
2016-02-26-ccc_priority_script,2016/02/26,ccc_priority_script,23,23,0:00:09,9,0:00:56,0,207
2016-02-26-ccc_tax_script,2016/02/26,ccc_tax_script,13,13,0:00:25,25,0:01:27,0,325
2016-02-26-ccc_waste_recycling_script,2016/02/26,ccc_waste_recycling_script,0,0,0:00:00,0,0:00:00,0,0
2016-02-27-ccc_311_calgary_script,2016/02/27,ccc_311_calgary_script,889,879,0:00:08,8,0:02:09,11,7032
2016-02-27-ccc_311_lobby_ph_script,2016/02/27,ccc_311_lobby_ph_script,0,0,0:00:00,0,0:00:00,0,0
2016-02-27-ccc_aserv_info_script,2016/02/27,ccc_aserv_info_script,0,0,0:00:00,0,0:00:00,0,0
2016-02-27-ccc_bylaw_script,2016/02/27,ccc_bylaw_script,0,0,0:00:00,0,0:00:00,0,0
2016-02-27-ccc_city_script,2016/02/27,ccc_city_script,0,0,0:00:00,0,0:00:00,0,0
2016-02-27-ccc_cty_online_script,2016/02/27,ccc_cty_online_script,0,0,0:00:00,0,0:00:00,0,0
2016-02-27-ccc_feedback_script,2016/02/27,ccc_feedback_script,0,0,0:00:00,0,0:00:00,0,0
2016-02-27-ccc_fpb_script,2016/02/27,ccc_fpb_script,0,0,0:00:00,0,0:00:00,0,0
2016-02-27-ccc_help_script,2016/02/27,ccc_help_script,10,10,0:00:06,6,0:00:11,0,60
2016-02-27-ccc_link_script,2016/02/27,ccc_link_script,0,0,0:00:00,0,0:00:00,0,0
2016-02-27-ccc_media_line_script,2016/02/27,ccc_media_line_script,2,2,0:00:05,5,0:00:06,0,10
2016-02-27-ccc_priority_script,2016/02/27,ccc_priority_script,14,14,0:00:11,11,0:01:17,0,154
2016-02-27-ccc_tax_script,2016/02/27,ccc_tax_script,1,1,0:00:12,12,0:00:12,0,12
2016-02-27-ccc_waste_recycling_script,2016/02/27,ccc_waste_recycling_script,0,0,0:00:00,0,0:00:00,0,0
2016-02-28-ccc_311_calgary_script,2016/02/28,ccc_311_calgary_script,855,837,0:00:12,12,0:05:25,17,10044
2016-02-28-ccc_311_lobby_ph_script,2016/02/28,ccc_311_lobby_ph_script,0,0,0:00:00,0,0:00:00,0,0
2016-02-28-ccc_aserv_info_script,2016/02/28,ccc_aserv_info_script,0,0,0:00:00,0,0:00:00,0,0
2016-02-28-ccc_bylaw_script,2016/02/28,ccc_bylaw_script,0,0,0:00:00,0,0:00:00,0,0
2016-02-28-ccc_city_script,2016/02/28,ccc_city_script,0,0,0:00:00,0,0:00:00,0,0
2016-02-28-ccc_cty_online_script,2016/02/28,ccc_cty_online_script,0,0,0:00:00,0,0:00:00,0,0
2016-02-28-ccc_feedback_script,2016/02/28,ccc_feedback_script,0,0,0:00:00,0,0:00:00,0,0
2016-02-28-ccc_fpb_script,2016/02/28,ccc_fpb_script,1,1,0:00:04,4,0:00:04,0,4
2016-02-28-ccc_help_script,2016/02/28,ccc_help_script,8,8,0:00:07,7,0:00:14,0,56
2016-02-28-ccc_link_script,2016/02/28,ccc_link_script,0,0,0:00:00,0,0:00:00,0,0
2016-02-28-ccc_media_line_script,2016/02/28,ccc_media_line_script,1,1,0:00:07,7,0:00:07,0,7
2016-02-28-ccc_priority_script,2016/02/28,ccc_priority_script,20,19,0:00:22,22,0:02:59,1,418
2016-02-28-ccc_tax_script,2016/02/28,ccc_tax_script,0,0,0:00:00,0,0:00:00,0,0
2016-02-28-ccc_waste_recycling_script,2016/02/28,ccc_waste_recycling_script,0,0,0:00:00,0,0:00:00,0,0
2016-02-29-ccc_311_calgary_script,2016/02/29,ccc_311_calgary_script,3199,3099,0:00:23,23,0:18:06,100,71277
2016-02-29-ccc_311_lobby_ph_script,2016/02/29,ccc_311_lobby_ph_script,2,2,0:00:02,2,0:00:02,0,4
2016-02-29-ccc_aserv_info_script,2016/02/29,ccc_aserv_info_script,0,0,0:00:00,0,0:00:00,0,0
2016-02-29-ccc_bylaw_script,2016/02/29,ccc_bylaw_script,0,0,0:00:00,0,0:00:00,0,0
2016-02-29-ccc_city_script,2016/02/29,ccc_city_script,17,16,0:00:15,15,0:01:27,1,240
2016-02-29-ccc_cty_online_script,2016/02/29,ccc_cty_online_script,0,0,0:00:00,0,0:00:00,0,0
2016-02-29-ccc_feedback_script,2016/02/29,ccc_feedback_script,0,0,0:00:00,0,0:00:00,0,0
2016-02-29-ccc_fpb_script,2016/02/29,ccc_fpb_script,0,0,0:00:00,0,0:00:00,0,0
2016-02-29-ccc_help_script,2016/02/29,ccc_help_script,21,19,0:00:06,6,0:00:14,2,114
2016-02-29-ccc_link_script,2016/02/29,ccc_link_script,0,0,0:00:00,0,0:00:00,0,0
2016-02-29-ccc_media_line_script,2016/02/29,ccc_media_line_script,1,1,0:00:05,5,0:00:05,0,5
2016-02-29-ccc_priority_script,2016/02/29,ccc_priority_script,41,39,0:00:07,7,0:00:21,2,273
2016-02-29-ccc_tax_script,2016/02/29,ccc_tax_script,19,18,0:00:22,22,0:03:08,1,396
2016-02-29-ccc_waste_recycling_script,2016/02/29,ccc_waste_recycling_script,0,0,0:00:00,0,0:00:00,0,0
2016-03-01-ccc_311_calgary_script,2016/03/01,ccc_311_calgary_script,2969,2882,0:00:25,25,0:03:43,87,72050
2016-03-01-ccc_311_lobby_ph_script,2016/03/01,ccc_311_lobby_ph_script,4,4,0:00:12,12,0:00:26,0,48
2016-03-01-ccc_aserv_info_script,2016/03/01,ccc_aserv_info_script,0,0,0:00:00,0,0:00:00,0,0
2016-03-01-ccc_bylaw_script,2016/03/01,ccc_bylaw_script,0,0,0:00:00,0,0:00:00,0,0
2016-03-01-ccc_city_script,2016/03/01,ccc_city_script,26,26,0:00:09,9,0:00:49,0,234
2016-03-01-ccc_cty_online_script,2016/03/01,ccc_cty_online_script,0,0,0:00:00,0,0:00:00,0,0
2016-03-01-ccc_feedback_script,2016/03/01,ccc_feedback_script,0,0,0:00:00,0,0:00:00,0,0
2016-03-01-ccc_fpb_script,2016/03/01,ccc_fpb_script,1,1,0:00:03,3,0:00:03,0,3
2016-03-01-ccc_help_script,2016/03/01,ccc_help_script,18,18,0:00:17,17,0:00:54,0,306
2016-03-01-ccc_link_script,2016/03/01,ccc_link_script,0,0,0:00:00,0,0:00:00,0,0
2016-03-01-ccc_media_line_script,2016/03/01,ccc_media_line_script,3,3,0:00:10,10,0:00:16,0,30
2016-03-01-ccc_priority_script,2016/03/01,ccc_priority_script,22,22,0:00:08,8,0:00:47,0,176
2016-03-01-ccc_tax_script,2016/03/01,ccc_tax_script,16,16,0:00:25,25,0:01:48,0,400
2016-03-01-ccc_waste_recycling_script,2016/03/01,ccc_waste_recycling_script,0,0,0:00:00,0,0:00:00,0,0
2016-03-02-ccc_311_calgary_script,2016/03/02,ccc_311_calgary_script,2982,2868,0:00:26,26,0:04:13,114,74568
2016-03-02-ccc_311_lobby_ph_script,2016/03/02,ccc_311_lobby_ph_script,3,2,0:00:23,23,0:00:37,1,46
2016-03-02-ccc_aserv_info_script,2016/03/02,ccc_aserv_info_script,0,0,0:00:00,0,0:00:00,0,0
2016-03-02-ccc_bylaw_script,2016/03/02,ccc_bylaw_script,0,0,0:00:00,0,0:00:00,0,0
2016-03-02-ccc_city_script,2016/03/02,ccc_city_script,29,28,0:00:09,9,0:00:29,1,252
2016-03-02-ccc_cty_online_script,2016/03/02,ccc_cty_online_script,0,0,0:00:00,0,0:00:00,0,0
2016-03-02-ccc_feedback_script,2016/03/02,ccc_feedback_script,0,0,0:00:00,0,0:00:00,0,0
2016-03-02-ccc_fpb_script,2016/03/02,ccc_fpb_script,1,1,0:00:04,4,0:00:04,0,4
2016-03-02-ccc_help_script,2016/03/02,ccc_help_script,18,18,0:00:18,18,0:01:11,0,324
2016-03-02-ccc_link_script,2016/03/02,ccc_link_script,0,0,0:00:00,0,0:00:00,0,0
2016-03-02-ccc_media_line_script,2016/03/02,ccc_media_line_script,1,1,0:00:06,6,0:00:06,0,6
2016-03-02-ccc_priority_script,2016/03/02,ccc_priority_script,14,14,0:00:07,7,0:00:19,0,98
2016-03-02-ccc_tax_script,2016/03/02,ccc_tax_script,19,17,0:00:30,30,0:02:05,2,510
2016-03-02-ccc_waste_recycling_script,2016/03/02,ccc_waste_recycling_script,0,0,0:00:00,0,0:00:00,0,0
2016-03-03-ccc_311_calgary_script,2016/03/03,ccc_311_calgary_script,2920,2855,0:00:18,18,0:07:14,65,51390
2016-03-03-ccc_311_lobby_ph_script,2016/03/03,ccc_311_lobby_ph_script,4,4,0:00:12,12,0:00:16,0,48
2016-03-03-ccc_aserv_info_script,2016/03/03,ccc_aserv_info_script,0,0,0:00:00,0,0:00:00,0,0
2016-03-03-ccc_bylaw_script,2016/03/03,ccc_bylaw_script,0,0,0:00:00,0,0:00:00,0,0
2016-03-03-ccc_city_script,2016/03/03,ccc_city_script,26,25,0:00:09,9,0:00:32,1,225
2016-03-03-ccc_cty_online_script,2016/03/03,ccc_cty_online_script,0,0,0:00:00,0,0:00:00,0,0
2016-03-03-ccc_feedback_script,2016/03/03,ccc_feedback_script,0,0,0:00:00,0,0:00:00,0,0
2016-03-03-ccc_fpb_script,2016/03/03,ccc_fpb_script,0,0,0:00:00,0,0:00:00,0,0
2016-03-03-ccc_help_script,2016/03/03,ccc_help_script,20,20,0:00:07,7,0:00:23,0,140
2016-03-03-ccc_link_script,2016/03/03,ccc_link_script,2,0,0:00:00,0,0:00:00,0,0
2016-03-03-ccc_media_line_script,2016/03/03,ccc_media_line_script,0,0,0:00:00,0,0:00:00,0,0
2016-03-03-ccc_priority_script,2016/03/03,ccc_priority_script,26,22,0:00:06,6,0:00:18,4,132
2016-03-03-ccc_tax_script,2016/03/03,ccc_tax_script,18,18,0:00:27,27,0:02:49,0,486
2016-03-03-ccc_waste_recycling_script,2016/03/03,ccc_waste_recycling_script,0,0,0:00:00,0,0:00:00,0,0
2016-03-04-ccc_311_calgary_script,2016/03/04,ccc_311_calgary_script,2754,2680,0:00:13,13,0:04:03,74,34840
2016-03-04-ccc_311_lobby_ph_script,2016/03/04,ccc_311_lobby_ph_script,5,4,0:00:07,7,0:00:18,1,28
2016-03-04-ccc_aserv_info_script,2016/03/04,ccc_aserv_info_script,0,0,0:00:00,0,0:00:00,0,0
2016-03-04-ccc_bylaw_script,2016/03/04,ccc_bylaw_script,0,0,0:00:00,0,0:00:00,0,0
2016-03-04-ccc_city_script,2016/03/04,ccc_city_script,21,21,0:00:09,9,0:01:02,0,189
2016-03-04-ccc_cty_online_script,2016/03/04,ccc_cty_online_script,0,0,0:00:00,0,0:00:00,0,0
2016-03-04-ccc_feedback_script,2016/03/04,ccc_feedback_script,0,0,0:00:00,0,0:00:00,0,0
2016-03-04-ccc_fpb_script,2016/03/04,ccc_fpb_script,1,1,0:00:01,1,0:00:01,0,1
2016-03-04-ccc_help_script,2016/03/04,ccc_help_script,25,24,0:00:07,7,0:00:20,1,168
2016-03-04-ccc_link_script,2016/03/04,ccc_link_script,0,0,0:00:00,0,0:00:00,0,0
2016-03-04-ccc_media_line_script,2016/03/04,ccc_media_line_script,0,0,0:00:00,0,0:00:00,0,0
2016-03-04-ccc_priority_script,2016/03/04,ccc_priority_script,25,22,0:00:06,6,0:00:14,3,132
2016-03-04-ccc_tax_script,2016/03/04,ccc_tax_script,12,12,0:00:08,8,0:00:31,0,96
2016-03-04-ccc_waste_recycling_script,2016/03/04,ccc_waste_recycling_script,0,0,0:00:00,0,0:00:00,0,0
2016-03-05-ccc_311_calgary_script,2016/03/05,ccc_311_calgary_script,1053,1008,0:00:27,27,0:08:29,45,27216
2016-03-05-ccc_311_lobby_ph_script,2016/03/05,ccc_311_lobby_ph_script,0,0,0:00:00,0,0:00:00,0,0
2016-03-05-ccc_aserv_info_script,2016/03/05,ccc_aserv_info_script,0,0,0:00:00,0,0:00:00,0,0
2016-03-05-ccc_bylaw_script,2016/03/05,ccc_bylaw_script,0,0,0:00:00,0,0:00:00,0,0
2016-03-05-ccc_city_script,2016/03/05,ccc_city_script,0,0,0:00:00,0,0:00:00,0,0
2016-03-05-ccc_cty_online_script,2016/03/05,ccc_cty_online_script,0,0,0:00:00,0,0:00:00,0,0
2016-03-05-ccc_feedback_script,2016/03/05,ccc_feedback_script,0,0,0:00:00,0,0:00:00,0,0
2016-03-05-ccc_fpb_script,2016/03/05,ccc_fpb_script,0,0,0:00:00,0,0:00:00,0,0
2016-03-05-ccc_help_script,2016/03/05,ccc_help_script,7,6,0:00:18,18,0:00:55,1,108
2016-03-05-ccc_link_script,2016/03/05,ccc_link_script,0,0,0:00:00,0,0:00:00,0,0
2016-03-05-ccc_media_line_script,2016/03/05,ccc_media_line_script,0,0,0:00:00,0,0:00:00,0,0
2016-03-05-ccc_priority_script,2016/03/05,ccc_priority_script,18,17,0:00:31,31,0:02:10,1,527
2016-03-05-ccc_tax_script,2016/03/05,ccc_tax_script,0,0,0:00:00,0,0:00:00,0,0
2016-03-05-ccc_waste_recycling_script,2016/03/05,ccc_waste_recycling_script,0,0,0:00:00,0,0:00:00,0,0
2016-03-06-ccc_311_calgary_script,2016/03/06,ccc_311_calgary_script,860,848,0:00:12,12,0:02:59,12,10176
2016-03-06-ccc_311_lobby_ph_script,2016/03/06,ccc_311_lobby_ph_script,0,0,0:00:00,0,0:00:00,0,0
2016-03-06-ccc_aserv_info_script,2016/03/06,ccc_aserv_info_script,0,0,0:00:00,0,0:00:00,0,0
2016-03-06-ccc_bylaw_script,2016/03/06,ccc_bylaw_script,0,0,0:00:00,0,0:00:00,0,0
2016-03-06-ccc_city_script,2016/03/06,ccc_city_script,0,0,0:00:00,0,0:00:00,0,0
2016-03-06-ccc_cty_online_script,2016/03/06,ccc_cty_online_script,0,0,0:00:00,0,0:00:00,0,0
2016-03-06-ccc_feedback_script,2016/03/06,ccc_feedback_script,0,0,0:00:00,0,0:00:00,0,0
2016-03-06-ccc_fpb_script,2016/03/06,ccc_fpb_script,0,0,0:00:00,0,0:00:00,0,0
2016-03-06-ccc_help_script,2016/03/06,ccc_help_script,0,0,0:00:00,0,0:00:00,0,0
2016-03-06-ccc_link_script,2016/03/06,ccc_link_script,0,0,0:00:00,0,0:00:00,0,0
2016-03-06-ccc_media_line_script,2016/03/06,ccc_media_line_script,0,0,0:00:00,0,0:00:00,0,0
2016-03-06-ccc_priority_script,2016/03/06,ccc_priority_script,13,13,0:00:08,8,0:00:15,0,104
2016-03-06-ccc_tax_script,2016/03/06,ccc_tax_script,0,0,0:00:00,0,0:00:00,0,0
2016-03-06-ccc_waste_recycling_script,2016/03/06,ccc_waste_recycling_script,0,0,0:00:00,0,0:00:00,0,0
2016-03-07-ccc_311_calgary_script,2016/03/07,ccc_311_calgary_script,3311,3140,0:00:47,47,0:06:21,171,147580
2016-03-07-ccc_311_lobby_ph_script,2016/03/07,ccc_311_lobby_ph_script,8,6,0:00:08,8,0:00:27,2,48
2016-03-07-ccc_aserv_info_script,2016/03/07,ccc_aserv_info_script,0,0,0:00:00,0,0:00:00,0,0
2016-03-07-ccc_bylaw_script,2016/03/07,ccc_bylaw_script,0,0,0:00:00,0,0:00:00,0,0
2016-03-07-ccc_city_script,2016/03/07,ccc_city_script,19,19,0:00:16,16,0:00:47,0,304
2016-03-07-ccc_cty_online_script,2016/03/07,ccc_cty_online_script,0,0,0:00:00,0,0:00:00,0,0
2016-03-07-ccc_feedback_script,2016/03/07,ccc_feedback_script,0,0,0:00:00,0,0:00:00,0,0
2016-03-07-ccc_fpb_script,2016/03/07,ccc_fpb_script,0,0,0:00:00,0,0:00:00,0,0
2016-03-07-ccc_help_script,2016/03/07,ccc_help_script,23,21,0:00:13,13,0:00:42,2,273
2016-03-07-ccc_link_script,2016/03/07,ccc_link_script,0,0,0:00:00,0,0:00:00,0,0
2016-03-07-ccc_media_line_script,2016/03/07,ccc_media_line_script,3,3,0:00:04,4,0:00:08,0,12
2016-03-07-ccc_priority_script,2016/03/07,ccc_priority_script,22,20,0:00:08,8,0:00:33,2,160
2016-03-07-ccc_tax_script,2016/03/07,ccc_tax_script,25,22,0:01:00,60,0:03:12,3,1320
2016-03-07-ccc_waste_recycling_script,2016/03/07,ccc_waste_recycling_script,0,0,0:00:00,0,0:00:00,0,0
2016-03-08-ccc_311_calgary_script,2016/03/08,ccc_311_calgary_script,2900,2758,0:00:41,41,0:06:18,142,113078
2016-03-08-ccc_311_lobby_ph_script,2016/03/08,ccc_311_lobby_ph_script,1,0,0:00:00,0,0:00:00,1,0
2016-03-08-ccc_aserv_info_script,2016/03/08,ccc_aserv_info_script,0,0,0:00:00,0,0:00:00,0,0
2016-03-08-ccc_bylaw_script,2016/03/08,ccc_bylaw_script,0,0,0:00:00,0,0:00:00,0,0
2016-03-08-ccc_city_script,2016/03/08,ccc_city_script,15,15,0:00:07,7,0:00:16,0,105
2016-03-08-ccc_cty_online_script,2016/03/08,ccc_cty_online_script,0,0,0:00:00,0,0:00:00,0,0
2016-03-08-ccc_feedback_script,2016/03/08,ccc_feedback_script,0,0,0:00:00,0,0:00:00,0,0
2016-03-08-ccc_fpb_script,2016/03/08,ccc_fpb_script,2,1,0:00:02,2,0:00:02,1,2
2016-03-08-ccc_help_script,2016/03/08,ccc_help_script,16,14,0:00:11,11,0:00:43,2,154
2016-03-08-ccc_link_script,2016/03/08,ccc_link_script,0,0,0:00:00,0,0:00:00,0,0
2016-03-08-ccc_media_line_script,2016/03/08,ccc_media_line_script,0,0,0:00:00,0,0:00:00,0,0
2016-03-08-ccc_priority_script,2016/03/08,ccc_priority_script,21,21,0:00:09,9,0:00:31,0,189
2016-03-08-ccc_tax_script,2016/03/08,ccc_tax_script,20,20,0:00:56,56,0:03:10,0,1120
2016-03-08-ccc_waste_recycling_script,2016/03/08,ccc_waste_recycling_script,0,0,0:00:00,0,0:00:00,0,0
2016-03-09-ccc_311_calgary_script,2016/03/09,ccc_311_calgary_script,3026,2889,0:00:34,34,0:07:55,137,98226
2016-03-09-ccc_311_lobby_ph_script,2016/03/09,ccc_311_lobby_ph_script,8,8,0:00:11,11,0:00:31,0,88
2016-03-09-ccc_aserv_info_script,2016/03/09,ccc_aserv_info_script,0,0,0:00:00,0,0:00:00,0,0
2016-03-09-ccc_bylaw_script,2016/03/09,ccc_bylaw_script,0,0,0:00:00,0,0:00:00,0,0
2016-03-09-ccc_city_script,2016/03/09,ccc_city_script,15,14,0:00:11,11,0:00:27,1,154
2016-03-09-ccc_cty_online_script,2016/03/09,ccc_cty_online_script,0,0,0:00:00,0,0:00:00,0,0
2016-03-09-ccc_feedback_script,2016/03/09,ccc_feedback_script,3,0,0:00:00,0,0:00:00,0,0
2016-03-09-ccc_fpb_script,2016/03/09,ccc_fpb_script,5,4,0:00:06,6,0:00:13,1,24
2016-03-09-ccc_help_script,2016/03/09,ccc_help_script,16,13,0:00:07,7,0:00:27,3,91
2016-03-09-ccc_link_script,2016/03/09,ccc_link_script,0,0,0:00:00,0,0:00:00,0,0
2016-03-09-ccc_media_line_script,2016/03/09,ccc_media_line_script,2,2,0:00:05,5,0:00:05,0,10
2016-03-09-ccc_priority_script,2016/03/09,ccc_priority_script,33,31,0:00:10,10,0:00:45,2,310
2016-03-09-ccc_tax_script,2016/03/09,ccc_tax_script,20,19,0:00:38,38,0:03:06,1,722
2016-03-09-ccc_waste_recycling_script,2016/03/09,ccc_waste_recycling_script,0,0,0:00:00,0,0:00:00,0,0
2016-03-10-ccc_311_calgary_script,2016/03/10,ccc_311_calgary_script,3093,2949,0:00:36,36,0:04:44,144,106164
2016-03-10-ccc_311_lobby_ph_script,2016/03/10,ccc_311_lobby_ph_script,9,8,0:00:06,6,0:00:11,1,48
2016-03-10-ccc_aserv_info_script,2016/03/10,ccc_aserv_info_script,0,0,0:00:00,0,0:00:00,0,0
2016-03-10-ccc_bylaw_script,2016/03/10,ccc_bylaw_script,0,0,0:00:00,0,0:00:00,0,0
2016-03-10-ccc_city_script,2016/03/10,ccc_city_script,24,24,0:00:15,15,0:02:05,0,360
2016-03-10-ccc_cty_online_script,2016/03/10,ccc_cty_online_script,0,0,0:00:00,0,0:00:00,0,0
2016-03-10-ccc_feedback_script,2016/03/10,ccc_feedback_script,0,0,0:00:00,0,0:00:00,0,0
2016-03-10-ccc_fpb_script,2016/03/10,ccc_fpb_script,1,1,0:04:27,267,0:04:27,0,267
2016-03-10-ccc_help_script,2016/03/10,ccc_help_script,25,23,0:00:10,10,0:00:23,2,230
2016-03-10-ccc_link_script,2016/03/10,ccc_link_script,0,0,0:00:00,0,0:00:00,0,0
2016-03-10-ccc_media_line_script,2016/03/10,ccc_media_line_script,0,0,0:00:00,0,0:00:00,0,0
2016-03-10-ccc_priority_script,2016/03/10,ccc_priority_script,30,30,0:00:09,9,0:00:35,0,270
2016-03-10-ccc_tax_script,2016/03/10,ccc_tax_script,12,12,0:00:39,39,0:01:52,0,468
2016-03-10-ccc_waste_recycling_script,2016/03/10,ccc_waste_recycling_script,0,0,0:00:00,0,0:00:00,0,0
2016-03-11-ccc_311_calgary_script,2016/03/11,ccc_311_calgary_script,2710,2631,0:00:23,23,0:05:19,79,60513
2016-03-11-ccc_311_lobby_ph_script,2016/03/11,ccc_311_lobby_ph_script,4,4,0:00:07,7,0:00:09,0,28
2016-03-11-ccc_aserv_info_script,2016/03/11,ccc_aserv_info_script,0,0,0:00:00,0,0:00:00,0,0
2016-03-11-ccc_bylaw_script,2016/03/11,ccc_bylaw_script,0,0,0:00:00,0,0:00:00,0,0
2016-03-11-ccc_city_script,2016/03/11,ccc_city_script,14,14,0:00:11,11,0:00:48,0,154
2016-03-11-ccc_cty_online_script,2016/03/11,ccc_cty_online_script,0,0,0:00:00,0,0:00:00,0,0
2016-03-11-ccc_feedback_script,2016/03/11,ccc_feedback_script,0,0,0:00:00,0,0:00:00,0,0
2016-03-11-ccc_fpb_script,2016/03/11,ccc_fpb_script,0,0,0:00:00,0,0:00:00,0,0
2016-03-11-ccc_help_script,2016/03/11,ccc_help_script,27,26,0:00:10,10,0:00:51,1,260
2016-03-11-ccc_link_script,2016/03/11,ccc_link_script,0,0,0:00:00,0,0:00:00,0,0
2016-03-11-ccc_media_line_script,2016/03/11,ccc_media_line_script,2,2,0:00:06,6,0:00:09,0,12
2016-03-11-ccc_priority_script,2016/03/11,ccc_priority_script,30,29,0:00:18,18,0:02:15,1,522
2016-03-11-ccc_tax_script,2016/03/11,ccc_tax_script,19,19,0:00:11,11,0:01:37,0,209
2016-03-11-ccc_waste_recycling_script,2016/03/11,ccc_waste_recycling_script,0,0,0:00:00,0,0:00:00,0,0
2016-03-12-ccc_311_calgary_script,2016/03/12,ccc_311_calgary_script,1100,1087,0:00:11,11,0:02:17,13,11957
2016-03-12-ccc_311_lobby_ph_script,2016/03/12,ccc_311_lobby_ph_script,0,0,0:00:00,0,0:00:00,0,0
2016-03-12-ccc_aserv_info_script,2016/03/12,ccc_aserv_info_script,0,0,0:00:00,0,0:00:00,0,0
2016-03-12-ccc_bylaw_script,2016/03/12,ccc_bylaw_script,0,0,0:00:00,0,0:00:00,0,0
2016-03-12-ccc_city_script,2016/03/12,ccc_city_script,0,0,0:00:00,0,0:00:00,0,0
2016-03-12-ccc_cty_online_script,2016/03/12,ccc_cty_online_script,0,0,0:00:00,0,0:00:00,0,0
2016-03-12-ccc_feedback_script,2016/03/12,ccc_feedback_script,0,0,0:00:00,0,0:00:00,0,0
2016-03-12-ccc_fpb_script,2016/03/12,ccc_fpb_script,0,0,0:00:00,0,0:00:00,0,0
2016-03-12-ccc_help_script,2016/03/12,ccc_help_script,0,0,0:00:00,0,0:00:00,0,0
2016-03-12-ccc_link_script,2016/03/12,ccc_link_script,0,0,0:00:00,0,0:00:00,0,0
2016-03-12-ccc_media_line_script,2016/03/12,ccc_media_line_script,0,0,0:00:00,0,0:00:00,0,0
2016-03-12-ccc_priority_script,2016/03/12,ccc_priority_script,19,19,0:00:09,9,0:00:28,0,171
2016-03-12-ccc_tax_script,2016/03/12,ccc_tax_script,3,3,0:00:05,5,0:00:06,0,15
2016-03-12-ccc_waste_recycling_script,2016/03/12,ccc_waste_recycling_script,0,0,0:00:00,0,0:00:00,0,0
2016-03-13-ccc_311_calgary_script,2016/03/13,ccc_311_calgary_script,868,835,0:00:22,22,0:07:47,33,18370
2016-03-13-ccc_311_lobby_ph_script,2016/03/13,ccc_311_lobby_ph_script,0,0,0:00:00,0,0:00:00,0,0
2016-03-13-ccc_aserv_info_script,2016/03/13,ccc_aserv_info_script,0,0,0:00:00,0,0:00:00,0,0
2016-03-13-ccc_bylaw_script,2016/03/13,ccc_bylaw_script,0,0,0:00:00,0,0:00:00,0,0
2016-03-13-ccc_city_script,2016/03/13,ccc_city_script,0,0,0:00:00,0,0:00:00,0,0
2016-03-13-ccc_cty_online_script,2016/03/13,ccc_cty_online_script,0,0,0:00:00,0,0:00:00,0,0
2016-03-13-ccc_feedback_script,2016/03/13,ccc_feedback_script,0,0,0:00:00,0,0:00:00,0,0
2016-03-13-ccc_fpb_script,2016/03/13,ccc_fpb_script,0,0,0:00:00,0,0:00:00,0,0
2016-03-13-ccc_help_script,2016/03/13,ccc_help_script,6,5,0:00:13,13,0:00:33,1,65
2016-03-13-ccc_link_script,2016/03/13,ccc_link_script,0,0,0:00:00,0,0:00:00,0,0
2016-03-13-ccc_media_line_script,2016/03/13,ccc_media_line_script,1,1,0:00:04,4,0:00:04,0,4
2016-03-13-ccc_priority_script,2016/03/13,ccc_priority_script,18,16,0:00:07,7,0:00:39,2,112
2016-03-13-ccc_tax_script,2016/03/13,ccc_tax_script,1,1,0:00:04,4,0:00:04,0,4
2016-03-13-ccc_waste_recycling_script,2016/03/13,ccc_waste_recycling_script,0,0,0:00:00,0,0:00:00,0,0
2016-03-14-ccc_311_calgary_script,2016/03/14,ccc_311_calgary_script,2998,2962,0:00:10,10,0:05:47,36,29620
2016-03-14-ccc_311_lobby_ph_script,2016/03/14,ccc_311_lobby_ph_script,7,6,0:00:10,10,0:00:18,1,60
2016-03-14-ccc_aserv_info_script,2016/03/14,ccc_aserv_info_script,0,0,0:00:00,0,0:00:00,0,0
2016-03-14-ccc_bylaw_script,2016/03/14,ccc_bylaw_script,0,0,0:00:00,0,0:00:00,0,0
2016-03-14-ccc_city_script,2016/03/14,ccc_city_script,27,26,0:00:08,8,0:00:19,1,208
2016-03-14-ccc_cty_online_script,2016/03/14,ccc_cty_online_script,0,0,0:00:00,0,0:00:00,0,0
2016-03-14-ccc_feedback_script,2016/03/14,ccc_feedback_script,0,0,0:00:00,0,0:00:00,0,0
2016-03-14-ccc_fpb_script,2016/03/14,ccc_fpb_script,1,1,0:00:04,4,0:00:04,0,4
2016-03-14-ccc_help_script,2016/03/14,ccc_help_script,20,20,0:00:07,7,0:00:35,0,140
2016-03-14-ccc_link_script,2016/03/14,ccc_link_script,0,0,0:00:00,0,0:00:00,0,0
2016-03-14-ccc_media_line_script,2016/03/14,ccc_media_line_script,1,1,0:00:09,9,0:00:09,0,9
2016-03-14-ccc_priority_script,2016/03/14,ccc_priority_script,22,21,0:00:11,11,0:00:49,1,231
2016-03-14-ccc_tax_script,2016/03/14,ccc_tax_script,12,12,0:00:09,9,0:00:38,0,108
2016-03-14-ccc_waste_recycling_script,2016/03/14,ccc_waste_recycling_script,0,0,0:00:00,0,0:00:00,0,0
2016-03-15-ccc_311_calgary_script,2016/03/15,ccc_311_calgary_script,2926,2877,0:00:16,16,0:18:15,49,46032
2016-03-15-ccc_311_lobby_ph_script,2016/03/15,ccc_311_lobby_ph_script,5,4,0:00:09,9,0:00:19,1,36
2016-03-15-ccc_aserv_info_script,2016/03/15,ccc_aserv_info_script,0,0,0:00:00,0,0:00:00,0,0
2016-03-15-ccc_bylaw_script,2016/03/15,ccc_bylaw_script,0,0,0:00:00,0,0:00:00,0,0
2016-03-15-ccc_city_script,2016/03/15,ccc_city_script,25,25,0:00:09,9,0:00:19,0,225
2016-03-15-ccc_cty_online_script,2016/03/15,ccc_cty_online_script,0,0,0:00:00,0,0:00:00,0,0
2016-03-15-ccc_feedback_script,2016/03/15,ccc_feedback_script,0,0,0:00:00,0,0:00:00,0,0
2016-03-15-ccc_fpb_script,2016/03/15,ccc_fpb_script,1,1,0:00:05,5,0:00:05,0,5
2016-03-15-ccc_help_script,2016/03/15,ccc_help_script,21,19,0:00:11,11,0:00:42,2,209
2016-03-15-ccc_link_script,2016/03/15,ccc_link_script,0,0,0:00:00,0,0:00:00,0,0
2016-03-15-ccc_media_line_script,2016/03/15,ccc_media_line_script,2,2,0:00:06,6,0:00:07,0,12
2016-03-15-ccc_priority_script,2016/03/15,ccc_priority_script,23,22,0:00:08,8,0:00:20,1,176
2016-03-15-ccc_tax_script,2016/03/15,ccc_tax_script,14,13,0:00:05,5,0:00:09,1,65
2016-03-15-ccc_waste_recycling_script,2016/03/15,ccc_waste_recycling_script,0,0,0:00:00,0,0:00:00,0,0
2016-03-16-ccc_311_calgary_script,2016/03/16,ccc_311_calgary_script,2694,2652,0:00:11,11,0:04:30,42,29172
2016-03-16-ccc_311_lobby_ph_script,2016/03/16,ccc_311_lobby_ph_script,6,6,0:00:07,7,0:00:18,0,42
2016-03-16-ccc_aserv_info_script,2016/03/16,ccc_aserv_info_script,0,0,0:00:00,0,0:00:00,0,0
2016-03-16-ccc_bylaw_script,2016/03/16,ccc_bylaw_script,0,0,0:00:00,0,0:00:00,0,0
2016-03-16-ccc_city_script,2016/03/16,ccc_city_script,18,18,0:00:10,10,0:00:37,0,180
2016-03-16-ccc_cty_online_script,2016/03/16,ccc_cty_online_script,0,0,0:00:00,0,0:00:00,0,0
2016-03-16-ccc_feedback_script,2016/03/16,ccc_feedback_script,0,0,0:00:00,0,0:00:00,0,0
2016-03-16-ccc_fpb_script,2016/03/16,ccc_fpb_script,0,0,0:00:00,0,0:00:00,0,0
2016-03-16-ccc_help_script,2016/03/16,ccc_help_script,14,13,0:00:11,11,0:00:39,1,143
2016-03-16-ccc_link_script,2016/03/16,ccc_link_script,0,0,0:00:00,0,0:00:00,0,0
2016-03-16-ccc_media_line_script,2016/03/16,ccc_media_line_script,0,0,0:00:00,0,0:00:00,0,0
2016-03-16-ccc_priority_script,2016/03/16,ccc_priority_script,22,22,0:00:07,7,0:00:25,0,154
2016-03-16-ccc_tax_script,2016/03/16,ccc_tax_script,15,15,0:00:09,9,0:00:47,0,135
2016-03-16-ccc_waste_recycling_script,2016/03/16,ccc_waste_recycling_script,0,0,0:00:00,0,0:00:00,0,0
2016-03-17-ccc_311_calgary_script,2016/03/17,ccc_311_calgary_script,2472,2448,0:00:08,8,0:03:43,24,19584
2016-03-17-ccc_311_lobby_ph_script,2016/03/17,ccc_311_lobby_ph_script,1,1,0:00:03,3,0:00:03,0,3
2016-03-17-ccc_aserv_info_script,2016/03/17,ccc_aserv_info_script,0,0,0:00:00,0,0:00:00,0,0
2016-03-17-ccc_bylaw_script,2016/03/17,ccc_bylaw_script,0,0,0:00:00,0,0:00:00,0,0
2016-03-17-ccc_city_script,2016/03/17,ccc_city_script,20,20,0:00:06,6,0:00:14,0,120
2016-03-17-ccc_cty_online_script,2016/03/17,ccc_cty_online_script,0,0,0:00:00,0,0:00:00,0,0
2016-03-17-ccc_feedback_script,2016/03/17,ccc_feedback_script,0,0,0:00:00,0,0:00:00,0,0
2016-03-17-ccc_fpb_script,2016/03/17,ccc_fpb_script,1,1,0:00:05,5,0:00:05,0,5
2016-03-17-ccc_help_script,2016/03/17,ccc_help_script,12,12,0:00:10,10,0:00:45,0,120
2016-03-17-ccc_link_script,2016/03/17,ccc_link_script,0,0,0:00:00,0,0:00:00,0,0
2016-03-17-ccc_media_line_script,2016/03/17,ccc_media_line_script,2,2,0:00:04,4,0:00:05,0,8
2016-03-17-ccc_priority_script,2016/03/17,ccc_priority_script,44,44,0:00:11,11,0:01:36,0,484
2016-03-17-ccc_tax_script,2016/03/17,ccc_tax_script,4,4,0:00:05,5,0:00:07,0,20
2016-03-17-ccc_waste_recycling_script,2016/03/17,ccc_waste_recycling_script,0,0,0:00:00,0,0:00:00,0,0
2016-03-18-ccc_311_calgary_script,2016/03/18,ccc_311_calgary_script,2429,2394,0:00:09,9,0:05:53,35,21546
2016-03-18-ccc_311_lobby_ph_script,2016/03/18,ccc_311_lobby_ph_script,3,3,0:00:16,16,0:00:36,0,48
2016-03-18-ccc_aserv_info_script,2016/03/18,ccc_aserv_info_script,0,0,0:00:00,0,0:00:00,0,0
2016-03-18-ccc_bylaw_script,2016/03/18,ccc_bylaw_script,0,0,0:00:00,0,0:00:00,0,0
2016-03-18-ccc_city_script,2016/03/18,ccc_city_script,18,18,0:00:07,7,0:00:15,0,126
2016-03-18-ccc_cty_online_script,2016/03/18,ccc_cty_online_script,0,0,0:00:00,0,0:00:00,0,0
2016-03-18-ccc_feedback_script,2016/03/18,ccc_feedback_script,0,0,0:00:00,0,0:00:00,0,0
2016-03-18-ccc_fpb_script,2016/03/18,ccc_fpb_script,0,0,0:00:00,0,0:00:00,0,0
2016-03-18-ccc_help_script,2016/03/18,ccc_help_script,10,10,0:00:13,13,0:00:33,0,130
2016-03-18-ccc_link_script,2016/03/18,ccc_link_script,0,0,0:00:00,0,0:00:00,0,0
2016-03-18-ccc_media_line_script,2016/03/18,ccc_media_line_script,0,0,0:00:00,0,0:00:00,0,0
2016-03-18-ccc_priority_script,2016/03/18,ccc_priority_script,26,25,0:00:08,8,0:00:26,1,200
2016-03-18-ccc_tax_script,2016/03/18,ccc_tax_script,14,14,0:00:09,9,0:00:34,0,126
2016-03-18-ccc_waste_recycling_script,2016/03/18,ccc_waste_recycling_script,0,0,0:00:00,0,0:00:00,0,0
2016-03-19-ccc_311_calgary_script,2016/03/19,ccc_311_calgary_script,1044,1017,0:00:14,14,0:09:33,27,14238
2016-03-19-ccc_311_lobby_ph_script,2016/03/19,ccc_311_lobby_ph_script,0,0,0:00:00,0,0:00:00,0,0
2016-03-19-ccc_aserv_info_script,2016/03/19,ccc_aserv_info_script,0,0,0:00:00,0,0:00:00,0,0
2016-03-19-ccc_bylaw_script,2016/03/19,ccc_bylaw_script,0,0,0:00:00,0,0:00:00,0,0
2016-03-19-ccc_city_script,2016/03/19,ccc_city_script,0,0,0:00:00,0,0:00:00,0,0
2016-03-19-ccc_cty_online_script,2016/03/19,ccc_cty_online_script,0,0,0:00:00,0,0:00:00,0,0
2016-03-19-ccc_feedback_script,2016/03/19,ccc_feedback_script,0,0,0:00:00,0,0:00:00,0,0
2016-03-19-ccc_fpb_script,2016/03/19,ccc_fpb_script,0,0,0:00:00,0,0:00:00,0,0
2016-03-19-ccc_help_script,2016/03/19,ccc_help_script,4,4,0:00:07,7,0:00:15,0,28
2016-03-19-ccc_link_script,2016/03/19,ccc_link_script,0,0,0:00:00,0,0:00:00,0,0
2016-03-19-ccc_media_line_script,2016/03/19,ccc_media_line_script,2,2,0:00:05,5,0:00:06,0,10
2016-03-19-ccc_priority_script,2016/03/19,ccc_priority_script,25,24,0:00:13,13,0:00:53,1,312
2016-03-19-ccc_tax_script,2016/03/19,ccc_tax_script,0,0,0:00:00,0,0:00:00,0,0
2016-03-19-ccc_waste_recycling_script,2016/03/19,ccc_waste_recycling_script,0,0,0:00:00,0,0:00:00,0,0
2016-03-20-ccc_311_calgary_script,2016/03/20,ccc_311_calgary_script,894,882,0:00:12,12,0:02:53,12,10584
2016-03-20-ccc_311_lobby_ph_script,2016/03/20,ccc_311_lobby_ph_script,0,0,0:00:00,0,0:00:00,0,0
2016-03-20-ccc_aserv_info_script,2016/03/20,ccc_aserv_info_script,0,0,0:00:00,0,0:00:00,0,0
2016-03-20-ccc_bylaw_script,2016/03/20,ccc_bylaw_script,0,0,0:00:00,0,0:00:00,0,0
2016-03-20-ccc_city_script,2016/03/20,ccc_city_script,0,0,0:00:00,0,0:00:00,0,0
2016-03-20-ccc_cty_online_script,2016/03/20,ccc_cty_online_script,0,0,0:00:00,0,0:00:00,0,0
2016-03-20-ccc_feedback_script,2016/03/20,ccc_feedback_script,0,0,0:00:00,0,0:00:00,0,0
2016-03-20-ccc_fpb_script,2016/03/20,ccc_fpb_script,0,0,0:00:00,0,0:00:00,0,0
2016-03-20-ccc_help_script,2016/03/20,ccc_help_script,1,1,0:00:07,7,0:00:07,0,7
2016-03-20-ccc_link_script,2016/03/20,ccc_link_script,0,0,0:00:00,0,0:00:00,0,0
2016-03-20-ccc_media_line_script,2016/03/20,ccc_media_line_script,1,1,0:00:10,10,0:00:10,0,10
2016-03-20-ccc_priority_script,2016/03/20,ccc_priority_script,13,12,0:00:10,10,0:00:49,1,120
2016-03-20-ccc_tax_script,2016/03/20,ccc_tax_script,1,1,0:00:38,38,0:00:38,0,38
2016-03-20-ccc_waste_recycling_script,2016/03/20,ccc_waste_recycling_script,0,0,0:00:00,0,0:00:00,0,0
2016-03-21-ccc_311_calgary_script,2016/03/21,ccc_311_calgary_script,3127,3060,0:00:15,15,0:02:54,67,45900
2016-03-21-ccc_311_lobby_ph_script,2016/03/21,ccc_311_lobby_ph_script,7,7,0:00:13,13,0:00:46,0,91
2016-03-21-ccc_aserv_info_script,2016/03/21,ccc_aserv_info_script,0,0,0:00:00,0,0:00:00,0,0
2016-03-21-ccc_bylaw_script,2016/03/21,ccc_bylaw_script,0,0,0:00:00,0,0:00:00,0,0
2016-03-21-ccc_city_script,2016/03/21,ccc_city_script,29,29,0:00:10,10,0:00:38,0,290
2016-03-21-ccc_cty_online_script,2016/03/21,ccc_cty_online_script,0,0,0:00:00,0,0:00:00,0,0
2016-03-21-ccc_feedback_script,2016/03/21,ccc_feedback_script,0,0,0:00:00,0,0:00:00,0,0
2016-03-21-ccc_fpb_script,2016/03/21,ccc_fpb_script,0,0,0:00:00,0,0:00:00,0,0
2016-03-21-ccc_help_script,2016/03/21,ccc_help_script,11,11,0:00:08,8,0:00:16,0,88
2016-03-21-ccc_link_script,2016/03/21,ccc_link_script,0,0,0:00:00,0,0:00:00,0,0
2016-03-21-ccc_media_line_script,2016/03/21,ccc_media_line_script,2,2,0:00:06,6,0:00:08,0,12
2016-03-21-ccc_priority_script,2016/03/21,ccc_priority_script,22,21,0:00:10,10,0:00:28,1,210
2016-03-21-ccc_tax_script,2016/03/21,ccc_tax_script,9,9,0:00:28,28,0:01:26,0,252
2016-03-21-ccc_waste_recycling_script,2016/03/21,ccc_waste_recycling_script,0,0,0:00:00,0,0:00:00,0,0
2016-03-22-ccc_311_calgary_script,2016/03/22,ccc_311_calgary_script,2938,2747,0:00:51,51,0:07:12,191,140097
2016-03-22-ccc_311_lobby_ph_script,2016/03/22,ccc_311_lobby_ph_script,1,0,0:00:00,0,0:00:00,1,0
2016-03-22-ccc_aserv_info_script,2016/03/22,ccc_aserv_info_script,0,0,0:00:00,0,0:00:00,0,0
2016-03-22-ccc_bylaw_script,2016/03/22,ccc_bylaw_script,0,0,0:00:00,0,0:00:00,0,0
2016-03-22-ccc_city_script,2016/03/22,ccc_city_script,13,12,0:00:18,18,0:00:55,1,216
2016-03-22-ccc_cty_online_script,2016/03/22,ccc_cty_online_script,0,0,0:00:00,0,0:00:00,0,0
2016-03-22-ccc_feedback_script,2016/03/22,ccc_feedback_script,0,0,0:00:00,0,0:00:00,0,0
2016-03-22-ccc_fpb_script,2016/03/22,ccc_fpb_script,0,0,0:00:00,0,0:00:00,0,0
2016-03-22-ccc_help_script,2016/03/22,ccc_help_script,12,11,0:00:11,11,0:00:32,1,121
2016-03-22-ccc_link_script,2016/03/22,ccc_link_script,0,0,0:00:00,0,0:00:00,0,0
2016-03-22-ccc_media_line_script,2016/03/22,ccc_media_line_script,1,1,0:00:06,6,0:00:06,0,6
2016-03-22-ccc_priority_script,2016/03/22,ccc_priority_script,33,33,0:00:15,15,0:01:15,0,495
2016-03-22-ccc_tax_script,2016/03/22,ccc_tax_script,15,13,0:00:37,37,0:02:51,2,481
2016-03-22-ccc_waste_recycling_script,2016/03/22,ccc_waste_recycling_script,0,0,0:00:00,0,0:00:00,0,0
2016-03-23-ccc_311_calgary_script,2016/03/23,ccc_311_calgary_script,3038,2804,0:00:57,57,0:12:05,234,159828
2016-03-23-ccc_311_lobby_ph_script,2016/03/23,ccc_311_lobby_ph_script,5,4,0:00:06,6,0:00:13,1,24
2016-03-23-ccc_aserv_info_script,2016/03/23,ccc_aserv_info_script,0,0,0:00:00,0,0:00:00,0,0
2016-03-23-ccc_bylaw_script,2016/03/23,ccc_bylaw_script,0,0,0:00:00,0,0:00:00,0,0
2016-03-23-ccc_city_script,2016/03/23,ccc_city_script,13,13,0:00:10,10,0:00:21,0,130
2016-03-23-ccc_cty_online_script,2016/03/23,ccc_cty_online_script,0,0,0:00:00,0,0:00:00,0,0
2016-03-23-ccc_feedback_script,2016/03/23,ccc_feedback_script,0,0,0:00:00,0,0:00:00,0,0
2016-03-23-ccc_fpb_script,2016/03/23,ccc_fpb_script,1,0,0:00:00,0,0:00:00,1,0
2016-03-23-ccc_help_script,2016/03/23,ccc_help_script,11,8,0:00:21,21,0:01:42,3,168
2016-03-23-ccc_link_script,2016/03/23,ccc_link_script,0,0,0:00:00,0,0:00:00,0,0
2016-03-23-ccc_media_line_script,2016/03/23,ccc_media_line_script,2,1,0:00:50,50,0:00:50,1,50
2016-03-23-ccc_priority_script,2016/03/23,ccc_priority_script,30,28,0:00:12,12,0:01:51,2,336
2016-03-23-ccc_tax_script,2016/03/23,ccc_tax_script,12,12,0:00:47,47,0:02:33,0,564
2016-03-23-ccc_waste_recycling_script,2016/03/23,ccc_waste_recycling_script,0,0,0:00:00,0,0:00:00,0,0
2016-03-24-ccc_311_calgary_script,2016/03/24,ccc_311_calgary_script,2949,2842,0:00:27,27,0:04:49,107,76734
2016-03-24-ccc_311_lobby_ph_script,2016/03/24,ccc_311_lobby_ph_script,1,1,0:00:02,2,0:00:02,0,2
2016-03-24-ccc_aserv_info_script,2016/03/24,ccc_aserv_info_script,0,0,0:00:00,0,0:00:00,0,0
2016-03-24-ccc_bylaw_script,2016/03/24,ccc_bylaw_script,0,0,0:00:00,0,0:00:00,0,0
2016-03-24-ccc_city_script,2016/03/24,ccc_city_script,13,13,0:00:17,17,0:00:44,0,221
2016-03-24-ccc_cty_online_script,2016/03/24,ccc_cty_online_script,0,0,0:00:00,0,0:00:00,0,0
2016-03-24-ccc_feedback_script,2016/03/24,ccc_feedback_script,0,0,0:00:00,0,0:00:00,0,0
2016-03-24-ccc_fpb_script,2016/03/24,ccc_fpb_script,0,0,0:00:00,0,0:00:00,0,0
2016-03-24-ccc_help_script,2016/03/24,ccc_help_script,19,17,0:00:17,17,0:00:57,2,289
2016-03-24-ccc_link_script,2016/03/24,ccc_link_script,0,0,0:00:00,0,0:00:00,0,0
2016-03-24-ccc_media_line_script,2016/03/24,ccc_media_line_script,1,1,0:00:02,2,0:00:02,0,2
2016-03-24-ccc_priority_script,2016/03/24,ccc_priority_script,24,24,0:00:10,10,0:00:28,0,240
2016-03-24-ccc_tax_script,2016/03/24,ccc_tax_script,17,15,0:00:40,40,0:03:08,2,600
2016-03-24-ccc_waste_recycling_script,2016/03/24,ccc_waste_recycling_script,0,0,0:00:00,0,0:00:00,0,0
2016-03-25-ccc_311_calgary_script,2016/03/25,ccc_311_calgary_script,1124,1108,0:00:07,7,0:05:05,16,7756
2016-03-25-ccc_311_lobby_ph_script,2016/03/25,ccc_311_lobby_ph_script,0,0,0:00:00,0,0:00:00,0,0
2016-03-25-ccc_aserv_info_script,2016/03/25,ccc_aserv_info_script,0,0,0:00:00,0,0:00:00,0,0
2016-03-25-ccc_bylaw_script,2016/03/25,ccc_bylaw_script,0,0,0:00:00,0,0:00:00,0,0
2016-03-25-ccc_city_script,2016/03/25,ccc_city_script,0,0,0:00:00,0,0:00:00,0,0
2016-03-25-ccc_cty_online_script,2016/03/25,ccc_cty_online_script,0,0,0:00:00,0,0:00:00,0,0
2016-03-25-ccc_feedback_script,2016/03/25,ccc_feedback_script,0,0,0:00:00,0,0:00:00,0,0
2016-03-25-ccc_fpb_script,2016/03/25,ccc_fpb_script,0,0,0:00:00,0,0:00:00,0,0
2016-03-25-ccc_help_script,2016/03/25,ccc_help_script,3,3,0:00:05,5,0:00:10,0,15
2016-03-25-ccc_link_script,2016/03/25,ccc_link_script,0,0,0:00:00,0,0:00:00,0,0
2016-03-25-ccc_media_line_script,2016/03/25,ccc_media_line_script,2,2,0:00:05,5,0:00:06,0,10
2016-03-25-ccc_priority_script,2016/03/25,ccc_priority_script,19,19,0:00:05,5,0:00:13,0,95
2016-03-25-ccc_tax_script,2016/03/25,ccc_tax_script,0,0,0:00:00,0,0:00:00,0,0
2016-03-25-ccc_waste_recycling_script,2016/03/25,ccc_waste_recycling_script,0,0,0:00:00,0,0:00:00,0,0
2016-03-26-ccc_311_calgary_script,2016/03/26,ccc_311_calgary_script,985,959,0:00:10,10,0:04:05,26,9590
2016-03-26-ccc_311_lobby_ph_script,2016/03/26,ccc_311_lobby_ph_script,0,0,0:00:00,0,0:00:00,0,0
2016-03-26-ccc_aserv_info_script,2016/03/26,ccc_aserv_info_script,0,0,0:00:00,0,0:00:00,0,0
2016-03-26-ccc_bylaw_script,2016/03/26,ccc_bylaw_script,0,0,0:00:00,0,0:00:00,0,0
2016-03-26-ccc_city_script,2016/03/26,ccc_city_script,0,0,0:00:00,0,0:00:00,0,0
2016-03-26-ccc_cty_online_script,2016/03/26,ccc_cty_online_script,0,0,0:00:00,0,0:00:00,0,0
2016-03-26-ccc_feedback_script,2016/03/26,ccc_feedback_script,0,0,0:00:00,0,0:00:00,0,0
2016-03-26-ccc_fpb_script,2016/03/26,ccc_fpb_script,0,0,0:00:00,0,0:00:00,0,0
2016-03-26-ccc_help_script,2016/03/26,ccc_help_script,0,0,0:00:00,0,0:00:00,0,0
2016-03-26-ccc_link_script,2016/03/26,ccc_link_script,0,0,0:00:00,0,0:00:00,0,0
2016-03-26-ccc_media_line_script,2016/03/26,ccc_media_line_script,0,0,0:00:00,0,0:00:00,0,0
2016-03-26-ccc_priority_script,2016/03/26,ccc_priority_script,15,15,0:00:07,7,0:00:11,0,105
2016-03-26-ccc_tax_script,2016/03/26,ccc_tax_script,2,2,0:00:05,5,0:00:06,0,10
2016-03-26-ccc_waste_recycling_script,2016/03/26,ccc_waste_recycling_script,0,0,0:00:00,0,0:00:00,0,0
2016-03-27-ccc_311_calgary_script,2016/03/27,ccc_311_calgary_script,702,691,0:00:08,8,0:03:39,11,5528
2016-03-27-ccc_311_lobby_ph_script,2016/03/27,ccc_311_lobby_ph_script,0,0,0:00:00,0,0:00:00,0,0
2016-03-27-ccc_aserv_info_script,2016/03/27,ccc_aserv_info_script,0,0,0:00:00,0,0:00:00,0,0
2016-03-27-ccc_bylaw_script,2016/03/27,ccc_bylaw_script,0,0,0:00:00,0,0:00:00,0,0
2016-03-27-ccc_city_script,2016/03/27,ccc_city_script,0,0,0:00:00,0,0:00:00,0,0
2016-03-27-ccc_cty_online_script,2016/03/27,ccc_cty_online_script,0,0,0:00:00,0,0:00:00,0,0
2016-03-27-ccc_feedback_script,2016/03/27,ccc_feedback_script,0,0,0:00:00,0,0:00:00,0,0
2016-03-27-ccc_fpb_script,2016/03/27,ccc_fpb_script,0,0,0:00:00,0,0:00:00,0,0
2016-03-27-ccc_help_script,2016/03/27,ccc_help_script,2,2,0:00:08,8,0:00:13,0,16
2016-03-27-ccc_link_script,2016/03/27,ccc_link_script,0,0,0:00:00,0,0:00:00,0,0
2016-03-27-ccc_media_line_script,2016/03/27,ccc_media_line_script,1,1,0:00:13,13,0:00:13,0,13
2016-03-27-ccc_priority_script,2016/03/27,ccc_priority_script,18,18,0:00:13,13,0:01:07,0,234
2016-03-27-ccc_tax_script,2016/03/27,ccc_tax_script,0,0,0:00:00,0,0:00:00,0,0
2016-03-27-ccc_waste_recycling_script,2016/03/27,ccc_waste_recycling_script,0,0,0:00:00,0,0:00:00,0,0
2016-03-28-ccc_311_calgary_script,2016/03/28,ccc_311_calgary_script,3090,3045,0:00:11,11,0:03:30,45,33495
2016-03-28-ccc_311_lobby_ph_script,2016/03/28,ccc_311_lobby_ph_script,1,1,0:00:04,4,0:00:04,0,4
2016-03-28-ccc_aserv_info_script,2016/03/28,ccc_aserv_info_script,0,0,0:00:00,0,0:00:00,0,0
2016-03-28-ccc_bylaw_script,2016/03/28,ccc_bylaw_script,2,2,0:00:08,8,0:00:12,0,16
2016-03-28-ccc_city_script,2016/03/28,ccc_city_script,30,30,0:00:11,11,0:02:14,0,330
2016-03-28-ccc_cty_online_script,2016/03/28,ccc_cty_online_script,0,0,0:00:00,0,0:00:00,0,0
2016-03-28-ccc_feedback_script,2016/03/28,ccc_feedback_script,2,0,0:00:00,0,0:00:00,0,0
2016-03-28-ccc_fpb_script,2016/03/28,ccc_fpb_script,0,0,0:00:00,0,0:00:00,0,0
2016-03-28-ccc_help_script,2016/03/28,ccc_help_script,4,4,0:00:13,13,0:00:31,0,52
2016-03-28-ccc_link_script,2016/03/28,ccc_link_script,0,0,0:00:00,0,0:00:00,0,0
2016-03-28-ccc_media_line_script,2016/03/28,ccc_media_line_script,0,0,0:00:00,0,0:00:00,0,0
2016-03-28-ccc_priority_script,2016/03/28,ccc_priority_script,20,19,0:00:06,6,0:00:13,1,114
2016-03-28-ccc_tax_script,2016/03/28,ccc_tax_script,2,2,0:00:09,9,0:00:10,0,18
2016-03-28-ccc_waste_recycling_script,2016/03/28,ccc_waste_recycling_script,0,0,0:00:00,0,0:00:00,0,0
2016-03-29-ccc_311_calgary_script,2016/03/29,ccc_311_calgary_script,3414,2958,0:01:45,105,0:08:24,456,310590
2016-03-29-ccc_311_lobby_ph_script,2016/03/29,ccc_311_lobby_ph_script,3,1,0:00:10,10,0:00:10,2,10
2016-03-29-ccc_aserv_info_script,2016/03/29,ccc_aserv_info_script,0,0,0:00:00,0,0:00:00,0,0
2016-03-29-ccc_bylaw_script,2016/03/29,ccc_bylaw_script,0,0,0:00:00,0,0:00:00,0,0
2016-03-29-ccc_city_script,2016/03/29,ccc_city_script,18,18,0:00:30,30,0:01:58,0,540
2016-03-29-ccc_cty_online_script,2016/03/29,ccc_cty_online_script,0,0,0:00:00,0,0:00:00,0,0
2016-03-29-ccc_feedback_script,2016/03/29,ccc_feedback_script,0,0,0:00:00,0,0:00:00,0,0
2016-03-29-ccc_fpb_script,2016/03/29,ccc_fpb_script,0,0,0:00:00,0,0:00:00,0,0
2016-03-29-ccc_help_script,2016/03/29,ccc_help_script,7,7,0:00:12,12,0:00:20,0,84
2016-03-29-ccc_link_script,2016/03/29,ccc_link_script,1,0,0:00:00,0,0:00:00,1,0
2016-03-29-ccc_media_line_script,2016/03/29,ccc_media_line_script,0,0,0:00:00,0,0:00:00,0,0
2016-03-29-ccc_priority_script,2016/03/29,ccc_priority_script,28,27,0:00:15,15,0:01:57,1,405
2016-03-29-ccc_tax_script,2016/03/29,ccc_tax_script,21,18,0:02:20,140,0:06:20,3,2520
2016-03-29-ccc_waste_recycling_script,2016/03/29,ccc_waste_recycling_script,0,0,0:00:00,0,0:00:00,0,0
2016-03-30-ccc_311_calgary_script,2016/03/30,ccc_311_calgary_script,3086,2867,0:00:44,44,0:04:58,219,126148
2016-03-30-ccc_311_lobby_ph_script,2016/03/30,ccc_311_lobby_ph_script,3,3,0:00:06,6,0:00:08,0,18
2016-03-30-ccc_aserv_info_script,2016/03/30,ccc_aserv_info_script,0,0,0:00:00,0,0:00:00,0,0
2016-03-30-ccc_bylaw_script,2016/03/30,ccc_bylaw_script,0,0,0:00:00,0,0:00:00,0,0
2016-03-30-ccc_city_script,2016/03/30,ccc_city_script,23,23,0:00:20,20,0:01:10,0,460
2016-03-30-ccc_cty_online_script,2016/03/30,ccc_cty_online_script,0,0,0:00:00,0,0:00:00,0,0
2016-03-30-ccc_feedback_script,2016/03/30,ccc_feedback_script,1,0,0:00:00,0,0:00:00,0,0
2016-03-30-ccc_fpb_script,2016/03/30,ccc_fpb_script,0,0,0:00:00,0,0:00:00,0,0
2016-03-30-ccc_help_script,2016/03/30,ccc_help_script,6,6,0:00:25,25,0:01:40,0,150
2016-03-30-ccc_link_script,2016/03/30,ccc_link_script,0,0,0:00:00,0,0:00:00,0,0
2016-03-30-ccc_media_line_script,2016/03/30,ccc_media_line_script,0,0,0:00:00,0,0:00:00,0,0
2016-03-30-ccc_priority_script,2016/03/30,ccc_priority_script,28,27,0:00:09,9,0:00:30,1,243
2016-03-30-ccc_tax_script,2016/03/30,ccc_tax_script,22,22,0:00:41,41,0:02:14,0,902
2016-03-30-ccc_waste_recycling_script,2016/03/30,ccc_waste_recycling_script,0,0,0:00:00,0,0:00:00,0,0
2016-03-31-ccc_311_calgary_script,2016/03/31,ccc_311_calgary_script,3199,2944,0:01:01,61,0:05:13,255,179584
2016-03-31-ccc_311_lobby_ph_script,2016/03/31,ccc_311_lobby_ph_script,6,4,0:00:07,7,0:00:13,2,28
2016-03-31-ccc_aserv_info_script,2016/03/31,ccc_aserv_info_script,0,0,0:00:00,0,0:00:00,0,0
2016-03-31-ccc_bylaw_script,2016/03/31,ccc_bylaw_script,0,0,0:00:00,0,0:00:00,0,0
2016-03-31-ccc_city_script,2016/03/31,ccc_city_script,14,13,0:00:14,14,0:00:55,1,182
2016-03-31-ccc_cty_online_script,2016/03/31,ccc_cty_online_script,0,0,0:00:00,0,0:00:00,0,0
2016-03-31-ccc_feedback_script,2016/03/31,ccc_feedback_script,1,0,0:00:00,0,0:00:00,0,0
2016-03-31-ccc_fpb_script,2016/03/31,ccc_fpb_script,1,0,0:00:00,0,0:00:00,1,0
2016-03-31-ccc_help_script,2016/03/31,ccc_help_script,20,16,0:00:05,5,0:00:15,4,80
2016-03-31-ccc_link_script,2016/03/31,ccc_link_script,0,0,0:00:00,0,0:00:00,0,0
2016-03-31-ccc_media_line_script,2016/03/31,ccc_media_line_script,0,0,0:00:00,0,0:00:00,0,0
2016-03-31-ccc_priority_script,2016/03/31,ccc_priority_script,33,33,0:00:13,13,0:01:11,0,429
2016-03-31-ccc_tax_script,2016/03/31,ccc_tax_script,24,20,0:00:57,57,0:02:49,4,1140
2016-03-31-ccc_waste_recycling_script,2016/03/31,ccc_waste_recycling_script,0,0,0:00:00,0,0:00:00,0,0
2016-04-01-ccc_311_calgary_script,2016/04/01,ccc_311_calgary_script,3162,2927,0:00:58,58,0:11:38,235,169766
2016-04-01-ccc_311_lobby_ph_script,2016/04/01,ccc_311_lobby_ph_script,4,4,0:00:11,11,0:00:13,0,44
2016-04-01-ccc_aserv_info_script,2016/04/01,ccc_aserv_info_script,0,0,0:00:00,0,0:00:00,0,0
2016-04-01-ccc_bylaw_script,2016/04/01,ccc_bylaw_script,0,0,0:00:00,0,0:00:00,0,0
2016-04-01-ccc_city_script,2016/04/01,ccc_city_script,24,21,0:00:15,15,0:01:30,3,315
2016-04-01-ccc_cty_online_script,2016/04/01,ccc_cty_online_script,0,0,0:00:00,0,0:00:00,0,0
2016-04-01-ccc_feedback_script,2016/04/01,ccc_feedback_script,0,0,0:00:00,0,0:00:00,0,0
2016-04-01-ccc_fpb_script,2016/04/01,ccc_fpb_script,0,0,0:00:00,0,0:00:00,0,0
2016-04-01-ccc_help_script,2016/04/01,ccc_help_script,15,14,0:00:14,14,0:00:51,1,196
2016-04-01-ccc_link_script,2016/04/01,ccc_link_script,0,0,0:00:00,0,0:00:00,0,0
2016-04-01-ccc_media_line_script,2016/04/01,ccc_media_line_script,3,3,0:00:06,6,0:00:10,0,18
2016-04-01-ccc_priority_script,2016/04/01,ccc_priority_script,25,24,0:00:17,17,0:01:17,1,408
2016-04-01-ccc_tax_script,2016/04/01,ccc_tax_script,15,14,0:01:35,95,0:06:19,1,1330
2016-04-01-ccc_waste_recycling_script,2016/04/01,ccc_waste_recycling_script,0,0,0:00:00,0,0:00:00,0,0
2016-04-02-ccc_311_calgary_script,2016/04/02,ccc_311_calgary_script,1460,1335,0:00:55,55,0:14:04,125,73425
2016-04-02-ccc_311_lobby_ph_script,2016/04/02,ccc_311_lobby_ph_script,0,0,0:00:00,0,0:00:00,0,0
2016-04-02-ccc_aserv_info_script,2016/04/02,ccc_aserv_info_script,0,0,0:00:00,0,0:00:00,0,0
2016-04-02-ccc_bylaw_script,2016/04/02,ccc_bylaw_script,0,0,0:00:00,0,0:00:00,0,0
2016-04-02-ccc_city_script,2016/04/02,ccc_city_script,0,0,0:00:00,0,0:00:00,0,0
2016-04-02-ccc_cty_online_script,2016/04/02,ccc_cty_online_script,0,0,0:00:00,0,0:00:00,0,0
2016-04-02-ccc_feedback_script,2016/04/02,ccc_feedback_script,0,0,0:00:00,0,0:00:00,0,0
2016-04-02-ccc_fpb_script,2016/04/02,ccc_fpb_script,0,0,0:00:00,0,0:00:00,0,0
2016-04-02-ccc_help_script,2016/04/02,ccc_help_script,10,10,0:00:44,44,0:03:36,0,440
2016-04-02-ccc_link_script,2016/04/02,ccc_link_script,0,0,0:00:00,0,0:00:00,0,0
2016-04-02-ccc_media_line_script,2016/04/02,ccc_media_line_script,0,0,0:00:00,0,0:00:00,0,0
2016-04-02-ccc_priority_script,2016/04/02,ccc_priority_script,21,20,0:00:09,9,0:00:32,1,180
2016-04-02-ccc_tax_script,2016/04/02,ccc_tax_script,7,7,0:01:41,101,0:05:21,0,707
2016-04-02-ccc_waste_recycling_script,2016/04/02,ccc_waste_recycling_script,0,0,0:00:00,0,0:00:00,0,0
2016-04-03-ccc_311_calgary_script,2016/04/03,ccc_311_calgary_script,1325,1220,0:00:47,47,0:10:33,105,57340
2016-04-03-ccc_311_lobby_ph_script,2016/04/03,ccc_311_lobby_ph_script,0,0,0:00:00,0,0:00:00,0,0
2016-04-03-ccc_aserv_info_script,2016/04/03,ccc_aserv_info_script,0,0,0:00:00,0,0:00:00,0,0
2016-04-03-ccc_bylaw_script,2016/04/03,ccc_bylaw_script,0,0,0:00:00,0,0:00:00,0,0
2016-04-03-ccc_city_script,2016/04/03,ccc_city_script,0,0,0:00:00,0,0:00:00,0,0
2016-04-03-ccc_cty_online_script,2016/04/03,ccc_cty_online_script,0,0,0:00:00,0,0:00:00,0,0
2016-04-03-ccc_feedback_script,2016/04/03,ccc_feedback_script,0,0,0:00:00,0,0:00:00,0,0
2016-04-03-ccc_fpb_script,2016/04/03,ccc_fpb_script,0,0,0:00:00,0,0:00:00,0,0
2016-04-03-ccc_help_script,2016/04/03,ccc_help_script,0,0,0:00:00,0,0:00:00,0,0
2016-04-03-ccc_link_script,2016/04/03,ccc_link_script,0,0,0:00:00,0,0:00:00,0,0
2016-04-03-ccc_media_line_script,2016/04/03,ccc_media_line_script,2,2,0:00:22,22,0:00:41,0,44
2016-04-03-ccc_priority_script,2016/04/03,ccc_priority_script,20,16,0:00:14,14,0:01:44,4,224
2016-04-03-ccc_tax_script,2016/04/03,ccc_tax_script,2,2,0:00:37,37,0:01:12,0,74
2016-04-03-ccc_waste_recycling_script,2016/04/03,ccc_waste_recycling_script,0,0,0:00:00,0,0:00:00,0,0
2016-04-04-ccc_311_calgary_script,2016/04/04,ccc_311_calgary_script,3577,3338,0:00:57,57,0:10:29,239,190266
2016-04-04-ccc_311_lobby_ph_script,2016/04/04,ccc_311_lobby_ph_script,4,4,0:00:12,12,0:00:32,0,48
2016-04-04-ccc_aserv_info_script,2016/04/04,ccc_aserv_info_script,0,0,0:00:00,0,0:00:00,0,0
2016-04-04-ccc_bylaw_script,2016/04/04,ccc_bylaw_script,0,0,0:00:00,0,0:00:00,0,0
2016-04-04-ccc_city_script,2016/04/04,ccc_city_script,15,15,0:00:05,5,0:00:14,0,75
2016-04-04-ccc_cty_online_script,2016/04/04,ccc_cty_online_script,0,0,0:00:00,0,0:00:00,0,0
2016-04-04-ccc_feedback_script,2016/04/04,ccc_feedback_script,0,0,0:00:00,0,0:00:00,0,0
2016-04-04-ccc_fpb_script,2016/04/04,ccc_fpb_script,0,0,0:00:00,0,0:00:00,0,0
2016-04-04-ccc_help_script,2016/04/04,ccc_help_script,9,8,0:00:12,12,0:00:45,1,96
2016-04-04-ccc_link_script,2016/04/04,ccc_link_script,0,0,0:00:00,0,0:00:00,0,0
2016-04-04-ccc_media_line_script,2016/04/04,ccc_media_line_script,1,1,0:00:11,11,0:00:11,0,11
2016-04-04-ccc_priority_script,2016/04/04,ccc_priority_script,28,26,0:00:14,14,0:01:48,2,364
2016-04-04-ccc_tax_script,2016/04/04,ccc_tax_script,25,24,0:00:21,21,0:01:24,1,504
2016-04-04-ccc_waste_recycling_script,2016/04/04,ccc_waste_recycling_script,0,0,0:00:00,0,0:00:00,0,0
2016-04-05-ccc_311_calgary_script,2016/04/05,ccc_311_calgary_script,3402,2976,0:01:44,104,0:10:31,426,309504
2016-04-05-ccc_311_lobby_ph_script,2016/04/05,ccc_311_lobby_ph_script,4,4,0:00:14,14,0:00:36,0,56
2016-04-05-ccc_aserv_info_script,2016/04/05,ccc_aserv_info_script,0,0,0:00:00,0,0:00:00,0,0
2016-04-05-ccc_bylaw_script,2016/04/05,ccc_bylaw_script,0,0,0:00:00,0,0:00:00,0,0
2016-04-05-ccc_city_script,2016/04/05,ccc_city_script,17,17,0:00:42,42,0:03:35,0,714
2016-04-05-ccc_cty_online_script,2016/04/05,ccc_cty_online_script,0,0,0:00:00,0,0:00:00,0,0
2016-04-05-ccc_feedback_script,2016/04/05,ccc_feedback_script,0,0,0:00:00,0,0:00:00,0,0
2016-04-05-ccc_fpb_script,2016/04/05,ccc_fpb_script,1,0,0:00:00,0,0:00:00,1,0
2016-04-05-ccc_help_script,2016/04/05,ccc_help_script,15,14,0:00:15,15,0:00:56,1,210
2016-04-05-ccc_link_script,2016/04/05,ccc_link_script,0,0,0:00:00,0,0:00:00,0,0
2016-04-05-ccc_media_line_script,2016/04/05,ccc_media_line_script,3,3,0:00:10,10,0:00:22,0,30
2016-04-05-ccc_priority_script,2016/04/05,ccc_priority_script,46,44,0:00:15,15,0:01:23,2,660
2016-04-05-ccc_tax_script,2016/04/05,ccc_tax_script,26,22,0:01:58,118,0:06:42,4,2596
2016-04-05-ccc_waste_recycling_script,2016/04/05,ccc_waste_recycling_script,0,0,0:00:00,0,0:00:00,0,0
2016-04-06-ccc_311_calgary_script,2016/04/06,ccc_311_calgary_script,3280,2941,0:01:13,73,0:10:39,339,214693
2016-04-06-ccc_311_lobby_ph_script,2016/04/06,ccc_311_lobby_ph_script,5,3,0:00:08,8,0:00:14,2,24
2016-04-06-ccc_aserv_info_script,2016/04/06,ccc_aserv_info_script,0,0,0:00:00,0,0:00:00,0,0
2016-04-06-ccc_bylaw_script,2016/04/06,ccc_bylaw_script,0,0,0:00:00,0,0:00:00,0,0
2016-04-06-ccc_city_script,2016/04/06,ccc_city_script,12,12,0:00:26,26,0:02:46,0,312
2016-04-06-ccc_cty_online_script,2016/04/06,ccc_cty_online_script,0,0,0:00:00,0,0:00:00,0,0
2016-04-06-ccc_feedback_script,2016/04/06,ccc_feedback_script,0,0,0:00:00,0,0:00:00,0,0
2016-04-06-ccc_fpb_script,2016/04/06,ccc_fpb_script,0,0,0:00:00,0,0:00:00,0,0
2016-04-06-ccc_help_script,2016/04/06,ccc_help_script,20,17,0:00:15,15,0:00:34,3,255
2016-04-06-ccc_link_script,2016/04/06,ccc_link_script,0,0,0:00:00,0,0:00:00,0,0
2016-04-06-ccc_media_line_script,2016/04/06,ccc_media_line_script,3,3,0:00:07,7,0:00:08,0,21
2016-04-06-ccc_priority_script,2016/04/06,ccc_priority_script,27,25,0:00:24,24,0:03:44,2,600
2016-04-06-ccc_tax_script,2016/04/06,ccc_tax_script,21,20,0:01:13,73,0:03:55,1,1460
2016-04-06-ccc_waste_recycling_script,2016/04/06,ccc_waste_recycling_script,0,0,0:00:00,0,0:00:00,0,0
2016-04-07-ccc_311_calgary_script,2016/04/07,ccc_311_calgary_script,3427,3155,0:00:59,59,0:21:07,272,186145
2016-04-07-ccc_311_lobby_ph_script,2016/04/07,ccc_311_lobby_ph_script,6,6,0:00:10,10,0:00:31,0,60
2016-04-07-ccc_aserv_info_script,2016/04/07,ccc_aserv_info_script,0,0,0:00:00,0,0:00:00,0,0
2016-04-07-ccc_bylaw_script,2016/04/07,ccc_bylaw_script,0,0,0:00:00,0,0:00:00,0,0
2016-04-07-ccc_city_script,2016/04/07,ccc_city_script,14,14,0:00:07,7,0:00:21,0,98
2016-04-07-ccc_cty_online_script,2016/04/07,ccc_cty_online_script,0,0,0:00:00,0,0:00:00,0,0
2016-04-07-ccc_feedback_script,2016/04/07,ccc_feedback_script,0,0,0:00:00,0,0:00:00,0,0
2016-04-07-ccc_fpb_script,2016/04/07,ccc_fpb_script,1,1,0:00:02,2,0:00:02,0,2
2016-04-07-ccc_help_script,2016/04/07,ccc_help_script,19,18,0:00:15,15,0:00:46,1,270
2016-04-07-ccc_link_script,2016/04/07,ccc_link_script,0,0,0:00:00,0,0:00:00,0,0
2016-04-07-ccc_media_line_script,2016/04/07,ccc_media_line_script,0,0,0:00:00,0,0:00:00,0,0
2016-04-07-ccc_priority_script,2016/04/07,ccc_priority_script,40,39,0:00:19,19,0:03:17,1,741
2016-04-07-ccc_tax_script,2016/04/07,ccc_tax_script,21,20,0:00:51,51,0:03:30,1,1020
2016-04-07-ccc_waste_recycling_script,2016/04/07,ccc_waste_recycling_script,0,0,0:00:00,0,0:00:00,0,0
2016-04-08-ccc_311_calgary_script,2016/04/08,ccc_311_calgary_script,3154,2976,0:00:33,33,0:08:51,178,98208
2016-04-08-ccc_311_lobby_ph_script,2016/04/08,ccc_311_lobby_ph_script,3,3,0:00:05,5,0:00:06,0,15
2016-04-08-ccc_aserv_info_script,2016/04/08,ccc_aserv_info_script,0,0,0:00:00,0,0:00:00,0,0
2016-04-08-ccc_bylaw_script,2016/04/08,ccc_bylaw_script,0,0,0:00:00,0,0:00:00,0,0
2016-04-08-ccc_city_script,2016/04/08,ccc_city_script,23,23,0:00:07,7,0:00:22,0,161
2016-04-08-ccc_cty_online_script,2016/04/08,ccc_cty_online_script,0,0,0:00:00,0,0:00:00,0,0
2016-04-08-ccc_feedback_script,2016/04/08,ccc_feedback_script,1,0,0:00:00,0,0:00:00,0,0
2016-04-08-ccc_fpb_script,2016/04/08,ccc_fpb_script,0,0,0:00:00,0,0:00:00,0,0
2016-04-08-ccc_help_script,2016/04/08,ccc_help_script,18,15,0:00:11,11,0:00:42,3,165
2016-04-08-ccc_link_script,2016/04/08,ccc_link_script,0,0,0:00:00,0,0:00:00,0,0
2016-04-08-ccc_media_line_script,2016/04/08,ccc_media_line_script,1,1,0:00:11,11,0:00:11,0,11
2016-04-08-ccc_priority_script,2016/04/08,ccc_priority_script,33,31,0:00:12,12,0:01:03,2,372
2016-04-08-ccc_tax_script,2016/04/08,ccc_tax_script,13,13,0:00:19,19,0:02:20,0,247
2016-04-08-ccc_waste_recycling_script,2016/04/08,ccc_waste_recycling_script,0,0,0:00:00,0,0:00:00,0,0
2016-04-09-ccc_311_calgary_script,2016/04/09,ccc_311_calgary_script,1413,1222,0:01:40,100,0:11:50,191,122200
2016-04-09-ccc_311_lobby_ph_script,2016/04/09,ccc_311_lobby_ph_script,0,0,0:00:00,0,0:00:00,0,0
2016-04-09-ccc_aserv_info_script,2016/04/09,ccc_aserv_info_script,0,0,0:00:00,0,0:00:00,0,0
2016-04-09-ccc_bylaw_script,2016/04/09,ccc_bylaw_script,0,0,0:00:00,0,0:00:00,0,0
2016-04-09-ccc_city_script,2016/04/09,ccc_city_script,0,0,0:00:00,0,0:00:00,0,0
2016-04-09-ccc_cty_online_script,2016/04/09,ccc_cty_online_script,0,0,0:00:00,0,0:00:00,0,0
2016-04-09-ccc_feedback_script,2016/04/09,ccc_feedback_script,0,0,0:00:00,0,0:00:00,0,0
2016-04-09-ccc_fpb_script,2016/04/09,ccc_fpb_script,0,0,0:00:00,0,0:00:00,0,0
2016-04-09-ccc_help_script,2016/04/09,ccc_help_script,1,1,0:01:24,84,0:01:24,0,84
2016-04-09-ccc_link_script,2016/04/09,ccc_link_script,0,0,0:00:00,0,0:00:00,0,0
2016-04-09-ccc_media_line_script,2016/04/09,ccc_media_line_script,0,0,0:00:00,0,0:00:00,0,0
2016-04-09-ccc_priority_script,2016/04/09,ccc_priority_script,24,21,0:00:10,10,0:01:04,3,210
2016-04-09-ccc_tax_script,2016/04/09,ccc_tax_script,2,2,0:05:19,319,0:10:36,0,638
2016-04-09-ccc_waste_recycling_script,2016/04/09,ccc_waste_recycling_script,0,0,0:00:00,0,0:00:00,0,0
2016-04-10-ccc_311_calgary_script,2016/04/10,ccc_311_calgary_script,1099,1034,0:00:33,33,0:06:27,65,34122
2016-04-10-ccc_311_lobby_ph_script,2016/04/10,ccc_311_lobby_ph_script,0,0,0:00:00,0,0:00:00,0,0
2016-04-10-ccc_aserv_info_script,2016/04/10,ccc_aserv_info_script,0,0,0:00:00,0,0:00:00,0,0
2016-04-10-ccc_bylaw_script,2016/04/10,ccc_bylaw_script,0,0,0:00:00,0,0:00:00,0,0
2016-04-10-ccc_city_script,2016/04/10,ccc_city_script,0,0,0:00:00,0,0:00:00,0,0
2016-04-10-ccc_cty_online_script,2016/04/10,ccc_cty_online_script,0,0,0:00:00,0,0:00:00,0,0
2016-04-10-ccc_feedback_script,2016/04/10,ccc_feedback_script,0,0,0:00:00,0,0:00:00,0,0
2016-04-10-ccc_fpb_script,2016/04/10,ccc_fpb_script,0,0,0:00:00,0,0:00:00,0,0
2016-04-10-ccc_help_script,2016/04/10,ccc_help_script,2,2,0:01:35,95,0:03:05,0,190
2016-04-10-ccc_link_script,2016/04/10,ccc_link_script,0,0,0:00:00,0,0:00:00,0,0
2016-04-10-ccc_media_line_script,2016/04/10,ccc_media_line_script,3,3,0:00:04,4,0:00:05,0,12
2016-04-10-ccc_priority_script,2016/04/10,ccc_priority_script,11,11,0:00:08,8,0:00:22,0,88
2016-04-10-ccc_tax_script,2016/04/10,ccc_tax_script,0,0,0:00:00,0,0:00:00,0,0
2016-04-10-ccc_waste_recycling_script,2016/04/10,ccc_waste_recycling_script,0,0,0:00:00,0,0:00:00,0,0
2016-04-11-ccc_311_calgary_script,2016/04/11,ccc_311_calgary_script,3570,3465,0:00:26,26,0:07:37,105,90090
2016-04-11-ccc_311_lobby_ph_script,2016/04/11,ccc_311_lobby_ph_script,4,4,0:00:04,4,0:00:06,0,16
2016-04-11-ccc_aserv_info_script,2016/04/11,ccc_aserv_info_script,0,0,0:00:00,0,0:00:00,0,0
2016-04-11-ccc_bylaw_script,2016/04/11,ccc_bylaw_script,0,0,0:00:00,0,0:00:00,0,0
2016-04-11-ccc_city_script,2016/04/11,ccc_city_script,30,30,0:00:13,13,0:01:51,0,390
2016-04-11-ccc_cty_online_script,2016/04/11,ccc_cty_online_script,0,0,0:00:00,0,0:00:00,0,0
2016-04-11-ccc_feedback_script,2016/04/11,ccc_feedback_script,0,0,0:00:00,0,0:00:00,0,0
2016-04-11-ccc_fpb_script,2016/04/11,ccc_fpb_script,0,0,0:00:00,0,0:00:00,0,0
2016-04-11-ccc_help_script,2016/04/11,ccc_help_script,16,15,0:00:10,10,0:00:33,1,150
2016-04-11-ccc_link_script,2016/04/11,ccc_link_script,0,0,0:00:00,0,0:00:00,0,0
2016-04-11-ccc_media_line_script,2016/04/11,ccc_media_line_script,1,1,0:00:02,2,0:00:02,0,2
2016-04-11-ccc_priority_script,2016/04/11,ccc_priority_script,28,24,0:00:07,7,0:00:45,4,168
2016-04-11-ccc_tax_script,2016/04/11,ccc_tax_script,25,24,0:00:28,28,0:02:13,1,672
2016-04-11-ccc_waste_recycling_script,2016/04/11,ccc_waste_recycling_script,0,0,0:00:00,0,0:00:00,0,0
2016-04-12-ccc_311_calgary_script,2016/04/12,ccc_311_calgary_script,3391,3084,0:01:22,82,0:07:08,307,252888
2016-04-12-ccc_311_lobby_ph_script,2016/04/12,ccc_311_lobby_ph_script,0,0,0:00:00,0,0:00:00,0,0
2016-04-12-ccc_aserv_info_script,2016/04/12,ccc_aserv_info_script,0,0,0:00:00,0,0:00:00,0,0
2016-04-12-ccc_bylaw_script,2016/04/12,ccc_bylaw_script,0,0,0:00:00,0,0:00:00,0,0
2016-04-12-ccc_city_script,2016/04/12,ccc_city_script,45,44,0:00:39,39,0:04:02,1,1716
2016-04-12-ccc_cty_online_script,2016/04/12,ccc_cty_online_script,0,0,0:00:00,0,0:00:00,0,0
2016-04-12-ccc_feedback_script,2016/04/12,ccc_feedback_script,1,0,0:00:00,0,0:00:00,0,0
2016-04-12-ccc_fpb_script,2016/04/12,ccc_fpb_script,1,1,0:05:26,326,0:05:26,0,326
2016-04-12-ccc_help_script,2016/04/12,ccc_help_script,11,10,0:00:17,17,0:00:51,1,170
2016-04-12-ccc_link_script,2016/04/12,ccc_link_script,0,0,0:00:00,0,0:00:00,0,0
2016-04-12-ccc_media_line_script,2016/04/12,ccc_media_line_script,0,0,0:00:00,0,0:00:00,0,0
2016-04-12-ccc_priority_script,2016/04/12,ccc_priority_script,35,34,0:00:12,12,0:00:58,1,408
2016-04-12-ccc_tax_script,2016/04/12,ccc_tax_script,22,20,0:02:08,128,0:06:16,2,2560
2016-04-12-ccc_waste_recycling_script,2016/04/12,ccc_waste_recycling_script,0,0,0:00:00,0,0:00:00,0,0
2016-04-13-ccc_311_calgary_script,2016/04/13,ccc_311_calgary_script,3635,3073,0:02:24,144,0:11:00,562,442512
2016-04-13-ccc_311_lobby_ph_script,2016/04/13,ccc_311_lobby_ph_script,1,1,0:00:11,11,0:00:11,0,11
2016-04-13-ccc_aserv_info_script,2016/04/13,ccc_aserv_info_script,0,0,0:00:00,0,0:00:00,0,0
2016-04-13-ccc_bylaw_script,2016/04/13,ccc_bylaw_script,0,0,0:00:00,0,0:00:00,0,0
2016-04-13-ccc_city_script,2016/04/13,ccc_city_script,25,23,0:00:49,49,0:03:49,2,1127
2016-04-13-ccc_cty_online_script,2016/04/13,ccc_cty_online_script,0,0,0:00:00,0,0:00:00,0,0
2016-04-13-ccc_feedback_script,2016/04/13,ccc_feedback_script,0,0,0:00:00,0,0:00:00,0,0
2016-04-13-ccc_fpb_script,2016/04/13,ccc_fpb_script,1,0,0:00:00,0,0:00:00,1,0
2016-04-13-ccc_help_script,2016/04/13,ccc_help_script,33,26,0:00:15,15,0:00:59,7,390
2016-04-13-ccc_link_script,2016/04/13,ccc_link_script,0,0,0:00:00,0,0:00:00,0,0
2016-04-13-ccc_media_line_script,2016/04/13,ccc_media_line_script,0,0,0:00:00,0,0:00:00,0,0
2016-04-13-ccc_priority_script,2016/04/13,ccc_priority_script,24,23,0:00:17,17,0:01:15,1,391
2016-04-13-ccc_tax_script,2016/04/13,ccc_tax_script,17,13,0:02:56,176,0:08:28,4,2288
2016-04-13-ccc_waste_recycling_script,2016/04/13,ccc_waste_recycling_script,0,0,0:00:00,0,0:00:00,0,0
2016-04-14-ccc_311_calgary_script,2016/04/14,ccc_311_calgary_script,3143,3038,0:00:24,24,0:08:30,105,72912
2016-04-14-ccc_311_lobby_ph_script,2016/04/14,ccc_311_lobby_ph_script,8,7,0:00:10,10,0:00:18,1,70
2016-04-14-ccc_aserv_info_script,2016/04/14,ccc_aserv_info_script,0,0,0:00:00,0,0:00:00,0,0
2016-04-14-ccc_bylaw_script,2016/04/14,ccc_bylaw_script,0,0,0:00:00,0,0:00:00,0,0
2016-04-14-ccc_city_script,2016/04/14,ccc_city_script,28,27,0:00:13,13,0:01:01,1,351
2016-04-14-ccc_cty_online_script,2016/04/14,ccc_cty_online_script,0,0,0:00:00,0,0:00:00,0,0
2016-04-14-ccc_feedback_script,2016/04/14,ccc_feedback_script,0,0,0:00:00,0,0:00:00,0,0
2016-04-14-ccc_fpb_script,2016/04/14,ccc_fpb_script,1,1,0:00:08,8,0:00:08,0,8
2016-04-14-ccc_help_script,2016/04/14,ccc_help_script,16,16,0:00:12,12,0:00:40,0,192
2016-04-14-ccc_link_script,2016/04/14,ccc_link_script,0,0,0:00:00,0,0:00:00,0,0
2016-04-14-ccc_media_line_script,2016/04/14,ccc_media_line_script,0,0,0:00:00,0,0:00:00,0,0
2016-04-14-ccc_priority_script,2016/04/14,ccc_priority_script,22,21,0:00:08,8,0:00:35,1,168
2016-04-14-ccc_tax_script,2016/04/14,ccc_tax_script,21,20,0:00:29,29,0:01:46,1,580
2016-04-14-ccc_waste_recycling_script,2016/04/14,ccc_waste_recycling_script,0,0,0:00:00,0,0:00:00,0,0
2016-04-15-ccc_311_calgary_script,2016/04/15,ccc_311_calgary_script,3159,2758,0:01:49,109,0:10:06,401,300622
2016-04-15-ccc_311_lobby_ph_script,2016/04/15,ccc_311_lobby_ph_script,4,3,0:00:20,20,0:00:34,1,60
2016-04-15-ccc_aserv_info_script,2016/04/15,ccc_aserv_info_script,0,0,0:00:00,0,0:00:00,0,0
2016-04-15-ccc_bylaw_script,2016/04/15,ccc_bylaw_script,0,0,0:00:00,0,0:00:00,0,0
2016-04-15-ccc_city_script,2016/04/15,ccc_city_script,16,16,0:00:39,39,0:05:43,0,624
2016-04-15-ccc_cty_online_script,2016/04/15,ccc_cty_online_script,0,0,0:00:00,0,0:00:00,0,0
2016-04-15-ccc_feedback_script,2016/04/15,ccc_feedback_script,0,0,0:00:00,0,0:00:00,0,0
2016-04-15-ccc_fpb_script,2016/04/15,ccc_fpb_script,1,0,0:00:00,0,0:00:00,1,0
2016-04-15-ccc_help_script,2016/04/15,ccc_help_script,10,9,0:00:17,17,0:00:52,1,153
2016-04-15-ccc_link_script,2016/04/15,ccc_link_script,1,0,0:00:00,0,0:00:00,0,0
2016-04-15-ccc_media_line_script,2016/04/15,ccc_media_line_script,2,2,0:00:10,10,0:00:13,0,20
2016-04-15-ccc_priority_script,2016/04/15,ccc_priority_script,28,27,0:00:11,11,0:01:08,1,297
2016-04-15-ccc_tax_script,2016/04/15,ccc_tax_script,26,25,0:01:47,107,0:08:38,1,2675
2016-04-15-ccc_waste_recycling_script,2016/04/15,ccc_waste_recycling_script,0,0,0:00:00,0,0:00:00,0,0
2016-04-16-ccc_311_calgary_script,2016/04/16,ccc_311_calgary_script,1353,1284,0:00:37,37,0:08:47,69,47508
2016-04-16-ccc_311_lobby_ph_script,2016/04/16,ccc_311_lobby_ph_script,0,0,0:00:00,0,0:00:00,0,0
2016-04-16-ccc_aserv_info_script,2016/04/16,ccc_aserv_info_script,0,0,0:00:00,0,0:00:00,0,0
2016-04-16-ccc_bylaw_script,2016/04/16,ccc_bylaw_script,0,0,0:00:00,0,0:00:00,0,0
2016-04-16-ccc_city_script,2016/04/16,ccc_city_script,0,0,0:00:00,0,0:00:00,0,0
2016-04-16-ccc_cty_online_script,2016/04/16,ccc_cty_online_script,0,0,0:00:00,0,0:00:00,0,0
2016-04-16-ccc_feedback_script,2016/04/16,ccc_feedback_script,0,0,0:00:00,0,0:00:00,0,0
2016-04-16-ccc_fpb_script,2016/04/16,ccc_fpb_script,0,0,0:00:00,0,0:00:00,0,0
2016-04-16-ccc_help_script,2016/04/16,ccc_help_script,2,1,0:00:08,8,0:00:08,1,8
2016-04-16-ccc_link_script,2016/04/16,ccc_link_script,0,0,0:00:00,0,0:00:00,0,0
2016-04-16-ccc_media_line_script,2016/04/16,ccc_media_line_script,0,0,0:00:00,0,0:00:00,0,0
2016-04-16-ccc_priority_script,2016/04/16,ccc_priority_script,19,18,0:00:19,19,0:02:09,1,342
2016-04-16-ccc_tax_script,2016/04/16,ccc_tax_script,3,3,0:01:10,70,0:03:24,0,210
2016-04-16-ccc_waste_recycling_script,2016/04/16,ccc_waste_recycling_script,0,0,0:00:00,0,0:00:00,0,0
2016-04-17-ccc_311_calgary_script,2016/04/17,ccc_311_calgary_script,1251,1165,0:00:45,45,0:08:13,86,52425
2016-04-17-ccc_311_lobby_ph_script,2016/04/17,ccc_311_lobby_ph_script,0,0,0:00:00,0,0:00:00,0,0
2016-04-17-ccc_aserv_info_script,2016/04/17,ccc_aserv_info_script,0,0,0:00:00,0,0:00:00,0,0
2016-04-17-ccc_bylaw_script,2016/04/17,ccc_bylaw_script,0,0,0:00:00,0,0:00:00,0,0
2016-04-17-ccc_city_script,2016/04/17,ccc_city_script,0,0,0:00:00,0,0:00:00,0,0
2016-04-17-ccc_cty_online_script,2016/04/17,ccc_cty_online_script,0,0,0:00:00,0,0:00:00,0,0
2016-04-17-ccc_feedback_script,2016/04/17,ccc_feedback_script,0,0,0:00:00,0,0:00:00,0,0
2016-04-17-ccc_fpb_script,2016/04/17,ccc_fpb_script,0,0,0:00:00,0,0:00:00,0,0
2016-04-17-ccc_help_script,2016/04/17,ccc_help_script,3,2,0:00:08,8,0:00:10,1,16
2016-04-17-ccc_link_script,2016/04/17,ccc_link_script,0,0,0:00:00,0,0:00:00,0,0
2016-04-17-ccc_media_line_script,2016/04/17,ccc_media_line_script,2,2,0:00:05,5,0:00:08,0,10
2016-04-17-ccc_priority_script,2016/04/17,ccc_priority_script,25,24,0:00:18,18,0:01:24,1,432
2016-04-17-ccc_tax_script,2016/04/17,ccc_tax_script,3,3,0:00:17,17,0:00:45,0,51
2016-04-17-ccc_waste_recycling_script,2016/04/17,ccc_waste_recycling_script,0,0,0:00:00,0,0:00:00,0,0
2016-04-18-ccc_311_calgary_script,2016/04/18,ccc_311_calgary_script,3964,3603,0:01:19,79,0:06:49,361,284637
2016-04-18-ccc_311_lobby_ph_script,2016/04/18,ccc_311_lobby_ph_script,3,3,0:00:15,15,0:00:18,0,45
2016-04-18-ccc_aserv_info_script,2016/04/18,ccc_aserv_info_script,0,0,0:00:00,0,0:00:00,0,0
2016-04-18-ccc_bylaw_script,2016/04/18,ccc_bylaw_script,0,0,0:00:00,0,0:00:00,0,0
2016-04-18-ccc_city_script,2016/04/18,ccc_city_script,13,13,0:00:39,39,0:03:48,0,507
2016-04-18-ccc_cty_online_script,2016/04/18,ccc_cty_online_script,0,0,0:00:00,0,0:00:00,0,0
2016-04-18-ccc_feedback_script,2016/04/18,ccc_feedback_script,0,0,0:00:00,0,0:00:00,0,0
2016-04-18-ccc_fpb_script,2016/04/18,ccc_fpb_script,2,1,0:00:02,2,0:00:02,1,2
2016-04-18-ccc_help_script,2016/04/18,ccc_help_script,32,26,0:00:12,12,0:00:36,6,312
2016-04-18-ccc_link_script,2016/04/18,ccc_link_script,0,0,0:00:00,0,0:00:00,0,0
2016-04-18-ccc_media_line_script,2016/04/18,ccc_media_line_script,1,1,0:00:07,7,0:00:07,0,7
2016-04-18-ccc_priority_script,2016/04/18,ccc_priority_script,27,26,0:00:12,12,0:01:05,1,312
2016-04-18-ccc_tax_script,2016/04/18,ccc_tax_script,20,19,0:01:29,89,0:05:22,1,1691
2016-04-18-ccc_waste_recycling_script,2016/04/18,ccc_waste_recycling_script,0,0,0:00:00,0,0:00:00,0,0
2016-04-19-ccc_311_calgary_script,2016/04/19,ccc_311_calgary_script,3889,3498,0:01:23,83,0:11:44,391,290334
2016-04-19-ccc_311_lobby_ph_script,2016/04/19,ccc_311_lobby_ph_script,5,5,0:00:08,8,0:00:29,0,40
2016-04-19-ccc_aserv_info_script,2016/04/19,ccc_aserv_info_script,0,0,0:00:00,0,0:00:00,0,0
2016-04-19-ccc_bylaw_script,2016/04/19,ccc_bylaw_script,0,0,0:00:00,0,0:00:00,0,0
2016-04-19-ccc_city_script,2016/04/19,ccc_city_script,11,11,0:00:16,16,0:00:39,0,176
2016-04-19-ccc_cty_online_script,2016/04/19,ccc_cty_online_script,0,0,0:00:00,0,0:00:00,0,0
2016-04-19-ccc_feedback_script,2016/04/19,ccc_feedback_script,0,0,0:00:00,0,0:00:00,0,0
2016-04-19-ccc_fpb_script,2016/04/19,ccc_fpb_script,1,1,0:01:48,108,0:01:48,0,108
2016-04-19-ccc_help_script,2016/04/19,ccc_help_script,20,18,0:00:18,18,0:00:55,2,324
2016-04-19-ccc_link_script,2016/04/19,ccc_link_script,0,0,0:00:00,0,0:00:00,0,0
2016-04-19-ccc_media_line_script,2016/04/19,ccc_media_line_script,0,0,0:00:00,0,0:00:00,0,0
2016-04-19-ccc_priority_script,2016/04/19,ccc_priority_script,27,27,0:00:12,12,0:00:52,0,324
2016-04-19-ccc_tax_script,2016/04/19,ccc_tax_script,19,17,0:01:34,94,0:04:29,2,1598
2016-04-19-ccc_waste_recycling_script,2016/04/19,ccc_waste_recycling_script,0,0,0:00:00,0,0:00:00,0,0
2016-04-20-ccc_311_calgary_script,2016/04/20,ccc_311_calgary_script,3647,3371,0:01:11,71,0:09:44,276,239341
2016-04-20-ccc_311_lobby_ph_script,2016/04/20,ccc_311_lobby_ph_script,4,4,0:00:05,5,0:00:08,0,20
2016-04-20-ccc_aserv_info_script,2016/04/20,ccc_aserv_info_script,0,0,0:00:00,0,0:00:00,0,0
2016-04-20-ccc_bylaw_script,2016/04/20,ccc_bylaw_script,0,0,0:00:00,0,0:00:00,0,0
2016-04-20-ccc_city_script,2016/04/20,ccc_city_script,18,18,0:00:10,10,0:00:31,0,180
2016-04-20-ccc_cty_online_script,2016/04/20,ccc_cty_online_script,0,0,0:00:00,0,0:00:00,0,0
2016-04-20-ccc_feedback_script,2016/04/20,ccc_feedback_script,0,0,0:00:00,0,0:00:00,0,0
2016-04-20-ccc_fpb_script,2016/04/20,ccc_fpb_script,0,0,0:00:00,0,0:00:00,0,0
2016-04-20-ccc_help_script,2016/04/20,ccc_help_script,22,21,0:00:14,14,0:01:12,1,294
2016-04-20-ccc_link_script,2016/04/20,ccc_link_script,0,0,0:00:00,0,0:00:00,0,0
2016-04-20-ccc_media_line_script,2016/04/20,ccc_media_line_script,1,1,0:00:30,30,0:00:30,0,30
2016-04-20-ccc_priority_script,2016/04/20,ccc_priority_script,37,36,0:00:12,12,0:00:45,1,432
2016-04-20-ccc_tax_script,2016/04/20,ccc_tax_script,18,17,0:00:49,49,0:02:20,1,833
2016-04-20-ccc_waste_recycling_script,2016/04/20,ccc_waste_recycling_script,0,0,0:00:00,0,0:00:00,0,0
2016-04-21-ccc_311_calgary_script,2016/04/21,ccc_311_calgary_script,3442,3193,0:00:55,55,0:13:03,249,175615
2016-04-21-ccc_311_lobby_ph_script,2016/04/21,ccc_311_lobby_ph_script,0,0,0:00:00,0,0:00:00,0,0
2016-04-21-ccc_aserv_info_script,2016/04/21,ccc_aserv_info_script,0,0,0:00:00,0,0:00:00,0,0
2016-04-21-ccc_bylaw_script,2016/04/21,ccc_bylaw_script,0,0,0:00:00,0,0:00:00,0,0
2016-04-21-ccc_city_script,2016/04/21,ccc_city_script,19,17,0:00:13,13,0:00:38,2,221
2016-04-21-ccc_cty_online_script,2016/04/21,ccc_cty_online_script,0,0,0:00:00,0,0:00:00,0,0
2016-04-21-ccc_feedback_script,2016/04/21,ccc_feedback_script,0,0,0:00:00,0,0:00:00,0,0
2016-04-21-ccc_fpb_script,2016/04/21,ccc_fpb_script,1,1,0:00:04,4,0:00:04,0,4
2016-04-21-ccc_help_script,2016/04/21,ccc_help_script,51,49,0:00:21,21,0:01:09,2,1029
2016-04-21-ccc_link_script,2016/04/21,ccc_link_script,0,0,0:00:00,0,0:00:00,0,0
2016-04-21-ccc_media_line_script,2016/04/21,ccc_media_line_script,0,0,0:00:00,0,0:00:00,0,0
2016-04-21-ccc_priority_script,2016/04/21,ccc_priority_script,25,23,0:00:14,14,0:00:59,2,322
2016-04-21-ccc_tax_script,2016/04/21,ccc_tax_script,15,12,0:01:07,67,0:03:03,3,804
2016-04-21-ccc_waste_recycling_script,2016/04/21,ccc_waste_recycling_script,0,0,0:00:00,0,0:00:00,0,0
2016-04-22-ccc_311_calgary_script,2016/04/22,ccc_311_calgary_script,3111,2819,0:01:29,89,0:10:51,292,250891
2016-04-22-ccc_311_lobby_ph_script,2016/04/22,ccc_311_lobby_ph_script,2,1,0:00:45,45,0:00:45,1,45
2016-04-22-ccc_aserv_info_script,2016/04/22,ccc_aserv_info_script,0,0,0:00:00,0,0:00:00,0,0
2016-04-22-ccc_bylaw_script,2016/04/22,ccc_bylaw_script,0,0,0:00:00,0,0:00:00,0,0
2016-04-22-ccc_city_script,2016/04/22,ccc_city_script,13,13,0:00:37,37,0:04:39,0,481
2016-04-22-ccc_cty_online_script,2016/04/22,ccc_cty_online_script,0,0,0:00:00,0,0:00:00,0,0
2016-04-22-ccc_feedback_script,2016/04/22,ccc_feedback_script,0,0,0:00:00,0,0:00:00,0,0
2016-04-22-ccc_fpb_script,2016/04/22,ccc_fpb_script,1,0,0:00:00,0,0:00:00,1,0
2016-04-22-ccc_help_script,2016/04/22,ccc_help_script,38,35,0:00:19,19,0:02:23,3,665
2016-04-22-ccc_link_script,2016/04/22,ccc_link_script,0,0,0:00:00,0,0:00:00,0,0
2016-04-22-ccc_media_line_script,2016/04/22,ccc_media_line_script,4,3,0:00:11,11,0:00:13,1,33
2016-04-22-ccc_priority_script,2016/04/22,ccc_priority_script,22,20,0:00:10,10,0:00:25,2,200
2016-04-22-ccc_tax_script,2016/04/22,ccc_tax_script,21,15,0:02:32,152,0:10:19,6,2280
2016-04-22-ccc_waste_recycling_script,2016/04/22,ccc_waste_recycling_script,0,0,0:00:00,0,0:00:00,0,0
2016-04-23-ccc_311_calgary_script,2016/04/23,ccc_311_calgary_script,1201,1110,0:00:53,53,0:11:18,91,58830
2016-04-23-ccc_311_lobby_ph_script,2016/04/23,ccc_311_lobby_ph_script,0,0,0:00:00,0,0:00:00,0,0
2016-04-23-ccc_aserv_info_script,2016/04/23,ccc_aserv_info_script,0,0,0:00:00,0,0:00:00,0,0
2016-04-23-ccc_bylaw_script,2016/04/23,ccc_bylaw_script,0,0,0:00:00,0,0:00:00,0,0
2016-04-23-ccc_city_script,2016/04/23,ccc_city_script,0,0,0:00:00,0,0:00:00,0,0
2016-04-23-ccc_cty_online_script,2016/04/23,ccc_cty_online_script,0,0,0:00:00,0,0:00:00,0,0
2016-04-23-ccc_feedback_script,2016/04/23,ccc_feedback_script,0,0,0:00:00,0,0:00:00,0,0
2016-04-23-ccc_fpb_script,2016/04/23,ccc_fpb_script,0,0,0:00:00,0,0:00:00,0,0
2016-04-23-ccc_help_script,2016/04/23,ccc_help_script,0,0,0:00:00,0,0:00:00,0,0
2016-04-23-ccc_link_script,2016/04/23,ccc_link_script,0,0,0:00:00,0,0:00:00,0,0
2016-04-23-ccc_media_line_script,2016/04/23,ccc_media_line_script,0,0,0:00:00,0,0:00:00,0,0
2016-04-23-ccc_priority_script,2016/04/23,ccc_priority_script,25,21,0:00:14,14,0:01:24,4,294
2016-04-23-ccc_tax_script,2016/04/23,ccc_tax_script,3,3,0:00:06,6,0:00:06,0,18
2016-04-23-ccc_waste_recycling_script,2016/04/23,ccc_waste_recycling_script,0,0,0:00:00,0,0:00:00,0,0
2016-04-24-ccc_311_calgary_script,2016/04/24,ccc_311_calgary_script,943,925,0:00:13,13,0:04:46,18,12025
2016-04-24-ccc_311_lobby_ph_script,2016/04/24,ccc_311_lobby_ph_script,0,0,0:00:00,0,0:00:00,0,0
2016-04-24-ccc_aserv_info_script,2016/04/24,ccc_aserv_info_script,0,0,0:00:00,0,0:00:00,0,0
2016-04-24-ccc_bylaw_script,2016/04/24,ccc_bylaw_script,0,0,0:00:00,0,0:00:00,0,0
2016-04-24-ccc_city_script,2016/04/24,ccc_city_script,0,0,0:00:00,0,0:00:00,0,0
2016-04-24-ccc_cty_online_script,2016/04/24,ccc_cty_online_script,0,0,0:00:00,0,0:00:00,0,0
2016-04-24-ccc_feedback_script,2016/04/24,ccc_feedback_script,1,0,0:00:00,0,0:00:00,0,0
2016-04-24-ccc_fpb_script,2016/04/24,ccc_fpb_script,0,0,0:00:00,0,0:00:00,0,0
2016-04-24-ccc_help_script,2016/04/24,ccc_help_script,4,4,0:00:16,16,0:00:43,0,64
2016-04-24-ccc_link_script,2016/04/24,ccc_link_script,0,0,0:00:00,0,0:00:00,0,0
2016-04-24-ccc_media_line_script,2016/04/24,ccc_media_line_script,1,1,0:00:06,6,0:00:06,0,6
2016-04-24-ccc_priority_script,2016/04/24,ccc_priority_script,16,14,0:00:14,14,0:01:46,2,196
2016-04-24-ccc_tax_script,2016/04/24,ccc_tax_script,2,2,0:00:02,2,0:00:02,0,4
2016-04-24-ccc_waste_recycling_script,2016/04/24,ccc_waste_recycling_script,0,0,0:00:00,0,0:00:00,0,0
2016-04-25-ccc_311_calgary_script,2016/04/25,ccc_311_calgary_script,3328,3265,0:00:18,18,0:05:19,63,58770
2016-04-25-ccc_311_lobby_ph_script,2016/04/25,ccc_311_lobby_ph_script,3,3,0:00:05,5,0:00:06,0,15
2016-04-25-ccc_aserv_info_script,2016/04/25,ccc_aserv_info_script,0,0,0:00:00,0,0:00:00,0,0
2016-04-25-ccc_bylaw_script,2016/04/25,ccc_bylaw_script,0,0,0:00:00,0,0:00:00,0,0
2016-04-25-ccc_city_script,2016/04/25,ccc_city_script,29,29,0:00:06,6,0:00:24,0,174
2016-04-25-ccc_cty_online_script,2016/04/25,ccc_cty_online_script,0,0,0:00:00,0,0:00:00,0,0
2016-04-25-ccc_feedback_script,2016/04/25,ccc_feedback_script,0,0,0:00:00,0,0:00:00,0,0
2016-04-25-ccc_fpb_script,2016/04/25,ccc_fpb_script,2,2,0:00:04,4,0:00:05,0,8
2016-04-25-ccc_help_script,2016/04/25,ccc_help_script,68,67,0:00:08,8,0:00:45,1,536
2016-04-25-ccc_link_script,2016/04/25,ccc_link_script,0,0,0:00:00,0,0:00:00,0,0
2016-04-25-ccc_media_line_script,2016/04/25,ccc_media_line_script,2,2,0:00:07,7,0:00:07,0,14
2016-04-25-ccc_priority_script,2016/04/25,ccc_priority_script,27,25,0:00:08,8,0:00:52,2,200
2016-04-25-ccc_tax_script,2016/04/25,ccc_tax_script,14,14,0:00:25,25,0:01:44,0,350
2016-04-25-ccc_waste_recycling_script,2016/04/25,ccc_waste_recycling_script,0,0,0:00:00,0,0:00:00,0,0
2016-04-26-ccc_311_calgary_script,2016/04/26,ccc_311_calgary_script,3316,3121,0:00:50,50,0:06:05,195,156050
2016-04-26-ccc_311_lobby_ph_script,2016/04/26,ccc_311_lobby_ph_script,3,2,0:00:04,4,0:00:04,1,8
2016-04-26-ccc_aserv_info_script,2016/04/26,ccc_aserv_info_script,0,0,0:00:00,0,0:00:00,0,0
2016-04-26-ccc_bylaw_script,2016/04/26,ccc_bylaw_script,0,0,0:00:00,0,0:00:00,0,0
2016-04-26-ccc_city_script,2016/04/26,ccc_city_script,19,19,0:00:18,18,0:02:55,0,342
2016-04-26-ccc_cty_online_script,2016/04/26,ccc_cty_online_script,0,0,0:00:00,0,0:00:00,0,0
2016-04-26-ccc_feedback_script,2016/04/26,ccc_feedback_script,0,0,0:00:00,0,0:00:00,0,0
2016-04-26-ccc_fpb_script,2016/04/26,ccc_fpb_script,1,1,0:00:10,10,0:00:10,0,10
2016-04-26-ccc_help_script,2016/04/26,ccc_help_script,23,21,0:00:22,22,0:01:10,2,462
2016-04-26-ccc_link_script,2016/04/26,ccc_link_script,0,0,0:00:00,0,0:00:00,0,0
2016-04-26-ccc_media_line_script,2016/04/26,ccc_media_line_script,1,1,0:00:17,17,0:00:17,0,17
2016-04-26-ccc_priority_script,2016/04/26,ccc_priority_script,23,22,0:00:15,15,0:01:23,1,330
2016-04-26-ccc_tax_script,2016/04/26,ccc_tax_script,11,10,0:00:41,41,0:01:52,1,410
2016-04-26-ccc_waste_recycling_script,2016/04/26,ccc_waste_recycling_script,0,0,0:00:00,0,0:00:00,0,0
2016-04-27-ccc_311_calgary_script,2016/04/27,ccc_311_calgary_script,3393,3015,0:01:37,97,0:07:59,378,292455
2016-04-27-ccc_311_lobby_ph_script,2016/04/27,ccc_311_lobby_ph_script,4,3,0:00:10,10,0:00:15,1,30
2016-04-27-ccc_aserv_info_script,2016/04/27,ccc_aserv_info_script,0,0,0:00:00,0,0:00:00,0,0
2016-04-27-ccc_bylaw_script,2016/04/27,ccc_bylaw_script,0,0,0:00:00,0,0:00:00,0,0
2016-04-27-ccc_city_script,2016/04/27,ccc_city_script,22,21,0:00:24,24,0:01:24,1,504
2016-04-27-ccc_cty_online_script,2016/04/27,ccc_cty_online_script,0,0,0:00:00,0,0:00:00,0,0
2016-04-27-ccc_feedback_script,2016/04/27,ccc_feedback_script,0,0,0:00:00,0,0:00:00,0,0
2016-04-27-ccc_fpb_script,2016/04/27,ccc_fpb_script,0,0,0:00:00,0,0:00:00,0,0
2016-04-27-ccc_help_script,2016/04/27,ccc_help_script,63,58,0:00:16,16,0:00:53,5,928
2016-04-27-ccc_link_script,2016/04/27,ccc_link_script,0,0,0:00:00,0,0:00:00,0,0
2016-04-27-ccc_media_line_script,2016/04/27,ccc_media_line_script,5,3,0:00:21,21,0:00:26,2,63
2016-04-27-ccc_priority_script,2016/04/27,ccc_priority_script,30,29,0:00:15,15,0:01:24,1,435
2016-04-27-ccc_tax_script,2016/04/27,ccc_tax_script,25,22,0:01:30,90,0:07:49,3,1980
2016-04-27-ccc_waste_recycling_script,2016/04/27,ccc_waste_recycling_script,0,0,0:00:00,0,0:00:00,0,0
2016-04-28-ccc_311_calgary_script,2016/04/28,ccc_311_calgary_script,3226,3011,0:00:48,48,0:10:42,215,144528
2016-04-28-ccc_311_lobby_ph_script,2016/04/28,ccc_311_lobby_ph_script,4,4,0:00:05,5,0:00:09,0,20
2016-04-28-ccc_aserv_info_script,2016/04/28,ccc_aserv_info_script,0,0,0:00:00,0,0:00:00,0,0
2016-04-28-ccc_bylaw_script,2016/04/28,ccc_bylaw_script,0,0,0:00:00,0,0:00:00,0,0
2016-04-28-ccc_city_script,2016/04/28,ccc_city_script,15,15,0:00:12,12,0:00:38,0,180
2016-04-28-ccc_cty_online_script,2016/04/28,ccc_cty_online_script,0,0,0:00:00,0,0:00:00,0,0
2016-04-28-ccc_feedback_script,2016/04/28,ccc_feedback_script,1,0,0:00:00,0,0:00:00,0,0
2016-04-28-ccc_fpb_script,2016/04/28,ccc_fpb_script,1,1,0:03:14,194,0:03:14,0,194
2016-04-28-ccc_help_script,2016/04/28,ccc_help_script,16,15,0:00:12,12,0:01:05,1,180
2016-04-28-ccc_link_script,2016/04/28,ccc_link_script,0,0,0:00:00,0,0:00:00,0,0
2016-04-28-ccc_media_line_script,2016/04/28,ccc_media_line_script,0,0,0:00:00,0,0:00:00,0,0
2016-04-28-ccc_priority_script,2016/04/28,ccc_priority_script,29,29,0:00:10,10,0:00:35,0,290
2016-04-28-ccc_tax_script,2016/04/28,ccc_tax_script,15,14,0:01:00,60,0:03:37,1,840
2016-04-28-ccc_waste_recycling_script,2016/04/28,ccc_waste_recycling_script,0,0,0:00:00,0,0:00:00,0,0
2016-04-29-ccc_311_calgary_script,2016/04/29,ccc_311_calgary_script,3201,2718,0:02:23,143,0:10:16,483,388674
2016-04-29-ccc_311_lobby_ph_script,2016/04/29,ccc_311_lobby_ph_script,0,0,0:00:00,0,0:00:00,0,0
2016-04-29-ccc_aserv_info_script,2016/04/29,ccc_aserv_info_script,0,0,0:00:00,0,0:00:00,0,0
2016-04-29-ccc_bylaw_script,2016/04/29,ccc_bylaw_script,0,0,0:00:00,0,0:00:00,0,0
2016-04-29-ccc_city_script,2016/04/29,ccc_city_script,23,22,0:01:00,60,0:05:33,1,1320
2016-04-29-ccc_cty_online_script,2016/04/29,ccc_cty_online_script,0,0,0:00:00,0,0:00:00,0,0
2016-04-29-ccc_feedback_script,2016/04/29,ccc_feedback_script,1,0,0:00:00,0,0:00:00,0,0
2016-04-29-ccc_fpb_script,2016/04/29,ccc_fpb_script,0,0,0:00:00,0,0:00:00,0,0
2016-04-29-ccc_help_script,2016/04/29,ccc_help_script,29,25,0:00:17,17,0:01:48,3,425
2016-04-29-ccc_link_script,2016/04/29,ccc_link_script,0,0,0:00:00,0,0:00:00,0,0
2016-04-29-ccc_media_line_script,2016/04/29,ccc_media_line_script,1,1,0:00:08,8,0:00:08,0,8
2016-04-29-ccc_priority_script,2016/04/29,ccc_priority_script,22,19,0:00:17,17,0:00:51,3,323
2016-04-29-ccc_tax_script,2016/04/29,ccc_tax_script,18,16,0:03:53,233,0:07:35,2,3728
2016-04-29-ccc_waste_recycling_script,2016/04/29,ccc_waste_recycling_script,0,0,0:00:00,0,0:00:00,0,0
2016-04-30-ccc_311_calgary_script,2016/04/30,ccc_311_calgary_script,1380,1274,0:00:47,47,0:11:51,106,59878
2016-04-30-ccc_311_lobby_ph_script,2016/04/30,ccc_311_lobby_ph_script,0,0,0:00:00,0,0:00:00,0,0
2016-04-30-ccc_aserv_info_script,2016/04/30,ccc_aserv_info_script,0,0,0:00:00,0,0:00:00,0,0
2016-04-30-ccc_bylaw_script,2016/04/30,ccc_bylaw_script,0,0,0:00:00,0,0:00:00,0,0
2016-04-30-ccc_city_script,2016/04/30,ccc_city_script,0,0,0:00:00,0,0:00:00,0,0
2016-04-30-ccc_cty_online_script,2016/04/30,ccc_cty_online_script,0,0,0:00:00,0,0:00:00,0,0
2016-04-30-ccc_feedback_script,2016/04/30,ccc_feedback_script,0,0,0:00:00,0,0:00:00,0,0
2016-04-30-ccc_fpb_script,2016/04/30,ccc_fpb_script,0,0,0:00:00,0,0:00:00,0,0
2016-04-30-ccc_help_script,2016/04/30,ccc_help_script,9,10,0:00:39,39,0:02:42,0,390
2016-04-30-ccc_link_script,2016/04/30,ccc_link_script,0,0,0:00:00,0,0:00:00,0,0
2016-04-30-ccc_media_line_script,2016/04/30,ccc_media_line_script,0,0,0:00:00,0,0:00:00,0,0
2016-04-30-ccc_priority_script,2016/04/30,ccc_priority_script,33,33,0:00:22,22,0:03:36,0,726
2016-04-30-ccc_tax_script,2016/04/30,ccc_tax_script,2,2,0:02:18,138,0:02:18,0,276
2016-04-30-ccc_waste_recycling_script,2016/04/30,ccc_waste_recycling_script,0,0,0:00:00,0,0:00:00,0,0
2016-05-01-ccc_311_calgary_script,2016/05/01,ccc_311_calgary_script,1381,1207,0:01:22,82,0:13:52,174,98974
2016-05-01-ccc_311_lobby_ph_script,2016/05/01,ccc_311_lobby_ph_script,0,0,0:00:00,0,0:00:00,0,0
2016-05-01-ccc_aserv_info_script,2016/05/01,ccc_aserv_info_script,0,0,0:00:00,0,0:00:00,0,0
2016-05-01-ccc_bylaw_script,2016/05/01,ccc_bylaw_script,0,0,0:00:00,0,0:00:00,0,0
2016-05-01-ccc_city_script,2016/05/01,ccc_city_script,0,0,0:00:00,0,0:00:00,0,0
2016-05-01-ccc_cty_online_script,2016/05/01,ccc_cty_online_script,0,0,0:00:00,0,0:00:00,0,0
2016-05-01-ccc_feedback_script,2016/05/01,ccc_feedback_script,0,0,0:00:00,0,0:00:00,0,0
2016-05-01-ccc_fpb_script,2016/05/01,ccc_fpb_script,0,0,0:00:00,0,0:00:00,0,0
2016-05-01-ccc_help_script,2016/05/01,ccc_help_script,6,6,0:00:13,13,0:00:25,0,78
2016-05-01-ccc_link_script,2016/05/01,ccc_link_script,0,0,0:00:00,0,0:00:00,0,0
2016-05-01-ccc_media_line_script,2016/05/01,ccc_media_line_script,2,2,0:00:04,4,0:00:05,0,8
2016-05-01-ccc_priority_script,2016/05/01,ccc_priority_script,12,12,0:00:29,29,0:02:45,0,348
2016-05-01-ccc_tax_script,2016/05/01,ccc_tax_script,0,0,0:00:00,0,0:00:00,0,0
2016-05-01-ccc_waste_recycling_script,2016/05/01,ccc_waste_recycling_script,0,0,0:00:00,0,0:00:00,0,0
2016-05-02-ccc_311_calgary_script,2016/05/02,ccc_311_calgary_script,4152,3595,0:02:05,125,0:19:19,557,449375
2016-05-02-ccc_311_lobby_ph_script,2016/05/02,ccc_311_lobby_ph_script,4,4,0:00:14,14,0:00:25,0,56
2016-05-02-ccc_aserv_info_script,2016/05/02,ccc_aserv_info_script,0,0,0:00:00,0,0:00:00,0,0
2016-05-02-ccc_bylaw_script,2016/05/02,ccc_bylaw_script,0,0,0:00:00,0,0:00:00,0,0
2016-05-02-ccc_city_script,2016/05/02,ccc_city_script,17,16,0:00:30,30,0:02:35,1,480
2016-05-02-ccc_cty_online_script,2016/05/02,ccc_cty_online_script,0,0,0:00:00,0,0:00:00,0,0
2016-05-02-ccc_feedback_script,2016/05/02,ccc_feedback_script,0,0,0:00:00,0,0:00:00,0,0
2016-05-02-ccc_fpb_script,2016/05/02,ccc_fpb_script,0,0,0:00:00,0,0:00:00,0,0
2016-05-02-ccc_help_script,2016/05/02,ccc_help_script,30,30,0:00:19,19,0:01:01,0,570
2016-05-02-ccc_link_script,2016/05/02,ccc_link_script,0,0,0:00:00,0,0:00:00,0,0
2016-05-02-ccc_media_line_script,2016/05/02,ccc_media_line_script,2,2,0:00:03,3,0:00:04,0,6
2016-05-02-ccc_priority_script,2016/05/02,ccc_priority_script,33,31,0:00:20,20,0:02:00,2,620
2016-05-02-ccc_tax_script,2016/05/02,ccc_tax_script,21,19,0:01:39,99,0:04:21,2,1881
2016-05-02-ccc_waste_recycling_script,2016/05/02,ccc_waste_recycling_script,0,0,0:00:00,0,0:00:00,0,0
2016-05-03-ccc_311_calgary_script,2016/05/03,ccc_311_calgary_script,3734,3463,0:01:02,62,0:07:37,271,214706
2016-05-03-ccc_311_lobby_ph_script,2016/05/03,ccc_311_lobby_ph_script,3,3,0:00:08,8,0:00:18,0,24
2016-05-03-ccc_aserv_info_script,2016/05/03,ccc_aserv_info_script,0,0,0:00:00,0,0:00:00,0,0
2016-05-03-ccc_bylaw_script,2016/05/03,ccc_bylaw_script,0,0,0:00:00,0,0:00:00,0,0
2016-05-03-ccc_city_script,2016/05/03,ccc_city_script,9,9,0:00:25,25,0:02:39,0,225
2016-05-03-ccc_cty_online_script,2016/05/03,ccc_cty_online_script,0,0,0:00:00,0,0:00:00,0,0
2016-05-03-ccc_feedback_script,2016/05/03,ccc_feedback_script,0,0,0:00:00,0,0:00:00,0,0
2016-05-03-ccc_fpb_script,2016/05/03,ccc_fpb_script,2,1,0:00:02,2,0:00:02,1,2
2016-05-03-ccc_help_script,2016/05/03,ccc_help_script,15,14,0:00:18,18,0:01:03,1,252
2016-05-03-ccc_link_script,2016/05/03,ccc_link_script,1,0,0:00:00,0,0:00:00,1,0
2016-05-03-ccc_media_line_script,2016/05/03,ccc_media_line_script,9,8,0:00:19,19,0:01:50,1,152
2016-05-03-ccc_priority_script,2016/05/03,ccc_priority_script,35,35,0:00:10,10,0:00:38,0,350
2016-05-03-ccc_tax_script,2016/05/03,ccc_tax_script,18,16,0:01:11,71,0:06:51,2,1136
2016-05-03-ccc_waste_recycling_script,2016/05/03,ccc_waste_recycling_script,0,0,0:00:00,0,0:00:00,0,0
2016-05-04-ccc_311_calgary_script,2016/05/04,ccc_311_calgary_script,3822,3355,0:01:34,94,0:18:31,467,315370
2016-05-04-ccc_311_lobby_ph_script,2016/05/04,ccc_311_lobby_ph_script,1,1,0:00:12,12,0:00:12,0,12
2016-05-04-ccc_aserv_info_script,2016/05/04,ccc_aserv_info_script,0,0,0:00:00,0,0:00:00,0,0
2016-05-04-ccc_bylaw_script,2016/05/04,ccc_bylaw_script,0,0,0:00:00,0,0:00:00,0,0
2016-05-04-ccc_city_script,2016/05/04,ccc_city_script,9,8,0:01:09,69,0:03:42,1,552
2016-05-04-ccc_cty_online_script,2016/05/04,ccc_cty_online_script,0,0,0:00:00,0,0:00:00,0,0
2016-05-04-ccc_feedback_script,2016/05/04,ccc_feedback_script,1,0,0:00:00,0,0:00:00,0,0
2016-05-04-ccc_fpb_script,2016/05/04,ccc_fpb_script,0,0,0:00:00,0,0:00:00,0,0
2016-05-04-ccc_help_script,2016/05/04,ccc_help_script,28,27,0:00:18,18,0:01:06,1,486
2016-05-04-ccc_link_script,2016/05/04,ccc_link_script,0,0,0:00:00,0,0:00:00,0,0
2016-05-04-ccc_media_line_script,2016/05/04,ccc_media_line_script,2,2,0:00:04,4,0:00:05,0,8
2016-05-04-ccc_priority_script,2016/05/04,ccc_priority_script,32,31,0:00:14,14,0:00:57,1,434
2016-05-04-ccc_tax_script,2016/05/04,ccc_tax_script,30,27,0:01:31,91,0:05:35,3,2457
2016-05-04-ccc_waste_recycling_script,2016/05/04,ccc_waste_recycling_script,0,0,0:00:00,0,0:00:00,0,0
2016-05-05-ccc_311_calgary_script,2016/05/05,ccc_311_calgary_script,3396,3053,0:01:28,88,0:15:25,343,268664
2016-05-05-ccc_311_lobby_ph_script,2016/05/05,ccc_311_lobby_ph_script,6,5,0:00:07,7,0:00:14,1,35
2016-05-05-ccc_aserv_info_script,2016/05/05,ccc_aserv_info_script,0,0,0:00:00,0,0:00:00,0,0
2016-05-05-ccc_bylaw_script,2016/05/05,ccc_bylaw_script,0,0,0:00:00,0,0:00:00,0,0
2016-05-05-ccc_city_script,2016/05/05,ccc_city_script,26,24,0:00:37,37,0:03:54,2,888
2016-05-05-ccc_cty_online_script,2016/05/05,ccc_cty_online_script,0,0,0:00:00,0,0:00:00,0,0
2016-05-05-ccc_feedback_script,2016/05/05,ccc_feedback_script,0,0,0:00:00,0,0:00:00,0,0
2016-05-05-ccc_fpb_script,2016/05/05,ccc_fpb_script,1,1,0:02:41,161,0:02:41,0,161
2016-05-05-ccc_help_script,2016/05/05,ccc_help_script,17,16,0:00:10,10,0:00:39,1,160
2016-05-05-ccc_link_script,2016/05/05,ccc_link_script,0,0,0:00:00,0,0:00:00,0,0
2016-05-05-ccc_media_line_script,2016/05/05,ccc_media_line_script,3,3,0:00:25,25,0:01:05,0,75
2016-05-05-ccc_priority_script,2016/05/05,ccc_priority_script,25,25,0:00:28,28,0:03:39,0,700
2016-05-05-ccc_tax_script,2016/05/05,ccc_tax_script,13,11,0:03:03,183,0:12:50,2,2013
2016-05-05-ccc_waste_recycling_script,2016/05/05,ccc_waste_recycling_script,0,0,0:00:00,0,0:00:00,0,0
2016-05-06-ccc_311_calgary_script,2016/05/06,ccc_311_calgary_script,4040,3265,0:02:55,175,0:09:21,775,571375
2016-05-06-ccc_311_lobby_ph_script,2016/05/06,ccc_311_lobby_ph_script,4,4,0:00:09,9,0:00:15,0,36
2016-05-06-ccc_aserv_info_script,2016/05/06,ccc_aserv_info_script,0,0,0:00:00,0,0:00:00,0,0
2016-05-06-ccc_bylaw_script,2016/05/06,ccc_bylaw_script,0,0,0:00:00,0,0:00:00,0,0
2016-05-06-ccc_city_script,2016/05/06,ccc_city_script,11,8,0:01:22,82,0:05:20,3,656
2016-05-06-ccc_cty_online_script,2016/05/06,ccc_cty_online_script,0,0,0:00:00,0,0:00:00,0,0
2016-05-06-ccc_feedback_script,2016/05/06,ccc_feedback_script,0,0,0:00:00,0,0:00:00,0,0
2016-05-06-ccc_fpb_script,2016/05/06,ccc_fpb_script,1,0,0:00:00,0,0:00:00,1,0
2016-05-06-ccc_help_script,2016/05/06,ccc_help_script,31,29,0:00:19,19,0:01:24,2,551
2016-05-06-ccc_link_script,2016/05/06,ccc_link_script,0,0,0:00:00,0,0:00:00,0,0
2016-05-06-ccc_media_line_script,2016/05/06,ccc_media_line_script,6,5,0:00:28,28,0:01:35,1,140
2016-05-06-ccc_priority_script,2016/05/06,ccc_priority_script,35,33,0:00:19,19,0:01:20,2,627
2016-05-06-ccc_tax_script,2016/05/06,ccc_tax_script,11,10,0:02:44,164,0:06:18,1,1640
2016-05-06-ccc_waste_recycling_script,2016/05/06,ccc_waste_recycling_script,0,0,0:00:00,0,0:00:00,0,0
2016-05-07-ccc_311_calgary_script,2016/05/07,ccc_311_calgary_script,2052,1803,0:01:16,76,0:11:26,249,137028
2016-05-07-ccc_311_lobby_ph_script,2016/05/07,ccc_311_lobby_ph_script,0,0,0:00:00,0,0:00:00,0,0
2016-05-07-ccc_aserv_info_script,2016/05/07,ccc_aserv_info_script,0,0,0:00:00,0,0:00:00,0,0
2016-05-07-ccc_bylaw_script,2016/05/07,ccc_bylaw_script,1,1,0:00:03,3,0:00:03,0,3
2016-05-07-ccc_city_script,2016/05/07,ccc_city_script,0,0,0:00:00,0,0:00:00,0,0
2016-05-07-ccc_cty_online_script,2016/05/07,ccc_cty_online_script,0,0,0:00:00,0,0:00:00,0,0
2016-05-07-ccc_feedback_script,2016/05/07,ccc_feedback_script,0,0,0:00:00,0,0:00:00,0,0
2016-05-07-ccc_fpb_script,2016/05/07,ccc_fpb_script,0,0,0:00:00,0,0:00:00,0,0
2016-05-07-ccc_help_script,2016/05/07,ccc_help_script,10,10,0:00:26,26,0:03:02,0,260
2016-05-07-ccc_link_script,2016/05/07,ccc_link_script,0,0,0:00:00,0,0:00:00,0,0
2016-05-07-ccc_media_line_script,2016/05/07,ccc_media_line_script,14,10,0:00:11,11,0:00:27,4,110
2016-05-07-ccc_priority_script,2016/05/07,ccc_priority_script,17,16,0:00:21,21,0:00:59,1,336
2016-05-07-ccc_tax_script,2016/05/07,ccc_tax_script,0,0,0:00:00,0,0:00:00,0,0
2016-05-07-ccc_waste_recycling_script,2016/05/07,ccc_waste_recycling_script,0,0,0:00:00,0,0:00:00,0,0
2016-05-08-ccc_311_calgary_script,2016/05/08,ccc_311_calgary_script,1064,1048,0:00:13,13,0:06:16,16,13624
2016-05-08-ccc_311_lobby_ph_script,2016/05/08,ccc_311_lobby_ph_script,0,0,0:00:00,0,0:00:00,0,0
2016-05-08-ccc_aserv_info_script,2016/05/08,ccc_aserv_info_script,0,0,0:00:00,0,0:00:00,0,0
2016-05-08-ccc_bylaw_script,2016/05/08,ccc_bylaw_script,0,0,0:00:00,0,0:00:00,0,0
2016-05-08-ccc_city_script,2016/05/08,ccc_city_script,0,0,0:00:00,0,0:00:00,0,0
2016-05-08-ccc_cty_online_script,2016/05/08,ccc_cty_online_script,0,0,0:00:00,0,0:00:00,0,0
2016-05-08-ccc_feedback_script,2016/05/08,ccc_feedback_script,0,0,0:00:00,0,0:00:00,0,0
2016-05-08-ccc_fpb_script,2016/05/08,ccc_fpb_script,0,0,0:00:00,0,0:00:00,0,0
2016-05-08-ccc_help_script,2016/05/08,ccc_help_script,4,4,0:00:04,4,0:00:05,0,16
2016-05-08-ccc_link_script,2016/05/08,ccc_link_script,0,0,0:00:00,0,0:00:00,0,0
2016-05-08-ccc_media_line_script,2016/05/08,ccc_media_line_script,9,9,0:00:09,9,0:00:39,0,81
2016-05-08-ccc_priority_script,2016/05/08,ccc_priority_script,18,17,0:00:05,5,0:00:12,1,85
2016-05-08-ccc_tax_script,2016/05/08,ccc_tax_script,1,1,0:00:03,3,0:00:03,0,3
2016-05-08-ccc_waste_recycling_script,2016/05/08,ccc_waste_recycling_script,0,0,0:00:00,0,0:00:00,0,0
2016-05-09-ccc_311_calgary_script,2016/05/09,ccc_311_calgary_script,3672,3517,0:00:35,35,0:05:47,155,123095
2016-05-09-ccc_311_lobby_ph_script,2016/05/09,ccc_311_lobby_ph_script,4,4,0:00:10,10,0:00:21,0,40
2016-05-09-ccc_aserv_info_script,2016/05/09,ccc_aserv_info_script,0,0,0:00:00,0,0:00:00,0,0
2016-05-09-ccc_bylaw_script,2016/05/09,ccc_bylaw_script,0,0,0:00:00,0,0:00:00,0,0
2016-05-09-ccc_city_script,2016/05/09,ccc_city_script,35,35,0:00:14,14,0:02:38,0,490
2016-05-09-ccc_cty_online_script,2016/05/09,ccc_cty_online_script,0,0,0:00:00,0,0:00:00,0,0
2016-05-09-ccc_feedback_script,2016/05/09,ccc_feedback_script,0,0,0:00:00,0,0:00:00,0,0
2016-05-09-ccc_fpb_script,2016/05/09,ccc_fpb_script,0,0,0:00:00,0,0:00:00,0,0
2016-05-09-ccc_help_script,2016/05/09,ccc_help_script,29,28,0:00:17,17,0:01:20,1,476
2016-05-09-ccc_link_script,2016/05/09,ccc_link_script,0,0,0:00:00,0,0:00:00,0,0
2016-05-09-ccc_media_line_script,2016/05/09,ccc_media_line_script,0,0,0:00:00,0,0:00:00,0,0
2016-05-09-ccc_priority_script,2016/05/09,ccc_priority_script,37,37,0:00:11,11,0:00:53,0,407
2016-05-09-ccc_tax_script,2016/05/09,ccc_tax_script,20,19,0:00:28,28,0:02:05,1,532
2016-05-09-ccc_waste_recycling_script,2016/05/09,ccc_waste_recycling_script,0,0,0:00:00,0,0:00:00,0,0
2016-05-10-ccc_311_calgary_script,2016/05/10,ccc_311_calgary_script,3578,3341,0:00:44,44,0:05:32,237,147004
2016-05-10-ccc_311_lobby_ph_script,2016/05/10,ccc_311_lobby_ph_script,3,3,0:00:05,5,0:00:06,0,15
2016-05-10-ccc_aserv_info_script,2016/05/10,ccc_aserv_info_script,0,0,0:00:00,0,0:00:00,0,0
2016-05-10-ccc_bylaw_script,2016/05/10,ccc_bylaw_script,0,0,0:00:00,0,0:00:00,0,0
2016-05-10-ccc_city_script,2016/05/10,ccc_city_script,24,24,0:00:34,34,0:03:17,0,816
2016-05-10-ccc_cty_online_script,2016/05/10,ccc_cty_online_script,0,0,0:00:00,0,0:00:00,0,0
2016-05-10-ccc_feedback_script,2016/05/10,ccc_feedback_script,0,0,0:00:00,0,0:00:00,0,0
2016-05-10-ccc_fpb_script,2016/05/10,ccc_fpb_script,0,0,0:00:00,0,0:00:00,0,0
2016-05-10-ccc_help_script,2016/05/10,ccc_help_script,16,16,0:00:39,39,0:02:43,0,624
2016-05-10-ccc_link_script,2016/05/10,ccc_link_script,0,0,0:00:00,0,0:00:00,0,0
2016-05-10-ccc_media_line_script,2016/05/10,ccc_media_line_script,0,0,0:00:00,0,0:00:00,0,0
2016-05-10-ccc_priority_script,2016/05/10,ccc_priority_script,25,24,0:00:11,11,0:01:04,1,264
2016-05-10-ccc_tax_script,2016/05/10,ccc_tax_script,16,15,0:00:55,55,0:02:39,1,825
2016-05-10-ccc_waste_recycling_script,2016/05/10,ccc_waste_recycling_script,0,0,0:00:00,0,0:00:00,0,0
2016-05-11-ccc_311_calgary_script,2016/05/11,ccc_311_calgary_script,3204,3096,0:00:29,29,0:09:29,108,89784
2016-05-11-ccc_311_lobby_ph_script,2016/05/11,ccc_311_lobby_ph_script,1,1,0:00:13,13,0:00:13,0,13
2016-05-11-ccc_aserv_info_script,2016/05/11,ccc_aserv_info_script,0,0,0:00:00,0,0:00:00,0,0
2016-05-11-ccc_bylaw_script,2016/05/11,ccc_bylaw_script,0,0,0:00:00,0,0:00:00,0,0
2016-05-11-ccc_city_script,2016/05/11,ccc_city_script,27,27,0:00:30,30,0:04:57,0,810
2016-05-11-ccc_cty_online_script,2016/05/11,ccc_cty_online_script,0,0,0:00:00,0,0:00:00,0,0
2016-05-11-ccc_feedback_script,2016/05/11,ccc_feedback_script,0,0,0:00:00,0,0:00:00,0,0
2016-05-11-ccc_fpb_script,2016/05/11,ccc_fpb_script,0,0,0:00:00,0,0:00:00,0,0
2016-05-11-ccc_help_script,2016/05/11,ccc_help_script,13,13,0:00:17,17,0:02:05,0,221
2016-05-11-ccc_link_script,2016/05/11,ccc_link_script,0,0,0:00:00,0,0:00:00,0,0
2016-05-11-ccc_media_line_script,2016/05/11,ccc_media_line_script,5,5,0:00:10,10,0:00:29,0,50
2016-05-11-ccc_priority_script,2016/05/11,ccc_priority_script,33,33,0:00:12,12,0:01:45,0,396
2016-05-11-ccc_tax_script,2016/05/11,ccc_tax_script,16,16,0:00:12,12,0:00:50,0,192
2016-05-11-ccc_waste_recycling_script,2016/05/11,ccc_waste_recycling_script,0,0,0:00:00,0,0:00:00,0,0
2016-05-12-ccc_311_calgary_script,2016/05/12,ccc_311_calgary_script,3030,2927,0:00:26,26,0:07:18,103,76102
2016-05-12-ccc_311_lobby_ph_script,2016/05/12,ccc_311_lobby_ph_script,3,2,0:00:07,7,0:00:10,1,14
2016-05-12-ccc_aserv_info_script,2016/05/12,ccc_aserv_info_script,0,0,0:00:00,0,0:00:00,0,0
2016-05-12-ccc_bylaw_script,2016/05/12,ccc_bylaw_script,0,0,0:00:00,0,0:00:00,0,0
2016-05-12-ccc_city_script,2016/05/12,ccc_city_script,25,24,0:00:07,7,0:00:15,1,168
2016-05-12-ccc_cty_online_script,2016/05/12,ccc_cty_online_script,0,0,0:00:00,0,0:00:00,0,0
2016-05-12-ccc_feedback_script,2016/05/12,ccc_feedback_script,0,0,0:00:00,0,0:00:00,0,0
2016-05-12-ccc_fpb_script,2016/05/12,ccc_fpb_script,0,0,0:00:00,0,0:00:00,0,0
2016-05-12-ccc_help_script,2016/05/12,ccc_help_script,34,31,0:00:08,8,0:00:50,3,248
2016-05-12-ccc_link_script,2016/05/12,ccc_link_script,0,0,0:00:00,0,0:00:00,0,0
2016-05-12-ccc_media_line_script,2016/05/12,ccc_media_line_script,1,1,0:00:03,3,0:00:03,0,3
2016-05-12-ccc_priority_script,2016/05/12,ccc_priority_script,27,25,0:00:16,16,0:01:52,2,400
2016-05-12-ccc_tax_script,2016/05/12,ccc_tax_script,10,10,0:00:23,23,0:01:51,0,230
2016-05-12-ccc_waste_recycling_script,2016/05/12,ccc_waste_recycling_script,0,0,0:00:00,0,0:00:00,0,0
2016-05-13-ccc_311_calgary_script,2016/05/13,ccc_311_calgary_script,3148,3017,0:00:37,37,0:06:51,131,111629
2016-05-13-ccc_311_lobby_ph_script,2016/05/13,ccc_311_lobby_ph_script,5,5,0:00:09,9,0:00:17,0,45
2016-05-13-ccc_aserv_info_script,2016/05/13,ccc_aserv_info_script,0,0,0:00:00,0,0:00:00,0,0
2016-05-13-ccc_bylaw_script,2016/05/13,ccc_bylaw_script,0,0,0:00:00,0,0:00:00,0,0
2016-05-13-ccc_city_script,2016/05/13,ccc_city_script,21,21,0:00:14,14,0:01:23,0,294
2016-05-13-ccc_cty_online_script,2016/05/13,ccc_cty_online_script,0,0,0:00:00,0,0:00:00,0,0
2016-05-13-ccc_feedback_script,2016/05/13,ccc_feedback_script,1,0,0:00:00,0,0:00:00,0,0
2016-05-13-ccc_fpb_script,2016/05/13,ccc_fpb_script,3,2,0:00:03,3,0:00:03,1,6
2016-05-13-ccc_help_script,2016/05/13,ccc_help_script,30,27,0:00:13,13,0:02:07,3,351
2016-05-13-ccc_link_script,2016/05/13,ccc_link_script,0,0,0:00:00,0,0:00:00,0,0
2016-05-13-ccc_media_line_script,2016/05/13,ccc_media_line_script,2,2,0:00:08,8,0:00:12,0,16
2016-05-13-ccc_priority_script,2016/05/13,ccc_priority_script,23,20,0:00:10,10,0:00:56,3,200
2016-05-13-ccc_tax_script,2016/05/13,ccc_tax_script,21,21,0:00:24,24,0:01:54,0,504
2016-05-13-ccc_waste_recycling_script,2016/05/13,ccc_waste_recycling_script,0,0,0:00:00,0,0:00:00,0,0
2016-05-14-ccc_311_calgary_script,2016/05/14,ccc_311_calgary_script,1425,1389,0:00:16,16,0:08:36,36,22224
2016-05-14-ccc_311_lobby_ph_script,2016/05/14,ccc_311_lobby_ph_script,0,0,0:00:00,0,0:00:00,0,0
2016-05-14-ccc_aserv_info_script,2016/05/14,ccc_aserv_info_script,0,0,0:00:00,0,0:00:00,0,0
2016-05-14-ccc_bylaw_script,2016/05/14,ccc_bylaw_script,0,0,0:00:00,0,0:00:00,0,0
2016-05-14-ccc_city_script,2016/05/14,ccc_city_script,0,0,0:00:00,0,0:00:00,0,0
2016-05-14-ccc_cty_online_script,2016/05/14,ccc_cty_online_script,0,0,0:00:00,0,0:00:00,0,0
2016-05-14-ccc_feedback_script,2016/05/14,ccc_feedback_script,0,0,0:00:00,0,0:00:00,0,0
2016-05-14-ccc_fpb_script,2016/05/14,ccc_fpb_script,1,1,0:00:03,3,0:00:03,0,3
2016-05-14-ccc_help_script,2016/05/14,ccc_help_script,7,7,0:00:18,18,0:01:26,0,126
2016-05-14-ccc_link_script,2016/05/14,ccc_link_script,0,0,0:00:00,0,0:00:00,0,0
2016-05-14-ccc_media_line_script,2016/05/14,ccc_media_line_script,2,2,0:00:17,17,0:00:31,0,34
2016-05-14-ccc_priority_script,2016/05/14,ccc_priority_script,12,12,0:00:07,7,0:00:18,0,84
2016-05-14-ccc_tax_script,2016/05/14,ccc_tax_script,1,1,0:00:05,5,0:00:05,0,5
2016-05-14-ccc_waste_recycling_script,2016/05/14,ccc_waste_recycling_script,0,0,0:00:00,0,0:00:00,0,0
2016-05-15-ccc_311_calgary_script,2016/05/15,ccc_311_calgary_script,1121,1090,0:00:18,18,0:11:11,31,19620
2016-05-15-ccc_311_lobby_ph_script,2016/05/15,ccc_311_lobby_ph_script,0,0,0:00:00,0,0:00:00,0,0
2016-05-15-ccc_aserv_info_script,2016/05/15,ccc_aserv_info_script,0,0,0:00:00,0,0:00:00,0,0
2016-05-15-ccc_bylaw_script,2016/05/15,ccc_bylaw_script,0,0,0:00:00,0,0:00:00,0,0
2016-05-15-ccc_city_script,2016/05/15,ccc_city_script,0,0,0:00:00,0,0:00:00,0,0
2016-05-15-ccc_cty_online_script,2016/05/15,ccc_cty_online_script,0,0,0:00:00,0,0:00:00,0,0
2016-05-15-ccc_feedback_script,2016/05/15,ccc_feedback_script,0,0,0:00:00,0,0:00:00,0,0
2016-05-15-ccc_fpb_script,2016/05/15,ccc_fpb_script,0,0,0:00:00,0,0:00:00,0,0
2016-05-15-ccc_help_script,2016/05/15,ccc_help_script,6,6,0:00:32,32,0:01:33,0,192
2016-05-15-ccc_link_script,2016/05/15,ccc_link_script,0,0,0:00:00,0,0:00:00,0,0
2016-05-15-ccc_media_line_script,2016/05/15,ccc_media_line_script,2,2,0:00:29,29,0:00:52,0,58
2016-05-15-ccc_priority_script,2016/05/15,ccc_priority_script,27,27,0:00:11,11,0:01:07,0,297
2016-05-15-ccc_tax_script,2016/05/15,ccc_tax_script,1,1,0:00:04,4,0:00:04,0,4
2016-05-15-ccc_waste_recycling_script,2016/05/15,ccc_waste_recycling_script,0,0,0:00:00,0,0:00:00,0,0
2016-05-16-ccc_311_calgary_script,2016/05/16,ccc_311_calgary_script,3942,3785,0:00:31,31,0:08:31,157,117335
2016-05-16-ccc_311_lobby_ph_script,2016/05/16,ccc_311_lobby_ph_script,2,2,0:00:03,3,0:00:04,0,6
2016-05-16-ccc_aserv_info_script,2016/05/16,ccc_aserv_info_script,0,0,0:00:00,0,0:00:00,0,0
2016-05-16-ccc_bylaw_script,2016/05/16,ccc_bylaw_script,0,0,0:00:00,0,0:00:00,0,0
2016-05-16-ccc_city_script,2016/05/16,ccc_city_script,14,13,0:00:11,11,0:00:46,1,143
2016-05-16-ccc_cty_online_script,2016/05/16,ccc_cty_online_script,0,0,0:00:00,0,0:00:00,0,0
2016-05-16-ccc_feedback_script,2016/05/16,ccc_feedback_script,0,0,0:00:00,0,0:00:00,0,0
2016-05-16-ccc_fpb_script,2016/05/16,ccc_fpb_script,0,0,0:00:00,0,0:00:00,0,0
2016-05-16-ccc_help_script,2016/05/16,ccc_help_script,10,10,0:00:25,25,0:02:10,0,250
2016-05-16-ccc_link_script,2016/05/16,ccc_link_script,0,0,0:00:00,0,0:00:00,0,0
2016-05-16-ccc_media_line_script,2016/05/16,ccc_media_line_script,2,2,0:00:07,7,0:00:09,0,14
2016-05-16-ccc_priority_script,2016/05/16,ccc_priority_script,39,38,0:00:12,12,0:02:09,1,456
2016-05-16-ccc_tax_script,2016/05/16,ccc_tax_script,20,13,0:00:20,20,0:01:38,7,260
2016-05-16-ccc_waste_recycling_script,2016/05/16,ccc_waste_recycling_script,0,0,0:00:00,0,0:00:00,0,0
2016-05-17-ccc_311_calgary_script,2016/05/17,ccc_311_calgary_script,3784,3291,0:01:48,108,0:14:56,493,355428
2016-05-17-ccc_311_lobby_ph_script,2016/05/17,ccc_311_lobby_ph_script,2,2,0:00:03,3,0:00:03,0,6
2016-05-17-ccc_aserv_info_script,2016/05/17,ccc_aserv_info_script,0,0,0:00:00,0,0:00:00,0,0
2016-05-17-ccc_bylaw_script,2016/05/17,ccc_bylaw_script,0,0,0:00:00,0,0:00:00,0,0
2016-05-17-ccc_city_script,2016/05/17,ccc_city_script,17,17,0:00:28,28,0:04:33,0,476
2016-05-17-ccc_cty_online_script,2016/05/17,ccc_cty_online_script,0,0,0:00:00,0,0:00:00,0,0
2016-05-17-ccc_feedback_script,2016/05/17,ccc_feedback_script,0,0,0:00:00,0,0:00:00,0,0
2016-05-17-ccc_fpb_script,2016/05/17,ccc_fpb_script,1,1,0:02:29,149,0:02:29,0,149
2016-05-17-ccc_help_script,2016/05/17,ccc_help_script,13,13,0:00:14,14,0:00:29,0,182
2016-05-17-ccc_link_script,2016/05/17,ccc_link_script,0,0,0:00:00,0,0:00:00,0,0
2016-05-17-ccc_media_line_script,2016/05/17,ccc_media_line_script,2,2,0:00:15,15,0:00:19,0,30
2016-05-17-ccc_priority_script,2016/05/17,ccc_priority_script,26,26,0:00:16,16,0:02:00,0,416
2016-05-17-ccc_tax_script,2016/05/17,ccc_tax_script,22,19,0:01:05,65,0:02:26,3,1235
2016-05-17-ccc_waste_recycling_script,2016/05/17,ccc_waste_recycling_script,0,0,0:00:00,0,0:00:00,0,0
2016-05-18-ccc_311_calgary_script,2016/05/18,ccc_311_calgary_script,3600,3226,0:01:28,88,0:10:45,374,283888
2016-05-18-ccc_311_lobby_ph_script,2016/05/18,ccc_311_lobby_ph_script,4,4,0:00:07,7,0:00:10,0,28
2016-05-18-ccc_aserv_info_script,2016/05/18,ccc_aserv_info_script,0,0,0:00:00,0,0:00:00,0,0
2016-05-18-ccc_bylaw_script,2016/05/18,ccc_bylaw_script,0,0,0:00:00,0,0:00:00,0,0
2016-05-18-ccc_city_script,2016/05/18,ccc_city_script,17,16,0:00:17,17,0:01:50,1,272
2016-05-18-ccc_cty_online_script,2016/05/18,ccc_cty_online_script,0,0,0:00:00,0,0:00:00,0,0
2016-05-18-ccc_feedback_script,2016/05/18,ccc_feedback_script,0,0,0:00:00,0,0:00:00,0,0
2016-05-18-ccc_fpb_script,2016/05/18,ccc_fpb_script,1,1,0:05:55,355,0:05:55,0,355
2016-05-18-ccc_help_script,2016/05/18,ccc_help_script,19,18,0:00:11,11,0:00:35,1,198
2016-05-18-ccc_link_script,2016/05/18,ccc_link_script,0,0,0:00:00,0,0:00:00,0,0
2016-05-18-ccc_media_line_script,2016/05/18,ccc_media_line_script,0,0,0:00:00,0,0:00:00,0,0
2016-05-18-ccc_priority_script,2016/05/18,ccc_priority_script,37,36,0:00:20,20,0:01:59,1,720
2016-05-18-ccc_tax_script,2016/05/18,ccc_tax_script,15,13,0:01:45,105,0:06:01,2,1365
2016-05-18-ccc_waste_recycling_script,2016/05/18,ccc_waste_recycling_script,0,0,0:00:00,0,0:00:00,0,0
2016-05-19-ccc_311_calgary_script,2016/05/19,ccc_311_calgary_script,3249,2820,0:01:58,118,0:08:10,429,332760
2016-05-19-ccc_311_lobby_ph_script,2016/05/19,ccc_311_lobby_ph_script,7,7,0:00:08,8,0:00:25,0,56
2016-05-19-ccc_aserv_info_script,2016/05/19,ccc_aserv_info_script,0,0,0:00:00,0,0:00:00,0,0
2016-05-19-ccc_bylaw_script,2016/05/19,ccc_bylaw_script,0,0,0:00:00,0,0:00:00,0,0
2016-05-19-ccc_city_script,2016/05/19,ccc_city_script,18,17,0:00:29,29,0:03:04,1,493
2016-05-19-ccc_cty_online_script,2016/05/19,ccc_cty_online_script,0,0,0:00:00,0,0:00:00,0,0
2016-05-19-ccc_feedback_script,2016/05/19,ccc_feedback_script,1,0,0:00:00,0,0:00:00,1,0
2016-05-19-ccc_fpb_script,2016/05/19,ccc_fpb_script,0,0,0:00:00,0,0:00:00,0,0
2016-05-19-ccc_help_script,2016/05/19,ccc_help_script,15,13,0:00:26,26,0:01:22,2,338
2016-05-19-ccc_link_script,2016/05/19,ccc_link_script,0,0,0:00:00,0,0:00:00,0,0
2016-05-19-ccc_media_line_script,2016/05/19,ccc_media_line_script,0,0,0:00:00,0,0:00:00,0,0
2016-05-19-ccc_priority_script,2016/05/19,ccc_priority_script,26,26,0:00:23,23,0:03:54,0,598
2016-05-19-ccc_tax_script,2016/05/19,ccc_tax_script,11,10,0:02:05,125,0:07:52,1,1250
2016-05-19-ccc_waste_recycling_script,2016/05/19,ccc_waste_recycling_script,0,0,0:00:00,0,0:00:00,0,0
2016-05-20-ccc_311_calgary_script,2016/05/20,ccc_311_calgary_script,2883,2635,0:01:09,69,0:07:58,242,181815
2016-05-20-ccc_311_lobby_ph_script,2016/05/20,ccc_311_lobby_ph_script,0,0,0:00:00,0,0:00:00,0,0
2016-05-20-ccc_aserv_info_script,2016/05/20,ccc_aserv_info_script,0,0,0:00:00,0,0:00:00,0,0
2016-05-20-ccc_bylaw_script,2016/05/20,ccc_bylaw_script,0,0,0:00:00,0,0:00:00,0,0
2016-05-20-ccc_city_script,2016/05/20,ccc_city_script,14,14,0:00:17,17,0:00:47,0,238
2016-05-20-ccc_cty_online_script,2016/05/20,ccc_cty_online_script,0,0,0:00:00,0,0:00:00,0,0
2016-05-20-ccc_feedback_script,2016/05/20,ccc_feedback_script,0,0,0:00:00,0,0:00:00,0,0
2016-05-20-ccc_fpb_script,2016/05/20,ccc_fpb_script,1,0,0:00:00,0,0:00:00,1,0
2016-05-20-ccc_help_script,2016/05/20,ccc_help_script,16,16,0:00:11,11,0:00:27,0,176
2016-05-20-ccc_link_script,2016/05/20,ccc_link_script,0,0,0:00:00,0,0:00:00,0,0
2016-05-20-ccc_media_line_script,2016/05/20,ccc_media_line_script,1,1,0:00:05,5,0:00:05,0,5
2016-05-20-ccc_priority_script,2016/05/20,ccc_priority_script,24,17,0:00:17,17,0:00:51,0,289
2016-05-20-ccc_tax_script,2016/05/20,ccc_tax_script,15,13,0:01:03,63,0:03:34,2,819
2016-05-20-ccc_waste_recycling_script,2016/05/20,ccc_waste_recycling_script,0,0,0:00:00,0,0:00:00,0,0
2016-05-21-ccc_311_calgary_script,2016/05/21,ccc_311_calgary_script,997,982,0:00:10,10,0:04:32,15,9820
2016-05-21-ccc_311_lobby_ph_script,2016/05/21,ccc_311_lobby_ph_script,0,0,0:00:00,0,0:00:00,0,0
2016-05-21-ccc_aserv_info_script,2016/05/21,ccc_aserv_info_script,0,0,0:00:00,0,0:00:00,0,0
2016-05-21-ccc_bylaw_script,2016/05/21,ccc_bylaw_script,0,0,0:00:00,0,0:00:00,0,0
2016-05-21-ccc_city_script,2016/05/21,ccc_city_script,0,0,0:00:00,0,0:00:00,0,0
2016-05-21-ccc_cty_online_script,2016/05/21,ccc_cty_online_script,0,0,0:00:00,0,0:00:00,0,0
2016-05-21-ccc_feedback_script,2016/05/21,ccc_feedback_script,0,0,0:00:00,0,0:00:00,0,0
2016-05-21-ccc_fpb_script,2016/05/21,ccc_fpb_script,0,0,0:00:00,0,0:00:00,0,0
2016-05-21-ccc_help_script,2016/05/21,ccc_help_script,0,0,0:00:00,0,0:00:00,0,0
2016-05-21-ccc_link_script,2016/05/21,ccc_link_script,0,0,0:00:00,0,0:00:00,0,0
2016-05-21-ccc_media_line_script,2016/05/21,ccc_media_line_script,1,1,0:00:05,5,0:00:05,0,5
2016-05-21-ccc_priority_script,2016/05/21,ccc_priority_script,10,8,0:00:26,26,0:02:05,2,208
2016-05-21-ccc_tax_script,2016/05/21,ccc_tax_script,0,0,0:00:00,0,0:00:00,0,0
2016-05-21-ccc_waste_recycling_script,2016/05/21,ccc_waste_recycling_script,0,0,0:00:00,0,0:00:00,0,0
2016-05-22-ccc_311_calgary_script,2016/05/22,ccc_311_calgary_script,759,744,0:00:13,13,0:03:04,15,9672
2016-05-22-ccc_311_lobby_ph_script,2016/05/22,ccc_311_lobby_ph_script,0,0,0:00:00,0,0:00:00,0,0
2016-05-22-ccc_aserv_info_script,2016/05/22,ccc_aserv_info_script,0,0,0:00:00,0,0:00:00,0,0
2016-05-22-ccc_bylaw_script,2016/05/22,ccc_bylaw_script,0,0,0:00:00,0,0:00:00,0,0
2016-05-22-ccc_city_script,2016/05/22,ccc_city_script,0,0,0:00:00,0,0:00:00,0,0
2016-05-22-ccc_cty_online_script,2016/05/22,ccc_cty_online_script,0,0,0:00:00,0,0:00:00,0,0
2016-05-22-ccc_feedback_script,2016/05/22,ccc_feedback_script,0,0,0:00:00,0,0:00:00,0,0
2016-05-22-ccc_fpb_script,2016/05/22,ccc_fpb_script,0,0,0:00:00,0,0:00:00,0,0
2016-05-22-ccc_help_script,2016/05/22,ccc_help_script,2,2,0:00:03,3,0:00:04,0,6
2016-05-22-ccc_link_script,2016/05/22,ccc_link_script,0,0,0:00:00,0,0:00:00,0,0
2016-05-22-ccc_media_line_script,2016/05/22,ccc_media_line_script,2,2,0:00:05,5,0:00:08,0,10
2016-05-22-ccc_priority_script,2016/05/22,ccc_priority_script,12,12,0:00:13,13,0:01:18,0,156
2016-05-22-ccc_tax_script,2016/05/22,ccc_tax_script,0,0,0:00:00,0,0:00:00,0,0
2016-05-22-ccc_waste_recycling_script,2016/05/22,ccc_waste_recycling_script,0,0,0:00:00,0,0:00:00,0,0
2016-05-23-ccc_311_calgary_script,2016/05/23,ccc_311_calgary_script,1035,1014,0:00:11,11,0:05:12,21,11154
2016-05-23-ccc_311_lobby_ph_script,2016/05/23,ccc_311_lobby_ph_script,0,0,0:00:00,0,0:00:00,0,0
2016-05-23-ccc_aserv_info_script,2016/05/23,ccc_aserv_info_script,0,0,0:00:00,0,0:00:00,0,0
2016-05-23-ccc_bylaw_script,2016/05/23,ccc_bylaw_script,0,0,0:00:00,0,0:00:00,0,0
2016-05-23-ccc_city_script,2016/05/23,ccc_city_script,0,0,0:00:00,0,0:00:00,0,0
2016-05-23-ccc_cty_online_script,2016/05/23,ccc_cty_online_script,0,0,0:00:00,0,0:00:00,0,0
2016-05-23-ccc_feedback_script,2016/05/23,ccc_feedback_script,0,0,0:00:00,0,0:00:00,0,0
2016-05-23-ccc_fpb_script,2016/05/23,ccc_fpb_script,0,0,0:00:00,0,0:00:00,0,0
2016-05-23-ccc_help_script,2016/05/23,ccc_help_script,2,2,0:00:04,4,0:00:07,0,8
2016-05-23-ccc_link_script,2016/05/23,ccc_link_script,0,0,0:00:00,0,0:00:00,0,0
2016-05-23-ccc_media_line_script,2016/05/23,ccc_media_line_script,9,9,0:00:08,8,0:00:35,0,72
2016-05-23-ccc_priority_script,2016/05/23,ccc_priority_script,18,17,0:00:15,15,0:01:48,1,255
2016-05-23-ccc_tax_script,2016/05/23,ccc_tax_script,0,0,0:00:00,0,0:00:00,0,0
2016-05-23-ccc_waste_recycling_script,2016/05/23,ccc_waste_recycling_script,0,0,0:00:00,0,0:00:00,0,0
2016-05-24-ccc_311_calgary_script,2016/05/24,ccc_311_calgary_script,3801,3578,0:00:42,42,0:28:04,223,150276
2016-05-24-ccc_311_lobby_ph_script,2016/05/24,ccc_311_lobby_ph_script,2,1,0:00:09,9,0:00:09,1,9
2016-05-24-ccc_aserv_info_script,2016/05/24,ccc_aserv_info_script,0,0,0:00:00,0,0:00:00,0,0
2016-05-24-ccc_bylaw_script,2016/05/24,ccc_bylaw_script,0,0,0:00:00,0,0:00:00,0,0
2016-05-24-ccc_city_script,2016/05/24,ccc_city_script,43,43,0:00:08,8,0:00:33,0,344
2016-05-24-ccc_cty_online_script,2016/05/24,ccc_cty_online_script,0,0,0:00:00,0,0:00:00,0,0
2016-05-24-ccc_feedback_script,2016/05/24,ccc_feedback_script,0,0,0:00:00,0,0:00:00,0,0
2016-05-24-ccc_fpb_script,2016/05/24,ccc_fpb_script,0,0,0:00:00,0,0:00:00,0,0
2016-05-24-ccc_help_script,2016/05/24,ccc_help_script,18,17,0:00:10,10,0:00:36,1,170
2016-05-24-ccc_link_script,2016/05/24,ccc_link_script,0,0,0:00:00,0,0:00:00,0,0
2016-05-24-ccc_media_line_script,2016/05/24,ccc_media_line_script,0,0,0:00:00,0,0:00:00,0,0
2016-05-24-ccc_priority_script,2016/05/24,ccc_priority_script,36,33,0:00:32,32,0:07:32,3,1056
2016-05-24-ccc_tax_script,2016/05/24,ccc_tax_script,13,12,0:00:20,20,0:01:02,1,240
2016-05-24-ccc_waste_recycling_script,2016/05/24,ccc_waste_recycling_script,0,0,0:00:00,0,0:00:00,0,0
2016-05-25-ccc_311_calgary_script,2016/05/25,ccc_311_calgary_script,3577,3033,0:02:21,141,0:11:30,544,427653
2016-05-25-ccc_311_lobby_ph_script,2016/05/25,ccc_311_lobby_ph_script,6,5,0:00:12,12,0:00:24,1,60
2016-05-25-ccc_aserv_info_script,2016/05/25,ccc_aserv_info_script,0,0,0:00:00,0,0:00:00,0,0
2016-05-25-ccc_bylaw_script,2016/05/25,ccc_bylaw_script,0,0,0:00:00,0,0:00:00,0,0
2016-05-25-ccc_city_script,2016/05/25,ccc_city_script,31,31,0:00:27,27,0:03:12,0,837
2016-05-25-ccc_cty_online_script,2016/05/25,ccc_cty_online_script,0,0,0:00:00,0,0:00:00,0,0
2016-05-25-ccc_feedback_script,2016/05/25,ccc_feedback_script,0,0,0:00:00,0,0:00:00,0,0
2016-05-25-ccc_fpb_script,2016/05/25,ccc_fpb_script,0,0,0:00:00,0,0:00:00,0,0
2016-05-25-ccc_help_script,2016/05/25,ccc_help_script,42,35,0:00:17,17,0:01:58,7,595
2016-05-25-ccc_link_script,2016/05/25,ccc_link_script,0,0,0:00:00,0,0:00:00,0,0
2016-05-25-ccc_media_line_script,2016/05/25,ccc_media_line_script,1,1,0:00:10,10,0:00:10,0,10
2016-05-25-ccc_priority_script,2016/05/25,ccc_priority_script,36,35,0:00:13,13,0:00:49,1,455
2016-05-25-ccc_tax_script,2016/05/25,ccc_tax_script,29,21,0:02:22,142,0:06:40,8,2982
2016-05-25-ccc_waste_recycling_script,2016/05/25,ccc_waste_recycling_script,0,0,0:00:00,0,0:00:00,0,0
2016-05-26-ccc_311_calgary_script,2016/05/26,ccc_311_calgary_script,3663,3121,0:02:12,132,0:17:21,542,411972
2016-05-26-ccc_311_lobby_ph_script,2016/05/26,ccc_311_lobby_ph_script,8,7,0:00:10,10,0:00:20,1,70
2016-05-26-ccc_aserv_info_script,2016/05/26,ccc_aserv_info_script,0,0,0:00:00,0,0:00:00,0,0
2016-05-26-ccc_bylaw_script,2016/05/26,ccc_bylaw_script,0,0,0:00:00,0,0:00:00,0,0
2016-05-26-ccc_city_script,2016/05/26,ccc_city_script,22,21,0:01:45,105,0:05:24,1,2205
2016-05-26-ccc_cty_online_script,2016/05/26,ccc_cty_online_script,0,0,0:00:00,0,0:00:00,0,0
2016-05-26-ccc_feedback_script,2016/05/26,ccc_feedback_script,0,0,0:00:00,0,0:00:00,0,0
2016-05-26-ccc_fpb_script,2016/05/26,ccc_fpb_script,0,0,0:00:00,0,0:00:00,0,0
2016-05-26-ccc_help_script,2016/05/26,ccc_help_script,30,23,0:00:20,20,0:00:56,5,460
2016-05-26-ccc_link_script,2016/05/26,ccc_link_script,0,0,0:00:00,0,0:00:00,0,0
2016-05-26-ccc_media_line_script,2016/05/26,ccc_media_line_script,0,0,0:00:00,0,0:00:00,0,0
2016-05-26-ccc_priority_script,2016/05/26,ccc_priority_script,34,32,0:00:18,18,0:02:37,2,576
2016-05-26-ccc_tax_script,2016/05/26,ccc_tax_script,24,22,0:02:25,145,0:06:04,2,3190
2016-05-26-ccc_waste_recycling_script,2016/05/26,ccc_waste_recycling_script,0,0,0:00:00,0,0:00:00,0,0
2016-05-27-ccc_311_calgary_script,2016/05/27,ccc_311_calgary_script,3422,2639,0:03:35,215,0:17:39,783,567385
2016-05-27-ccc_311_lobby_ph_script,2016/05/27,ccc_311_lobby_ph_script,1,1,0:00:26,26,0:00:26,0,26
2016-05-27-ccc_aserv_info_script,2016/05/27,ccc_aserv_info_script,0,0,0:00:00,0,0:00:00,0,0
2016-05-27-ccc_bylaw_script,2016/05/27,ccc_bylaw_script,0,0,0:00:00,0,0:00:00,0,0
2016-05-27-ccc_city_script,2016/05/27,ccc_city_script,23,23,0:00:26,26,0:03:08,0,598
2016-05-27-ccc_cty_online_script,2016/05/27,ccc_cty_online_script,0,0,0:00:00,0,0:00:00,0,0
2016-05-27-ccc_feedback_script,2016/05/27,ccc_feedback_script,0,0,0:00:00,0,0:00:00,0,0
2016-05-27-ccc_fpb_script,2016/05/27,ccc_fpb_script,0,0,0:00:00,0,0:00:00,0,0
2016-05-27-ccc_help_script,2016/05/27,ccc_help_script,14,13,0:00:18,18,0:01:12,1,234
2016-05-27-ccc_link_script,2016/05/27,ccc_link_script,0,0,0:00:00,0,0:00:00,0,0
2016-05-27-ccc_media_line_script,2016/05/27,ccc_media_line_script,1,1,0:00:07,7,0:00:07,0,7
2016-05-27-ccc_priority_script,2016/05/27,ccc_priority_script,42,38,0:00:22,22,0:04:22,3,836
2016-05-27-ccc_tax_script,2016/05/27,ccc_tax_script,22,19,0:04:23,263,0:09:05,3,4997
2016-05-27-ccc_waste_recycling_script,2016/05/27,ccc_waste_recycling_script,0,0,0:00:00,0,0:00:00,0,0
2016-05-28-ccc_311_calgary_script,2016/05/28,ccc_311_calgary_script,1448,1296,0:01:19,79,0:09:46,152,102384
2016-05-28-ccc_311_lobby_ph_script,2016/05/28,ccc_311_lobby_ph_script,0,0,0:00:00,0,0:00:00,0,0
2016-05-28-ccc_aserv_info_script,2016/05/28,ccc_aserv_info_script,0,0,0:00:00,0,0:00:00,0,0
2016-05-28-ccc_bylaw_script,2016/05/28,ccc_bylaw_script,0,0,0:00:00,0,0:00:00,0,0
2016-05-28-ccc_city_script,2016/05/28,ccc_city_script,0,0,0:00:00,0,0:00:00,0,0
2016-05-28-ccc_cty_online_script,2016/05/28,ccc_cty_online_script,0,0,0:00:00,0,0:00:00,0,0
2016-05-28-ccc_feedback_script,2016/05/28,ccc_feedback_script,1,0,0:00:00,0,0:00:00,0,0
2016-05-28-ccc_fpb_script,2016/05/28,ccc_fpb_script,0,0,0:00:00,0,0:00:00,0,0
2016-05-28-ccc_help_script,2016/05/28,ccc_help_script,9,8,0:01:13,73,0:04:21,1,584
2016-05-28-ccc_link_script,2016/05/28,ccc_link_script,0,0,0:00:00,0,0:00:00,0,0
2016-05-28-ccc_media_line_script,2016/05/28,ccc_media_line_script,0,0,0:00:00,0,0:00:00,0,0
2016-05-28-ccc_priority_script,2016/05/28,ccc_priority_script,33,32,0:00:25,25,0:02:30,2,800
2016-05-28-ccc_tax_script,2016/05/28,ccc_tax_script,0,0,0:00:00,0,0:00:00,0,0
2016-05-28-ccc_waste_recycling_script,2016/05/28,ccc_waste_recycling_script,0,0,0:00:00,0,0:00:00,0,0
2016-05-29-ccc_311_calgary_script,2016/05/29,ccc_311_calgary_script,1245,1142,0:00:49,49,0:11:53,103,55958
2016-05-29-ccc_311_lobby_ph_script,2016/05/29,ccc_311_lobby_ph_script,0,0,0:00:00,0,0:00:00,0,0
2016-05-29-ccc_aserv_info_script,2016/05/29,ccc_aserv_info_script,0,0,0:00:00,0,0:00:00,0,0
2016-05-29-ccc_bylaw_script,2016/05/29,ccc_bylaw_script,0,0,0:00:00,0,0:00:00,0,0
2016-05-29-ccc_city_script,2016/05/29,ccc_city_script,0,0,0:00:00,0,0:00:00,0,0
2016-05-29-ccc_cty_online_script,2016/05/29,ccc_cty_online_script,0,0,0:00:00,0,0:00:00,0,0
2016-05-29-ccc_feedback_script,2016/05/29,ccc_feedback_script,0,0,0:00:00,0,0:00:00,0,0
2016-05-29-ccc_fpb_script,2016/05/29,ccc_fpb_script,0,0,0:00:00,0,0:00:00,0,0
2016-05-29-ccc_help_script,2016/05/29,ccc_help_script,5,4,0:00:06,6,0:00:10,1,24
2016-05-29-ccc_link_script,2016/05/29,ccc_link_script,0,0,0:00:00,0,0:00:00,0,0
2016-05-29-ccc_media_line_script,2016/05/29,ccc_media_line_script,1,1,0:00:10,10,0:00:10,0,10
2016-05-29-ccc_priority_script,2016/05/29,ccc_priority_script,20,19,0:00:21,21,0:01:29,1,399
2016-05-29-ccc_tax_script,2016/05/29,ccc_tax_script,2,2,0:02:45,165,0:05:28,0,330
2016-05-29-ccc_waste_recycling_script,2016/05/29,ccc_waste_recycling_script,0,0,0:00:00,0,0:00:00,0,0
2016-05-30-ccc_311_calgary_script,2016/05/30,ccc_311_calgary_script,5154,3943,0:04:21,261,0:25:32,1211,1029123
2016-05-30-ccc_311_lobby_ph_script,2016/05/30,ccc_311_lobby_ph_script,2,2,0:00:06,6,0:00:06,0,12
2016-05-30-ccc_aserv_info_script,2016/05/30,ccc_aserv_info_script,0,0,0:00:00,0,0:00:00,0,0
2016-05-30-ccc_bylaw_script,2016/05/30,ccc_bylaw_script,0,0,0:00:00,0,0:00:00,0,0
2016-05-30-ccc_city_script,2016/05/30,ccc_city_script,21,21,0:00:31,31,0:02:25,0,651
2016-05-30-ccc_cty_online_script,2016/05/30,ccc_cty_online_script,0,0,0:00:00,0,0:00:00,0,0
2016-05-30-ccc_feedback_script,2016/05/30,ccc_feedback_script,0,0,0:00:00,0,0:00:00,0,0
2016-05-30-ccc_fpb_script,2016/05/30,ccc_fpb_script,0,0,0:00:00,0,0:00:00,0,0
2016-05-30-ccc_help_script,2016/05/30,ccc_help_script,31,27,0:00:20,20,0:01:34,4,540
2016-05-30-ccc_link_script,2016/05/30,ccc_link_script,0,0,0:00:00,0,0:00:00,0,0
2016-05-30-ccc_media_line_script,2016/05/30,ccc_media_line_script,1,1,0:01:34,94,0:01:34,0,94
2016-05-30-ccc_priority_script,2016/05/30,ccc_priority_script,46,46,0:00:19,19,0:02:40,0,874
2016-05-30-ccc_tax_script,2016/05/30,ccc_tax_script,22,19,0:03:03,183,0:08:27,3,3477
2016-05-30-ccc_waste_recycling_script,2016/05/30,ccc_waste_recycling_script,0,0,0:00:00,0,0:00:00,0,0
2016-05-31-ccc_311_calgary_script,2016/05/31,ccc_311_calgary_script,6165,4006,0:07:57,477,0:15:50,2159,1910862
2016-05-31-ccc_311_lobby_ph_script,2016/05/31,ccc_311_lobby_ph_script,2,2,0:00:06,6,0:00:09,0,12
2016-05-31-ccc_aserv_info_script,2016/05/31,ccc_aserv_info_script,0,0,0:00:00,0,0:00:00,0,0
2016-05-31-ccc_bylaw_script,2016/05/31,ccc_bylaw_script,0,0,0:00:00,0,0:00:00,0,0
2016-05-31-ccc_city_script,2016/05/31,ccc_city_script,8,6,0:04:30,270,0:11:34,2,1620
2016-05-31-ccc_cty_online_script,2016/05/31,ccc_cty_online_script,0,0,0:00:00,0,0:00:00,0,0
2016-05-31-ccc_feedback_script,2016/05/31,ccc_feedback_script,0,0,0:00:00,0,0:00:00,0,0
2016-05-31-ccc_fpb_script,2016/05/31,ccc_fpb_script,2,0,0:00:00,0,0:00:00,2,0
2016-05-31-ccc_help_script,2016/05/31,ccc_help_script,23,21,0:00:17,17,0:01:12,2,357
2016-05-31-ccc_link_script,2016/05/31,ccc_link_script,0,0,0:00:00,0,0:00:00,0,0
2016-05-31-ccc_media_line_script,2016/05/31,ccc_media_line_script,4,3,0:00:04,4,0:00:06,1,12
2016-05-31-ccc_priority_script,2016/05/31,ccc_priority_script,40,38,0:00:15,15,0:00:47,2,570
2016-05-31-ccc_tax_script,2016/05/31,ccc_tax_script,19,10,0:09:42,582,0:15:28,9,5820
2016-05-31-ccc_waste_recycling_script,2016/05/31,ccc_waste_recycling_script,0,0,0:00:00,0,0:00:00,0,0
2016-06-01-ccc_311_calgary_script,2016/06/01,ccc_311_calgary_script,5769,3698,0:08:25,505,0:17:53,2071,1867490
2016-06-01-ccc_311_lobby_ph_script,2016/06/01,ccc_311_lobby_ph_script,3,2,0:00:09,9,0:00:09,1,18
2016-06-01-ccc_aserv_info_script,2016/06/01,ccc_aserv_info_script,0,0,0:00:00,0,0:00:00,0,0
2016-06-01-ccc_bylaw_script,2016/06/01,ccc_bylaw_script,0,0,0:00:00,0,0:00:00,0,0
2016-06-01-ccc_city_script,2016/06/01,ccc_city_script,21,19,0:03:39,219,0:16:07,2,4161
2016-06-01-ccc_cty_online_script,2016/06/01,ccc_cty_online_script,0,0,0:00:00,0,0:00:00,0,0
2016-06-01-ccc_feedback_script,2016/06/01,ccc_feedback_script,0,0,0:00:00,0,0:00:00,0,0
2016-06-01-ccc_fpb_script,2016/06/01,ccc_fpb_script,0,0,0:00:00,0,0:00:00,0,0
2016-06-01-ccc_help_script,2016/06/01,ccc_help_script,24,22,0:00:17,17,0:00:52,2,374
2016-06-01-ccc_link_script,2016/06/01,ccc_link_script,0,0,0:00:00,0,0:00:00,0,0
2016-06-01-ccc_media_line_script,2016/06/01,ccc_media_line_script,0,0,0:00:00,0,0:00:00,0,0
2016-06-01-ccc_priority_script,2016/06/01,ccc_priority_script,40,40,0:00:21,21,0:01:59,0,840
2016-06-01-ccc_tax_script,2016/06/01,ccc_tax_script,27,13,0:10:32,632,0:14:50,14,8216
2016-06-01-ccc_waste_recycling_script,2016/06/01,ccc_waste_recycling_script,0,0,0:00:00,0,0:00:00,0,0
2016-06-02-ccc_311_calgary_script,2016/06/02,ccc_311_calgary_script,4914,3909,0:03:50,230,0:09:55,1005,899070
2016-06-02-ccc_311_lobby_ph_script,2016/06/02,ccc_311_lobby_ph_script,2,1,0:00:09,9,0:00:09,1,9
2016-06-02-ccc_aserv_info_script,2016/06/02,ccc_aserv_info_script,0,0,0:00:00,0,0:00:00,0,0
2016-06-02-ccc_bylaw_script,2016/06/02,ccc_bylaw_script,0,0,0:00:00,0,0:00:00,0,0
2016-06-02-ccc_city_script,2016/06/02,ccc_city_script,16,16,0:00:49,49,0:05:22,0,784
2016-06-02-ccc_cty_online_script,2016/06/02,ccc_cty_online_script,0,0,0:00:00,0,0:00:00,0,0
2016-06-02-ccc_feedback_script,2016/06/02,ccc_feedback_script,0,0,0:00:00,0,0:00:00,0,0
2016-06-02-ccc_fpb_script,2016/06/02,ccc_fpb_script,1,0,0:00:00,0,0:00:00,1,0
2016-06-02-ccc_help_script,2016/06/02,ccc_help_script,22,18,0:00:14,14,0:00:50,4,252
2016-06-02-ccc_link_script,2016/06/02,ccc_link_script,0,0,0:00:00,0,0:00:00,0,0
2016-06-02-ccc_media_line_script,2016/06/02,ccc_media_line_script,0,0,0:00:00,0,0:00:00,0,0
2016-06-02-ccc_priority_script,2016/06/02,ccc_priority_script,37,34,0:00:15,15,0:01:04,3,510
2016-06-02-ccc_tax_script,2016/06/02,ccc_tax_script,27,20,0:04:27,267,0:08:05,7,5340
2016-06-02-ccc_waste_recycling_script,2016/06/02,ccc_waste_recycling_script,0,0,0:00:00,0,0:00:00,0,0
2016-06-03-ccc_311_calgary_script,2016/06/03,ccc_311_calgary_script,4317,3292,0:04:33,273,0:11:10,1025,898716
2016-06-03-ccc_311_lobby_ph_script,2016/06/03,ccc_311_lobby_ph_script,1,0,0:00:00,0,0:00:00,1,0
2016-06-03-ccc_aserv_info_script,2016/06/03,ccc_aserv_info_script,0,0,0:00:00,0,0:00:00,0,0
2016-06-03-ccc_bylaw_script,2016/06/03,ccc_bylaw_script,0,0,0:00:00,0,0:00:00,0,0
2016-06-03-ccc_city_script,2016/06/03,ccc_city_script,12,10,0:02:19,139,0:07:41,2,1390
2016-06-03-ccc_cty_online_script,2016/06/03,ccc_cty_online_script,0,0,0:00:00,0,0:00:00,0,0
2016-06-03-ccc_feedback_script,2016/06/03,ccc_feedback_script,0,0,0:00:00,0,0:00:00,0,0
2016-06-03-ccc_fpb_script,2016/06/03,ccc_fpb_script,0,0,0:00:00,0,0:00:00,0,0
2016-06-03-ccc_help_script,2016/06/03,ccc_help_script,28,26,0:00:10,10,0:00:42,2,260
2016-06-03-ccc_link_script,2016/06/03,ccc_link_script,0,0,0:00:00,0,0:00:00,0,0
2016-06-03-ccc_media_line_script,2016/06/03,ccc_media_line_script,3,3,0:00:30,30,0:00:59,0,90
2016-06-03-ccc_priority_script,2016/06/03,ccc_priority_script,30,29,0:00:13,13,0:00:40,1,377
2016-06-03-ccc_tax_script,2016/06/03,ccc_tax_script,20,11,0:05:03,303,0:09:46,9,3333
2016-06-03-ccc_waste_recycling_script,2016/06/03,ccc_waste_recycling_script,0,0,0:00:00,0,0:00:00,0,0
2016-06-04-ccc_311_calgary_script,2016/06/04,ccc_311_calgary_script,1769,1616,0:00:57,57,0:12:52,153,92112
2016-06-04-ccc_311_lobby_ph_script,2016/06/04,ccc_311_lobby_ph_script,0,0,0:00:00,0,0:00:00,0,0
2016-06-04-ccc_aserv_info_script,2016/06/04,ccc_aserv_info_script,0,0,0:00:00,0,0:00:00,0,0
2016-06-04-ccc_bylaw_script,2016/06/04,ccc_bylaw_script,0,0,0:00:00,0,0:00:00,0,0
2016-06-04-ccc_city_script,2016/06/04,ccc_city_script,0,0,0:00:00,0,0:00:00,0,0
2016-06-04-ccc_cty_online_script,2016/06/04,ccc_cty_online_script,0,0,0:00:00,0,0:00:00,0,0
2016-06-04-ccc_feedback_script,2016/06/04,ccc_feedback_script,0,0,0:00:00,0,0:00:00,0,0
2016-06-04-ccc_fpb_script,2016/06/04,ccc_fpb_script,0,0,0:00:00,0,0:00:00,0,0
2016-06-04-ccc_help_script,2016/06/04,ccc_help_script,7,7,0:00:14,14,0:00:33,0,98
2016-06-04-ccc_link_script,2016/06/04,ccc_link_script,0,0,0:00:00,0,0:00:00,0,0
2016-06-04-ccc_media_line_script,2016/06/04,ccc_media_line_script,1,1,0:00:08,8,0:00:08,0,8
2016-06-04-ccc_priority_script,2016/06/04,ccc_priority_script,28,28,0:00:16,16,0:01:26,0,448
2016-06-04-ccc_tax_script,2016/06/04,ccc_tax_script,0,0,0:00:00,0,0:00:00,0,0
2016-06-04-ccc_waste_recycling_script,2016/06/04,ccc_waste_recycling_script,0,0,0:00:00,0,0:00:00,0,0
2016-06-05-ccc_311_calgary_script,2016/06/05,ccc_311_calgary_script,1367,1296,0:00:40,40,0:11:17,71,51840
2016-06-05-ccc_311_lobby_ph_script,2016/06/05,ccc_311_lobby_ph_script,0,0,0:00:00,0,0:00:00,0,0
2016-06-05-ccc_aserv_info_script,2016/06/05,ccc_aserv_info_script,0,0,0:00:00,0,0:00:00,0,0
2016-06-05-ccc_bylaw_script,2016/06/05,ccc_bylaw_script,0,0,0:00:00,0,0:00:00,0,0
2016-06-05-ccc_city_script,2016/06/05,ccc_city_script,0,0,0:00:00,0,0:00:00,0,0
2016-06-05-ccc_cty_online_script,2016/06/05,ccc_cty_online_script,0,0,0:00:00,0,0:00:00,0,0
2016-06-05-ccc_feedback_script,2016/06/05,ccc_feedback_script,0,0,0:00:00,0,0:00:00,0,0
2016-06-05-ccc_fpb_script,2016/06/05,ccc_fpb_script,0,0,0:00:00,0,0:00:00,0,0
2016-06-05-ccc_help_script,2016/06/05,ccc_help_script,1,1,0:00:09,9,0:00:09,0,9
2016-06-05-ccc_link_script,2016/06/05,ccc_link_script,0,0,0:00:00,0,0:00:00,0,0
2016-06-05-ccc_media_line_script,2016/06/05,ccc_media_line_script,1,1,0:00:02,2,0:00:02,0,2
2016-06-05-ccc_priority_script,2016/06/05,ccc_priority_script,27,26,0:00:18,18,0:01:16,1,468
2016-06-05-ccc_tax_script,2016/06/05,ccc_tax_script,0,0,0:00:00,0,0:00:00,0,0
2016-06-05-ccc_waste_recycling_script,2016/06/05,ccc_waste_recycling_script,0,0,0:00:00,0,0:00:00,0,0
2016-06-06-ccc_311_calgary_script,2016/06/06,ccc_311_calgary_script,5293,4085,0:04:23,263,0:13:42,1208,1074355
2016-06-06-ccc_311_lobby_ph_script,2016/06/06,ccc_311_lobby_ph_script,1,0,0:00:00,0,0:00:00,1,0
2016-06-06-ccc_aserv_info_script,2016/06/06,ccc_aserv_info_script,0,0,0:00:00,0,0:00:00,0,0
2016-06-06-ccc_bylaw_script,2016/06/06,ccc_bylaw_script,0,0,0:00:00,0,0:00:00,0,0
2016-06-06-ccc_city_script,2016/06/06,ccc_city_script,33,30,0:01:30,90,0:09:50,3,2700
2016-06-06-ccc_cty_online_script,2016/06/06,ccc_cty_online_script,0,0,0:00:00,0,0:00:00,0,0
2016-06-06-ccc_feedback_script,2016/06/06,ccc_feedback_script,0,0,0:00:00,0,0:00:00,0,0
2016-06-06-ccc_fpb_script,2016/06/06,ccc_fpb_script,0,0,0:00:00,0,0:00:00,0,0
2016-06-06-ccc_help_script,2016/06/06,ccc_help_script,45,42,0:00:10,10,0:00:29,3,420
2016-06-06-ccc_link_script,2016/06/06,ccc_link_script,0,0,0:00:00,0,0:00:00,0,0
2016-06-06-ccc_media_line_script,2016/06/06,ccc_media_line_script,1,0,0:00:00,0,0:00:00,1,0
2016-06-06-ccc_priority_script,2016/06/06,ccc_priority_script,31,30,0:00:30,30,0:02:46,1,900
2016-06-06-ccc_tax_script,2016/06/06,ccc_tax_script,21,15,0:03:53,233,0:08:59,6,3495
2016-06-06-ccc_waste_recycling_script,2016/06/06,ccc_waste_recycling_script,0,0,0:00:00,0,0:00:00,0,0
2016-06-07-ccc_311_calgary_script,2016/06/07,ccc_311_calgary_script,5192,3863,0:05:08,308,0:28:08,1328,1189804
2016-06-07-ccc_311_lobby_ph_script,2016/06/07,ccc_311_lobby_ph_script,5,3,0:00:12,12,0:00:15,2,36
2016-06-07-ccc_aserv_info_script,2016/06/07,ccc_aserv_info_script,0,0,0:00:00,0,0:00:00,0,0
2016-06-07-ccc_bylaw_script,2016/06/07,ccc_bylaw_script,0,0,0:00:00,0,0:00:00,0,0
2016-06-07-ccc_city_script,2016/06/07,ccc_city_script,27,24,0:01:11,71,0:06:34,3,1704
2016-06-07-ccc_cty_online_script,2016/06/07,ccc_cty_online_script,0,0,0:00:00,0,0:00:00,0,0
2016-06-07-ccc_feedback_script,2016/06/07,ccc_feedback_script,0,0,0:00:00,0,0:00:00,0,0
2016-06-07-ccc_fpb_script,2016/06/07,ccc_fpb_script,8,2,0:05:50,350,0:07:11,6,700
2016-06-07-ccc_help_script,2016/06/07,ccc_help_script,22,22,0:00:07,7,0:00:21,0,154
2016-06-07-ccc_link_script,2016/06/07,ccc_link_script,0,0,0:00:00,0,0:00:00,0,0
2016-06-07-ccc_media_line_script,2016/06/07,ccc_media_line_script,0,0,0:00:00,0,0:00:00,0,0
2016-06-07-ccc_priority_script,2016/06/07,ccc_priority_script,40,38,0:00:15,15,0:00:59,2,570
2016-06-07-ccc_tax_script,2016/06/07,ccc_tax_script,28,23,0:05:47,347,0:20:14,5,7981
2016-06-07-ccc_waste_recycling_script,2016/06/07,ccc_waste_recycling_script,0,0,0:00:00,0,0:00:00,0,0
2016-06-08-ccc_311_calgary_script,2016/06/08,ccc_311_calgary_script,4809,3599,0:04:51,291,0:22:50,1211,1047309
2016-06-08-ccc_311_lobby_ph_script,2016/06/08,ccc_311_lobby_ph_script,3,1,0:00:19,19,0:00:19,2,19
2016-06-08-ccc_aserv_info_script,2016/06/08,ccc_aserv_info_script,0,0,0:00:00,0,0:00:00,0,0
2016-06-08-ccc_bylaw_script,2016/06/08,ccc_bylaw_script,0,0,0:00:00,0,0:00:00,0,0
2016-06-08-ccc_city_script,2016/06/08,ccc_city_script,30,27,0:01:39,99,0:08:42,3,2673
2016-06-08-ccc_cty_online_script,2016/06/08,ccc_cty_online_script,0,0,0:00:00,0,0:00:00,0,0
2016-06-08-ccc_feedback_script,2016/06/08,ccc_feedback_script,0,0,0:00:00,0,0:00:00,0,0
2016-06-08-ccc_fpb_script,2016/06/08,ccc_fpb_script,1,1,0:03:16,196,0:03:16,0,196
2016-06-08-ccc_help_script,2016/06/08,ccc_help_script,32,31,0:00:12,12,0:00:40,1,372
2016-06-08-ccc_link_script,2016/06/08,ccc_link_script,0,0,0:00:00,0,0:00:00,0,0
2016-06-08-ccc_media_line_script,2016/06/08,ccc_media_line_script,0,0,0:00:00,0,0:00:00,0,0
2016-06-08-ccc_priority_script,2016/06/08,ccc_priority_script,35,33,0:00:24,24,0:03:39,2,792
2016-06-08-ccc_tax_script,2016/06/08,ccc_tax_script,14,10,0:06:38,398,0:09:48,4,3980
2016-06-08-ccc_waste_recycling_script,2016/06/08,ccc_waste_recycling_script,0,0,0:00:00,0,0:00:00,0,0
2016-06-09-ccc_311_calgary_script,2016/06/09,ccc_311_calgary_script,4526,3430,0:05:04,304,0:11:25,1096,1042720
2016-06-09-ccc_311_lobby_ph_script,2016/06/09,ccc_311_lobby_ph_script,4,4,0:00:10,10,0:00:21,0,40
2016-06-09-ccc_aserv_info_script,2016/06/09,ccc_aserv_info_script,0,0,0:00:00,0,0:00:00,0,0
2016-06-09-ccc_bylaw_script,2016/06/09,ccc_bylaw_script,0,0,0:00:00,0,0:00:00,0,0
2016-06-09-ccc_city_script,2016/06/09,ccc_city_script,37,32,0:02:15,135,0:07:47,5,4320
2016-06-09-ccc_cty_online_script,2016/06/09,ccc_cty_online_script,0,0,0:00:00,0,0:00:00,0,0
2016-06-09-ccc_feedback_script,2016/06/09,ccc_feedback_script,0,0,0:00:00,0,0:00:00,0,0
2016-06-09-ccc_fpb_script,2016/06/09,ccc_fpb_script,1,1,0:05:28,328,0:05:28,0,328
2016-06-09-ccc_help_script,2016/06/09,ccc_help_script,37,32,0:00:12,12,0:00:51,5,384
2016-06-09-ccc_link_script,2016/06/09,ccc_link_script,0,0,0:00:00,0,0:00:00,0,0
2016-06-09-ccc_media_line_script,2016/06/09,ccc_media_line_script,2,1,0:00:08,8,0:00:08,1,8
2016-06-09-ccc_priority_script,2016/06/09,ccc_priority_script,38,37,0:00:12,12,0:00:27,1,444
2016-06-09-ccc_tax_script,2016/06/09,ccc_tax_script,17,15,0:04:59,299,0:09:10,2,4485
2016-06-09-ccc_waste_recycling_script,2016/06/09,ccc_waste_recycling_script,0,0,0:00:00,0,0:00:00,0,0
2016-06-10-ccc_311_calgary_script,2016/06/10,ccc_311_calgary_script,3865,3351,0:02:27,147,0:09:06,514,492597
2016-06-10-ccc_311_lobby_ph_script,2016/06/10,ccc_311_lobby_ph_script,0,0,0:00:00,0,0:00:00,0,0
2016-06-10-ccc_aserv_info_script,2016/06/10,ccc_aserv_info_script,0,0,0:00:00,0,0:00:00,0,0
2016-06-10-ccc_bylaw_script,2016/06/10,ccc_bylaw_script,0,0,0:00:00,0,0:00:00,0,0
2016-06-10-ccc_city_script,2016/06/10,ccc_city_script,22,21,0:00:56,56,0:06:21,1,1176
2016-06-10-ccc_cty_online_script,2016/06/10,ccc_cty_online_script,0,0,0:00:00,0,0:00:00,0,0
2016-06-10-ccc_feedback_script,2016/06/10,ccc_feedback_script,0,0,0:00:00,0,0:00:00,0,0
2016-06-10-ccc_fpb_script,2016/06/10,ccc_fpb_script,1,1,0:00:04,4,0:00:04,0,4
2016-06-10-ccc_help_script,2016/06/10,ccc_help_script,19,18,0:00:08,8,0:00:19,1,144
2016-06-10-ccc_link_script,2016/06/10,ccc_link_script,1,0,0:00:00,0,0:00:00,1,0
2016-06-10-ccc_media_line_script,2016/06/10,ccc_media_line_script,0,0,0:00:00,0,0:00:00,0,0
2016-06-10-ccc_priority_script,2016/06/10,ccc_priority_script,29,29,0:00:13,13,0:01:19,0,377
2016-06-10-ccc_tax_script,2016/06/10,ccc_tax_script,18,16,0:01:54,114,0:05:50,2,1824
2016-06-10-ccc_waste_recycling_script,2016/06/10,ccc_waste_recycling_script,0,0,0:00:00,0,0:00:00,0,0
2016-06-11-ccc_311_calgary_script,2016/06/11,ccc_311_calgary_script,1450,1412,0:00:22,22,0:09:18,38,31064
2016-06-11-ccc_311_lobby_ph_script,2016/06/11,ccc_311_lobby_ph_script,0,0,0:00:00,0,0:00:00,0,0
2016-06-11-ccc_aserv_info_script,2016/06/11,ccc_aserv_info_script,0,0,0:00:00,0,0:00:00,0,0
2016-06-11-ccc_bylaw_script,2016/06/11,ccc_bylaw_script,0,0,0:00:00,0,0:00:00,0,0
2016-06-11-ccc_city_script,2016/06/11,ccc_city_script,0,0,0:00:00,0,0:00:00,0,0
2016-06-11-ccc_cty_online_script,2016/06/11,ccc_cty_online_script,0,0,0:00:00,0,0:00:00,0,0
2016-06-11-ccc_feedback_script,2016/06/11,ccc_feedback_script,0,0,0:00:00,0,0:00:00,0,0
2016-06-11-ccc_fpb_script,2016/06/11,ccc_fpb_script,2,2,0:00:06,6,0:00:10,0,12
2016-06-11-ccc_help_script,2016/06/11,ccc_help_script,7,6,0:00:04,4,0:00:11,1,24
2016-06-11-ccc_link_script,2016/06/11,ccc_link_script,0,0,0:00:00,0,0:00:00,0,0
2016-06-11-ccc_media_line_script,2016/06/11,ccc_media_line_script,0,0,0:00:00,0,0:00:00,0,0
2016-06-11-ccc_priority_script,2016/06/11,ccc_priority_script,34,33,0:00:14,14,0:01:32,1,462
2016-06-11-ccc_tax_script,2016/06/11,ccc_tax_script,0,0,0:00:00,0,0:00:00,0,0
2016-06-11-ccc_waste_recycling_script,2016/06/11,ccc_waste_recycling_script,0,0,0:00:00,0,0:00:00,0,0
2016-06-12-ccc_311_calgary_script,2016/06/12,ccc_311_calgary_script,1171,1151,0:00:23,23,0:09:27,20,26473
2016-06-12-ccc_311_lobby_ph_script,2016/06/12,ccc_311_lobby_ph_script,0,0,0:00:00,0,0:00:00,0,0
2016-06-12-ccc_aserv_info_script,2016/06/12,ccc_aserv_info_script,0,0,0:00:00,0,0:00:00,0,0
2016-06-12-ccc_bylaw_script,2016/06/12,ccc_bylaw_script,0,0,0:00:00,0,0:00:00,0,0
2016-06-12-ccc_city_script,2016/06/12,ccc_city_script,0,0,0:00:00,0,0:00:00,0,0
2016-06-12-ccc_cty_online_script,2016/06/12,ccc_cty_online_script,0,0,0:00:00,0,0:00:00,0,0
2016-06-12-ccc_feedback_script,2016/06/12,ccc_feedback_script,0,0,0:00:00,0,0:00:00,0,0
2016-06-12-ccc_fpb_script,2016/06/12,ccc_fpb_script,0,0,0:00:00,0,0:00:00,0,0
2016-06-12-ccc_help_script,2016/06/12,ccc_help_script,2,2,0:00:05,5,0:00:08,0,10
2016-06-12-ccc_link_script,2016/06/12,ccc_link_script,0,0,0:00:00,0,0:00:00,0,0
2016-06-12-ccc_media_line_script,2016/06/12,ccc_media_line_script,0,0,0:00:00,0,0:00:00,0,0
2016-06-12-ccc_priority_script,2016/06/12,ccc_priority_script,25,24,0:00:11,11,0:01:52,1,264
2016-06-12-ccc_tax_script,2016/06/12,ccc_tax_script,0,0,0:00:00,0,0:00:00,0,0
2016-06-12-ccc_waste_recycling_script,2016/06/12,ccc_waste_recycling_script,0,0,0:00:00,0,0:00:00,0,0
2016-06-13-ccc_311_calgary_script,2016/06/13,ccc_311_calgary_script,5106,3781,0:05:04,304,0:13:33,1325,1149424
2016-06-13-ccc_311_lobby_ph_script,2016/06/13,ccc_311_lobby_ph_script,4,4,0:00:14,14,0:00:36,0,56
2016-06-13-ccc_aserv_info_script,2016/06/13,ccc_aserv_info_script,0,0,0:00:00,0,0:00:00,0,0
2016-06-13-ccc_bylaw_script,2016/06/13,ccc_bylaw_script,0,0,0:00:00,0,0:00:00,0,0
2016-06-13-ccc_city_script,2016/06/13,ccc_city_script,19,18,0:02:21,141,0:08:08,1,2538
2016-06-13-ccc_cty_online_script,2016/06/13,ccc_cty_online_script,0,0,0:00:00,0,0:00:00,0,0
2016-06-13-ccc_feedback_script,2016/06/13,ccc_feedback_script,0,0,0:00:00,0,0:00:00,0,0
2016-06-13-ccc_fpb_script,2016/06/13,ccc_fpb_script,3,0,0:00:00,0,0:00:00,3,0
2016-06-13-ccc_help_script,2016/06/13,ccc_help_script,26,25,0:00:17,17,0:02:55,1,425
2016-06-13-ccc_link_script,2016/06/13,ccc_link_script,1,0,0:00:00,0,0:00:00,0,0
2016-06-13-ccc_media_line_script,2016/06/13,ccc_media_line_script,1,1,0:00:04,4,0:00:04,0,4
2016-06-13-ccc_priority_script,2016/06/13,ccc_priority_script,43,41,0:00:13,13,0:01:27,2,533
2016-06-13-ccc_tax_script,2016/06/13,ccc_tax_script,21,15,0:05:15,315,0:12:11,6,4725
2016-06-13-ccc_waste_recycling_script,2016/06/13,ccc_waste_recycling_script,0,0,0:00:00,0,0:00:00,0,0
2016-06-14-ccc_311_calgary_script,2016/06/14,ccc_311_calgary_script,4379,3720,0:02:57,177,0:16:27,659,658440
2016-06-14-ccc_311_lobby_ph_script,2016/06/14,ccc_311_lobby_ph_script,2,2,0:00:11,11,0:00:14,0,22
2016-06-14-ccc_aserv_info_script,2016/06/14,ccc_aserv_info_script,0,0,0:00:00,0,0:00:00,0,0
2016-06-14-ccc_bylaw_script,2016/06/14,ccc_bylaw_script,0,0,0:00:00,0,0:00:00,0,0
2016-06-14-ccc_city_script,2016/06/14,ccc_city_script,19,17,0:00:19,19,0:01:49,2,323
2016-06-14-ccc_cty_online_script,2016/06/14,ccc_cty_online_script,0,0,0:00:00,0,0:00:00,0,0
2016-06-14-ccc_feedback_script,2016/06/14,ccc_feedback_script,0,0,0:00:00,0,0:00:00,0,0
2016-06-14-ccc_fpb_script,2016/06/14,ccc_fpb_script,2,1,0:00:39,39,0:00:39,1,39
2016-06-14-ccc_help_script,2016/06/14,ccc_help_script,22,20,0:00:13,13,0:00:47,2,260
2016-06-14-ccc_link_script,2016/06/14,ccc_link_script,0,0,0:00:00,0,0:00:00,0,0
2016-06-14-ccc_media_line_script,2016/06/14,ccc_media_line_script,0,0,0:00:00,0,0:00:00,0,0
2016-06-14-ccc_priority_script,2016/06/14,ccc_priority_script,31,30,0:00:19,19,0:01:11,1,570
2016-06-14-ccc_tax_script,2016/06/14,ccc_tax_script,21,17,0:03:50,230,0:07:10,4,3910
2016-06-14-ccc_waste_recycling_script,2016/06/14,ccc_waste_recycling_script,0,0,0:00:00,0,0:00:00,0,0
2016-06-15-ccc_311_calgary_script,2016/06/15,ccc_311_calgary_script,4466,3340,0:05:11,311,0:12:58,1126,1038740
2016-06-15-ccc_311_lobby_ph_script,2016/06/15,ccc_311_lobby_ph_script,0,0,0:00:00,0,0:00:00,0,0
2016-06-15-ccc_aserv_info_script,2016/06/15,ccc_aserv_info_script,0,0,0:00:00,0,0:00:00,0,0
2016-06-15-ccc_bylaw_script,2016/06/15,ccc_bylaw_script,0,0,0:00:00,0,0:00:00,0,0
2016-06-15-ccc_city_script,2016/06/15,ccc_city_script,22,18,0:02:30,150,0:05:55,4,2700
2016-06-15-ccc_cty_online_script,2016/06/15,ccc_cty_online_script,0,0,0:00:00,0,0:00:00,0,0
2016-06-15-ccc_feedback_script,2016/06/15,ccc_feedback_script,0,0,0:00:00,0,0:00:00,0,0
2016-06-15-ccc_fpb_script,2016/06/15,ccc_fpb_script,3,2,0:06:28,388,0:09:20,1,776
2016-06-15-ccc_help_script,2016/06/15,ccc_help_script,34,33,0:00:14,14,0:00:47,1,462
2016-06-15-ccc_link_script,2016/06/15,ccc_link_script,0,0,0:00:00,0,0:00:00,0,0
2016-06-15-ccc_media_line_script,2016/06/15,ccc_media_line_script,0,0,0:00:00,0,0:00:00,0,0
2016-06-15-ccc_priority_script,2016/06/15,ccc_priority_script,26,25,0:00:12,12,0:00:28,1,300
2016-06-15-ccc_tax_script,2016/06/15,ccc_tax_script,12,9,0:05:48,348,0:11:52,3,3132
2016-06-15-ccc_waste_recycling_script,2016/06/15,ccc_waste_recycling_script,0,0,0:00:00,0,0:00:00,0,0
2016-06-16-ccc_311_calgary_script,2016/06/16,ccc_311_calgary_script,4011,3246,0:03:34,214,0:10:45,765,694644
2016-06-16-ccc_311_lobby_ph_script,2016/06/16,ccc_311_lobby_ph_script,2,2,0:00:03,3,0:00:05,0,6
2016-06-16-ccc_aserv_info_script,2016/06/16,ccc_aserv_info_script,0,0,0:00:00,0,0:00:00,0,0
2016-06-16-ccc_bylaw_script,2016/06/16,ccc_bylaw_script,0,0,0:00:00,0,0:00:00,0,0
2016-06-16-ccc_city_script,2016/06/16,ccc_city_script,11,11,0:01:16,76,0:05:20,0,836
2016-06-16-ccc_cty_online_script,2016/06/16,ccc_cty_online_script,0,0,0:00:00,0,0:00:00,0,0
2016-06-16-ccc_feedback_script,2016/06/16,ccc_feedback_script,0,0,0:00:00,0,0:00:00,0,0
2016-06-16-ccc_fpb_script,2016/06/16,ccc_fpb_script,0,0,0:00:00,0,0:00:00,0,0
2016-06-16-ccc_help_script,2016/06/16,ccc_help_script,42,41,0:00:14,14,0:00:41,1,574
2016-06-16-ccc_link_script,2016/06/16,ccc_link_script,0,0,0:00:00,0,0:00:00,0,0
2016-06-16-ccc_media_line_script,2016/06/16,ccc_media_line_script,1,1,0:00:08,8,0:00:08,0,8
2016-06-16-ccc_priority_script,2016/06/16,ccc_priority_script,35,35,0:00:13,13,0:01:06,0,455
2016-06-16-ccc_tax_script,2016/06/16,ccc_tax_script,20,17,0:04:26,266,0:09:51,3,4522
2016-06-16-ccc_waste_recycling_script,2016/06/16,ccc_waste_recycling_script,0,0,0:00:00,0,0:00:00,0,0
2016-06-17-ccc_311_calgary_script,2016/06/17,ccc_311_calgary_script,3850,3229,0:03:12,192,0:11:13,621,619968
2016-06-17-ccc_311_lobby_ph_script,2016/06/17,ccc_311_lobby_ph_script,5,5,0:00:21,21,0:00:35,0,105
2016-06-17-ccc_aserv_info_script,2016/06/17,ccc_aserv_info_script,0,0,0:00:00,0,0:00:00,0,0
2016-06-17-ccc_bylaw_script,2016/06/17,ccc_bylaw_script,0,0,0:00:00,0,0:00:00,0,0
2016-06-17-ccc_city_script,2016/06/17,ccc_city_script,21,20,0:00:42,42,0:03:36,1,840
2016-06-17-ccc_cty_online_script,2016/06/17,ccc_cty_online_script,0,0,0:00:00,0,0:00:00,0,0
2016-06-17-ccc_feedback_script,2016/06/17,ccc_feedback_script,0,0,0:00:00,0,0:00:00,0,0
2016-06-17-ccc_fpb_script,2016/06/17,ccc_fpb_script,1,1,0:02:53,173,0:02:53,0,173
2016-06-17-ccc_help_script,2016/06/17,ccc_help_script,29,27,0:00:19,19,0:01:32,2,513
2016-06-17-ccc_link_script,2016/06/17,ccc_link_script,0,0,0:00:00,0,0:00:00,0,0
2016-06-17-ccc_media_line_script,2016/06/17,ccc_media_line_script,0,0,0:00:00,0,0:00:00,0,0
2016-06-17-ccc_priority_script,2016/06/17,ccc_priority_script,22,19,0:00:11,11,0:00:52,3,209
2016-06-17-ccc_tax_script,2016/06/17,ccc_tax_script,23,18,0:03:10,190,0:07:35,5,3420
2016-06-17-ccc_waste_recycling_script,2016/06/17,ccc_waste_recycling_script,0,0,0:00:00,0,0:00:00,0,0
2016-06-18-ccc_311_calgary_script,2016/06/18,ccc_311_calgary_script,1417,1350,0:00:30,30,0:13:51,65,40500
2016-06-18-ccc_311_lobby_ph_script,2016/06/18,ccc_311_lobby_ph_script,0,0,0:00:00,0,0:00:00,0,0
2016-06-18-ccc_aserv_info_script,2016/06/18,ccc_aserv_info_script,0,0,0:00:00,0,0:00:00,0,0
2016-06-18-ccc_bylaw_script,2016/06/18,ccc_bylaw_script,0,0,0:00:00,0,0:00:00,0,0
2016-06-18-ccc_city_script,2016/06/18,ccc_city_script,0,0,0:00:00,0,0:00:00,0,0
2016-06-18-ccc_cty_online_script,2016/06/18,ccc_cty_online_script,0,0,0:00:00,0,0:00:00,0,0
2016-06-18-ccc_feedback_script,2016/06/18,ccc_feedback_script,0,0,0:00:00,0,0:00:00,0,0
2016-06-18-ccc_fpb_script,2016/06/18,ccc_fpb_script,1,1,0:00:10,10,0:00:10,0,10
2016-06-18-ccc_help_script,2016/06/18,ccc_help_script,8,8,0:00:31,31,0:01:36,0,248
2016-06-18-ccc_link_script,2016/06/18,ccc_link_script,0,0,0:00:00,0,0:00:00,0,0
2016-06-18-ccc_media_line_script,2016/06/18,ccc_media_line_script,0,0,0:00:00,0,0:00:00,0,0
2016-06-18-ccc_priority_script,2016/06/18,ccc_priority_script,24,24,0:00:18,18,0:03:59,0,432
2016-06-18-ccc_tax_script,2016/06/18,ccc_tax_script,3,2,0:00:06,6,0:00:09,1,12
2016-06-18-ccc_waste_recycling_script,2016/06/18,ccc_waste_recycling_script,0,0,0:00:00,0,0:00:00,0,0
2016-06-19-ccc_311_calgary_script,2016/06/19,ccc_311_calgary_script,1013,988,0:00:22,22,0:11:12,27,21736
2016-06-19-ccc_311_lobby_ph_script,2016/06/19,ccc_311_lobby_ph_script,0,0,0:00:00,0,0:00:00,0,0
2016-06-19-ccc_aserv_info_script,2016/06/19,ccc_aserv_info_script,0,0,0:00:00,0,0:00:00,0,0
2016-06-19-ccc_bylaw_script,2016/06/19,ccc_bylaw_script,0,0,0:00:00,0,0:00:00,0,0
2016-06-19-ccc_city_script,2016/06/19,ccc_city_script,0,0,0:00:00,0,0:00:00,0,0
2016-06-19-ccc_cty_online_script,2016/06/19,ccc_cty_online_script,0,0,0:00:00,0,0:00:00,0,0
2016-06-19-ccc_feedback_script,2016/06/19,ccc_feedback_script,0,0,0:00:00,0,0:00:00,0,0
2016-06-19-ccc_fpb_script,2016/06/19,ccc_fpb_script,0,0,0:00:00,0,0:00:00,0,0
2016-06-19-ccc_help_script,2016/06/19,ccc_help_script,1,1,0:00:06,6,0:00:06,0,6
2016-06-19-ccc_link_script,2016/06/19,ccc_link_script,0,0,0:00:00,0,0:00:00,0,0
2016-06-19-ccc_media_line_script,2016/06/19,ccc_media_line_script,1,1,0:00:05,5,0:00:05,0,5
2016-06-19-ccc_priority_script,2016/06/19,ccc_priority_script,22,22,0:00:14,14,0:02:43,0,308
2016-06-19-ccc_tax_script,2016/06/19,ccc_tax_script,1,0,0:00:00,0,0:00:00,1,0
2016-06-19-ccc_waste_recycling_script,2016/06/19,ccc_waste_recycling_script,0,0,0:00:00,0,0:00:00,0,0
2016-06-20-ccc_311_calgary_script,2016/06/20,ccc_311_calgary_script,4789,3927,0:03:31,211,0:16:44,860,828597
2016-06-20-ccc_311_lobby_ph_script,2016/06/20,ccc_311_lobby_ph_script,2,2,0:00:04,4,0:00:06,0,8
2016-06-20-ccc_aserv_info_script,2016/06/20,ccc_aserv_info_script,0,0,0:00:00,0,0:00:00,0,0
2016-06-20-ccc_bylaw_script,2016/06/20,ccc_bylaw_script,0,0,0:00:00,0,0:00:00,0,0
2016-06-20-ccc_city_script,2016/06/20,ccc_city_script,23,20,0:00:57,57,0:07:04,3,1140
2016-06-20-ccc_cty_online_script,2016/06/20,ccc_cty_online_script,0,0,0:00:00,0,0:00:00,0,0
2016-06-20-ccc_feedback_script,2016/06/20,ccc_feedback_script,0,0,0:00:00,0,0:00:00,0,0
2016-06-20-ccc_fpb_script,2016/06/20,ccc_fpb_script,0,0,0:00:00,0,0:00:00,0,0
2016-06-20-ccc_help_script,2016/06/20,ccc_help_script,18,18,0:00:09,9,0:00:31,0,162
2016-06-20-ccc_link_script,2016/06/20,ccc_link_script,0,0,0:00:00,0,0:00:00,0,0
2016-06-20-ccc_media_line_script,2016/06/20,ccc_media_line_script,1,1,0:00:03,3,0:00:03,0,3
2016-06-20-ccc_priority_script,2016/06/20,ccc_priority_script,29,28,0:00:16,16,0:01:06,1,448
2016-06-20-ccc_tax_script,2016/06/20,ccc_tax_script,18,16,0:03:25,205,0:08:59,2,3280
2016-06-20-ccc_waste_recycling_script,2016/06/20,ccc_waste_recycling_script,0,0,0:00:00,0,0:00:00,0,0
2016-06-21-ccc_311_calgary_script,2016/06/21,ccc_311_calgary_script,4428,3991,0:01:39,99,0:10:36,438,395109
2016-06-21-ccc_311_lobby_ph_script,2016/06/21,ccc_311_lobby_ph_script,8,6,0:00:06,6,0:00:13,2,36
2016-06-21-ccc_aserv_info_script,2016/06/21,ccc_aserv_info_script,0,0,0:00:00,0,0:00:00,0,0
2016-06-21-ccc_bylaw_script,2016/06/21,ccc_bylaw_script,0,0,0:00:00,0,0:00:00,0,0
2016-06-21-ccc_city_script,2016/06/21,ccc_city_script,47,42,0:00:45,45,0:05:15,5,1890
2016-06-21-ccc_cty_online_script,2016/06/21,ccc_cty_online_script,0,0,0:00:00,0,0:00:00,0,0
2016-06-21-ccc_feedback_script,2016/06/21,ccc_feedback_script,0,0,0:00:00,0,0:00:00,0,0
2016-06-21-ccc_fpb_script,2016/06/21,ccc_fpb_script,1,1,0:02:56,176,0:02:56,0,176
2016-06-21-ccc_help_script,2016/06/21,ccc_help_script,24,22,0:00:12,12,0:00:38,2,264
2016-06-21-ccc_link_script,2016/06/21,ccc_link_script,0,0,0:00:00,0,0:00:00,0,0
2016-06-21-ccc_media_line_script,2016/06/21,ccc_media_line_script,2,2,0:00:07,7,0:00:13,0,14
2016-06-21-ccc_priority_script,2016/06/21,ccc_priority_script,42,40,0:00:12,12,0:00:45,2,480
2016-06-21-ccc_tax_script,2016/06/21,ccc_tax_script,15,14,0:02:30,150,0:05:40,1,2100
2016-06-21-ccc_waste_recycling_script,2016/06/21,ccc_waste_recycling_script,0,0,0:00:00,0,0:00:00,0,0
2016-06-22-ccc_311_calgary_script,2016/06/22,ccc_311_calgary_script,4241,3565,0:02:56,176,0:19:53,677,627440
2016-06-22-ccc_311_lobby_ph_script,2016/06/22,ccc_311_lobby_ph_script,0,0,0:00:00,0,0:00:00,0,0
2016-06-22-ccc_aserv_info_script,2016/06/22,ccc_aserv_info_script,0,0,0:00:00,0,0:00:00,0,0
2016-06-22-ccc_bylaw_script,2016/06/22,ccc_bylaw_script,0,0,0:00:00,0,0:00:00,0,0
2016-06-22-ccc_city_script,2016/06/22,ccc_city_script,26,24,0:01:00,60,0:03:55,2,1440
2016-06-22-ccc_cty_online_script,2016/06/22,ccc_cty_online_script,0,0,0:00:00,0,0:00:00,0,0
2016-06-22-ccc_feedback_script,2016/06/22,ccc_feedback_script,0,0,0:00:00,0,0:00:00,0,0
2016-06-22-ccc_fpb_script,2016/06/22,ccc_fpb_script,2,1,0:00:05,5,0:00:05,1,5
2016-06-22-ccc_help_script,2016/06/22,ccc_help_script,43,35,0:00:13,13,0:01:27,8,455
2016-06-22-ccc_link_script,2016/06/22,ccc_link_script,0,0,0:00:00,0,0:00:00,0,0
2016-06-22-ccc_media_line_script,2016/06/22,ccc_media_line_script,2,2,0:00:05,5,0:00:05,0,10
2016-06-22-ccc_priority_script,2016/06/22,ccc_priority_script,38,35,0:00:21,21,0:02:22,3,735
2016-06-22-ccc_tax_script,2016/06/22,ccc_tax_script,15,10,0:01:59,119,0:04:48,5,1190
2016-06-22-ccc_waste_recycling_script,2016/06/22,ccc_waste_recycling_script,0,0,0:00:00,0,0:00:00,0,0
2016-06-23-ccc_311_calgary_script,2016/06/23,ccc_311_calgary_script,4329,3758,0:02:12,132,0:11:27,571,496056
2016-06-23-ccc_311_lobby_ph_script,2016/06/23,ccc_311_lobby_ph_script,3,3,0:00:11,11,0:00:21,0,33
2016-06-23-ccc_aserv_info_script,2016/06/23,ccc_aserv_info_script,0,0,0:00:00,0,0:00:00,0,0
2016-06-23-ccc_bylaw_script,2016/06/23,ccc_bylaw_script,0,0,0:00:00,0,0:00:00,0,0
2016-06-23-ccc_city_script,2016/06/23,ccc_city_script,30,27,0:00:40,40,0:03:56,3,1080
2016-06-23-ccc_cty_online_script,2016/06/23,ccc_cty_online_script,0,0,0:00:00,0,0:00:00,0,0
2016-06-23-ccc_feedback_script,2016/06/23,ccc_feedback_script,0,0,0:00:00,0,0:00:00,0,0
2016-06-23-ccc_fpb_script,2016/06/23,ccc_fpb_script,0,0,0:00:00,0,0:00:00,0,0
2016-06-23-ccc_help_script,2016/06/23,ccc_help_script,30,25,0:00:14,14,0:01:02,5,350
2016-06-23-ccc_link_script,2016/06/23,ccc_link_script,0,0,0:00:00,0,0:00:00,0,0
2016-06-23-ccc_media_line_script,2016/06/23,ccc_media_line_script,1,1,0:00:13,13,0:00:13,0,13
2016-06-23-ccc_priority_script,2016/06/23,ccc_priority_script,33,31,0:00:18,18,0:02:48,2,558
2016-06-23-ccc_tax_script,2016/06/23,ccc_tax_script,19,19,0:02:02,122,0:06:24,0,2318
2016-06-23-ccc_waste_recycling_script,2016/06/23,ccc_waste_recycling_script,0,0,0:00:00,0,0:00:00,0,0
2016-06-24-ccc_311_calgary_script,2016/06/24,ccc_311_calgary_script,3855,3240,0:03:18,198,0:11:58,615,641520
2016-06-24-ccc_311_lobby_ph_script,2016/06/24,ccc_311_lobby_ph_script,4,4,0:00:12,12,0:00:18,0,48
2016-06-24-ccc_aserv_info_script,2016/06/24,ccc_aserv_info_script,0,0,0:00:00,0,0:00:00,0,0
2016-06-24-ccc_bylaw_script,2016/06/24,ccc_bylaw_script,0,0,0:00:00,0,0:00:00,0,0
2016-06-24-ccc_city_script,2016/06/24,ccc_city_script,23,21,0:00:57,57,0:05:24,2,1197
2016-06-24-ccc_cty_online_script,2016/06/24,ccc_cty_online_script,0,0,0:00:00,0,0:00:00,0,0
2016-06-24-ccc_feedback_script,2016/06/24,ccc_feedback_script,0,0,0:00:00,0,0:00:00,0,0
2016-06-24-ccc_fpb_script,2016/06/24,ccc_fpb_script,0,0,0:00:00,0,0:00:00,0,0
2016-06-24-ccc_help_script,2016/06/24,ccc_help_script,18,17,0:00:07,7,0:00:31,1,119
2016-06-24-ccc_link_script,2016/06/24,ccc_link_script,0,0,0:00:00,0,0:00:00,0,0
2016-06-24-ccc_media_line_script,2016/06/24,ccc_media_line_script,1,1,0:00:08,8,0:00:08,0,8
2016-06-24-ccc_priority_script,2016/06/24,ccc_priority_script,37,35,0:00:12,12,0:01:29,2,420
2016-06-24-ccc_tax_script,2016/06/24,ccc_tax_script,17,12,0:05:21,321,0:08:01,5,3852
2016-06-24-ccc_waste_recycling_script,2016/06/24,ccc_waste_recycling_script,0,0,0:00:00,0,0:00:00,0,0
2016-06-25-ccc_311_calgary_script,2016/06/25,ccc_311_calgary_script,1504,1424,0:00:36,36,0:06:13,80,51264
2016-06-25-ccc_311_lobby_ph_script,2016/06/25,ccc_311_lobby_ph_script,0,0,0:00:00,0,0:00:00,0,0
2016-06-25-ccc_aserv_info_script,2016/06/25,ccc_aserv_info_script,0,0,0:00:00,0,0:00:00,0,0
2016-06-25-ccc_bylaw_script,2016/06/25,ccc_bylaw_script,0,0,0:00:00,0,0:00:00,0,0
2016-06-25-ccc_city_script,2016/06/25,ccc_city_script,0,0,0:00:00,0,0:00:00,0,0
2016-06-25-ccc_cty_online_script,2016/06/25,ccc_cty_online_script,0,0,0:00:00,0,0:00:00,0,0
2016-06-25-ccc_feedback_script,2016/06/25,ccc_feedback_script,0,0,0:00:00,0,0:00:00,0,0
2016-06-25-ccc_fpb_script,2016/06/25,ccc_fpb_script,0,0,0:00:00,0,0:00:00,0,0
2016-06-25-ccc_help_script,2016/06/25,ccc_help_script,24,22,0:00:21,21,0:01:42,2,462
2016-06-25-ccc_link_script,2016/06/25,ccc_link_script,1,0,0:00:00,0,0:00:00,0,0
2016-06-25-ccc_media_line_script,2016/06/25,ccc_media_line_script,1,1,0:00:25,25,0:00:25,0,25
2016-06-25-ccc_priority_script,2016/06/25,ccc_priority_script,27,26,0:00:43,43,0:09:29,1,1118
2016-06-25-ccc_tax_script,2016/06/25,ccc_tax_script,2,2,0:00:05,5,0:00:05,0,10
2016-06-25-ccc_waste_recycling_script,2016/06/25,ccc_waste_recycling_script,0,0,0:00:00,0,0:00:00,0,0
2016-06-26-ccc_311_calgary_script,2016/06/26,ccc_311_calgary_script,1159,1116,0:00:29,29,0:11:40,43,32364
2016-06-26-ccc_311_lobby_ph_script,2016/06/26,ccc_311_lobby_ph_script,0,0,0:00:00,0,0:00:00,0,0
2016-06-26-ccc_aserv_info_script,2016/06/26,ccc_aserv_info_script,0,0,0:00:00,0,0:00:00,0,0
2016-06-26-ccc_bylaw_script,2016/06/26,ccc_bylaw_script,0,0,0:00:00,0,0:00:00,0,0
2016-06-26-ccc_city_script,2016/06/26,ccc_city_script,0,0,0:00:00,0,0:00:00,0,0
2016-06-26-ccc_cty_online_script,2016/06/26,ccc_cty_online_script,0,0,0:00:00,0,0:00:00,0,0
2016-06-26-ccc_feedback_script,2016/06/26,ccc_feedback_script,0,0,0:00:00,0,0:00:00,0,0
2016-06-26-ccc_fpb_script,2016/06/26,ccc_fpb_script,0,0,0:00:00,0,0:00:00,0,0
2016-06-26-ccc_help_script,2016/06/26,ccc_help_script,6,5,0:00:06,6,0:00:10,1,30
2016-06-26-ccc_link_script,2016/06/26,ccc_link_script,0,0,0:00:00,0,0:00:00,0,0
2016-06-26-ccc_media_line_script,2016/06/26,ccc_media_line_script,1,1,0:00:09,9,0:00:09,0,9
2016-06-26-ccc_priority_script,2016/06/26,ccc_priority_script,39,37,0:00:20,20,0:02:35,2,740
2016-06-26-ccc_tax_script,2016/06/26,ccc_tax_script,1,1,0:00:06,6,0:00:06,0,6
2016-06-26-ccc_waste_recycling_script,2016/06/26,ccc_waste_recycling_script,0,0,0:00:00,0,0:00:00,0,0
2016-06-27-ccc_311_calgary_script,2016/06/27,ccc_311_calgary_script,5032,4428,0:02:23,143,0:08:08,604,633204
2016-06-27-ccc_311_lobby_ph_script,2016/06/27,ccc_311_lobby_ph_script,4,4,0:00:17,17,0:00:22,0,68
2016-06-27-ccc_aserv_info_script,2016/06/27,ccc_aserv_info_script,0,0,0:00:00,0,0:00:00,0,0
2016-06-27-ccc_bylaw_script,2016/06/27,ccc_bylaw_script,0,0,0:00:00,0,0:00:00,0,0
2016-06-27-ccc_city_script,2016/06/27,ccc_city_script,34,34,0:00:18,18,0:01:39,0,612
2016-06-27-ccc_cty_online_script,2016/06/27,ccc_cty_online_script,0,0,0:00:00,0,0:00:00,0,0
2016-06-27-ccc_feedback_script,2016/06/27,ccc_feedback_script,0,0,0:00:00,0,0:00:00,0,0
2016-06-27-ccc_fpb_script,2016/06/27,ccc_fpb_script,0,0,0:00:00,0,0:00:00,0,0
2016-06-27-ccc_help_script,2016/06/27,ccc_help_script,44,40,0:00:11,11,0:00:47,4,440
2016-06-27-ccc_link_script,2016/06/27,ccc_link_script,0,0,0:00:00,0,0:00:00,0,0
2016-06-27-ccc_media_line_script,2016/06/27,ccc_media_line_script,1,1,0:01:10,70,0:01:10,0,70
2016-06-27-ccc_priority_script,2016/06/27,ccc_priority_script,32,32,0:00:13,13,0:00:59,0,416
2016-06-27-ccc_tax_script,2016/06/27,ccc_tax_script,26,22,0:03:31,211,0:07:40,4,4642
2016-06-27-ccc_waste_recycling_script,2016/06/27,ccc_waste_recycling_script,0,0,0:00:00,0,0:00:00,0,0
2016-06-28-ccc_311_calgary_script,2016/06/28,ccc_311_calgary_script,5236,3807,0:05:40,340,0:16:28,1429,1294380
2016-06-28-ccc_311_lobby_ph_script,2016/06/28,ccc_311_lobby_ph_script,4,4,0:00:16,16,0:00:17,0,64
2016-06-28-ccc_aserv_info_script,2016/06/28,ccc_aserv_info_script,0,0,0:00:00,0,0:00:00,0,0
2016-06-28-ccc_bylaw_script,2016/06/28,ccc_bylaw_script,0,0,0:00:00,0,0:00:00,0,0
2016-06-28-ccc_city_script,2016/06/28,ccc_city_script,12,12,0:02:15,135,0:12:50,0,1620
2016-06-28-ccc_cty_online_script,2016/06/28,ccc_cty_online_script,0,0,0:00:00,0,0:00:00,0,0
2016-06-28-ccc_feedback_script,2016/06/28,ccc_feedback_script,1,0,0:00:00,0,0:00:00,0,0
2016-06-28-ccc_fpb_script,2016/06/28,ccc_fpb_script,0,0,0:00:00,0,0:00:00,0,0
2016-06-28-ccc_help_script,2016/06/28,ccc_help_script,55,44,0:00:15,15,0:01:03,11,660
2016-06-28-ccc_link_script,2016/06/28,ccc_link_script,0,0,0:00:00,0,0:00:00,0,0
2016-06-28-ccc_media_line_script,2016/06/28,ccc_media_line_script,0,0,0:00:00,0,0:00:00,0,0
2016-06-28-ccc_priority_script,2016/06/28,ccc_priority_script,38,36,0:00:18,18,0:00:50,2,648
2016-06-28-ccc_tax_script,2016/06/28,ccc_tax_script,14,12,0:05:42,342,0:11:35,2,4104
2016-06-28-ccc_waste_recycling_script,2016/06/28,ccc_waste_recycling_script,0,0,0:00:00,0,0:00:00,0,0
2016-06-29-ccc_311_calgary_script,2016/06/29,ccc_311_calgary_script,5512,4391,0:03:44,224,0:12:01,1121,983584
2016-06-29-ccc_311_lobby_ph_script,2016/06/29,ccc_311_lobby_ph_script,1,0,0:00:00,0,0:00:00,1,0
2016-06-29-ccc_aserv_info_script,2016/06/29,ccc_aserv_info_script,0,0,0:00:00,0,0:00:00,0,0
2016-06-29-ccc_bylaw_script,2016/06/29,ccc_bylaw_script,0,0,0:00:00,0,0:00:00,0,0
2016-06-29-ccc_city_script,2016/06/29,ccc_city_script,18,17,0:01:42,102,0:05:14,1,1734
2016-06-29-ccc_cty_online_script,2016/06/29,ccc_cty_online_script,0,0,0:00:00,0,0:00:00,0,0
2016-06-29-ccc_feedback_script,2016/06/29,ccc_feedback_script,1,0,0:00:00,0,0:00:00,0,0
2016-06-29-ccc_fpb_script,2016/06/29,ccc_fpb_script,1,0,0:00:00,0,0:00:00,1,0
2016-06-29-ccc_help_script,2016/06/29,ccc_help_script,34,31,0:00:11,11,0:01:00,3,341
2016-06-29-ccc_link_script,2016/06/29,ccc_link_script,0,0,0:00:00,0,0:00:00,0,0
2016-06-29-ccc_media_line_script,2016/06/29,ccc_media_line_script,0,0,0:00:00,0,0:00:00,0,0
2016-06-29-ccc_priority_script,2016/06/29,ccc_priority_script,35,33,0:00:10,10,0:00:35,2,330
2016-06-29-ccc_tax_script,2016/06/29,ccc_tax_script,16,12,0:03:37,217,0:09:15,4,2604
2016-06-29-ccc_waste_recycling_script,2016/06/29,ccc_waste_recycling_script,0,0,0:00:00,0,0:00:00,0,0
2016-06-30-ccc_311_calgary_script,2016/06/30,ccc_311_calgary_script,5115,4912,0:00:38,38,0:07:39,203,186656
2016-06-30-ccc_311_lobby_ph_script,2016/06/30,ccc_311_lobby_ph_script,2,2,0:00:10,10,0:00:15,0,20
2016-06-30-ccc_aserv_info_script,2016/06/30,ccc_aserv_info_script,0,0,0:00:00,0,0:00:00,0,0
2016-06-30-ccc_bylaw_script,2016/06/30,ccc_bylaw_script,0,0,0:00:00,0,0:00:00,0,0
2016-06-30-ccc_city_script,2016/06/30,ccc_city_script,15,15,0:00:17,17,0:02:55,0,255
2016-06-30-ccc_cty_online_script,2016/06/30,ccc_cty_online_script,0,0,0:00:00,0,0:00:00,0,0
2016-06-30-ccc_feedback_script,2016/06/30,ccc_feedback_script,1,0,0:00:00,0,0:00:00,0,0
2016-06-30-ccc_fpb_script,2016/06/30,ccc_fpb_script,0,0,0:00:00,0,0:00:00,0,0
2016-06-30-ccc_help_script,2016/06/30,ccc_help_script,32,32,0:00:08,8,0:00:32,0,256
2016-06-30-ccc_link_script,2016/06/30,ccc_link_script,0,0,0:00:00,0,0:00:00,0,0
2016-06-30-ccc_media_line_script,2016/06/30,ccc_media_line_script,1,1,0:00:18,18,0:00:18,0,18
2016-06-30-ccc_priority_script,2016/06/30,ccc_priority_script,27,27,0:00:11,11,0:02:47,0,297
2016-06-30-ccc_tax_script,2016/06/30,ccc_tax_script,14,13,0:00:51,51,0:02:45,1,663
2016-06-30-ccc_waste_recycling_script,2016/06/30,ccc_waste_recycling_script,0,0,0:00:00,0,0:00:00,0,0
2016-07-01-ccc_311_calgary_script,2016/07/01,ccc_311_calgary_script,1822,1712,0:00:28,28,0:16:00,110,47936
2016-07-01-ccc_311_lobby_ph_script,2016/07/01,ccc_311_lobby_ph_script,0,0,0:00:00,0,0:00:00,0,0
2016-07-01-ccc_aserv_info_script,2016/07/01,ccc_aserv_info_script,0,0,0:00:00,0,0:00:00,0,0
2016-07-01-ccc_bylaw_script,2016/07/01,ccc_bylaw_script,0,0,0:00:00,0,0:00:00,0,0
2016-07-01-ccc_city_script,2016/07/01,ccc_city_script,0,0,0:00:00,0,0:00:00,0,0
2016-07-01-ccc_cty_online_script,2016/07/01,ccc_cty_online_script,0,0,0:00:00,0,0:00:00,0,0
2016-07-01-ccc_feedback_script,2016/07/01,ccc_feedback_script,0,0,0:00:00,0,0:00:00,0,0
2016-07-01-ccc_fpb_script,2016/07/01,ccc_fpb_script,0,0,0:00:00,0,0:00:00,0,0
2016-07-01-ccc_help_script,2016/07/01,ccc_help_script,8,7,0:00:07,7,0:00:09,1,49
2016-07-01-ccc_link_script,2016/07/01,ccc_link_script,0,0,0:00:00,0,0:00:00,0,0
2016-07-01-ccc_media_line_script,2016/07/01,ccc_media_line_script,6,5,0:00:13,13,0:00:44,1,65
2016-07-01-ccc_priority_script,2016/07/01,ccc_priority_script,21,21,0:00:08,8,0:00:33,0,168
2016-07-01-ccc_tax_script,2016/07/01,ccc_tax_script,1,1,0:00:02,2,0:00:02,0,2
2016-07-01-ccc_waste_recycling_script,2016/07/01,ccc_waste_recycling_script,0,0,0:00:00,0,0:00:00,0,0
2016-07-02-ccc_311_calgary_script,2016/07/02,ccc_311_calgary_script,1385,1353,0:00:11,11,0:05:16,32,14883
2016-07-02-ccc_311_lobby_ph_script,2016/07/02,ccc_311_lobby_ph_script,0,0,0:00:00,0,0:00:00,0,0
2016-07-02-ccc_aserv_info_script,2016/07/02,ccc_aserv_info_script,0,0,0:00:00,0,0:00:00,0,0
2016-07-02-ccc_bylaw_script,2016/07/02,ccc_bylaw_script,0,0,0:00:00,0,0:00:00,0,0
2016-07-02-ccc_city_script,2016/07/02,ccc_city_script,0,0,0:00:00,0,0:00:00,0,0
2016-07-02-ccc_cty_online_script,2016/07/02,ccc_cty_online_script,0,0,0:00:00,0,0:00:00,0,0
2016-07-02-ccc_feedback_script,2016/07/02,ccc_feedback_script,0,0,0:00:00,0,0:00:00,0,0
2016-07-02-ccc_fpb_script,2016/07/02,ccc_fpb_script,0,0,0:00:00,0,0:00:00,0,0
2016-07-02-ccc_help_script,2016/07/02,ccc_help_script,5,5,0:00:03,3,0:00:06,0,15
2016-07-02-ccc_link_script,2016/07/02,ccc_link_script,0,0,0:00:00,0,0:00:00,0,0
2016-07-02-ccc_media_line_script,2016/07/02,ccc_media_line_script,1,1,0:00:02,2,0:00:02,0,2
2016-07-02-ccc_priority_script,2016/07/02,ccc_priority_script,22,20,0:00:14,14,0:01:14,2,280
2016-07-02-ccc_tax_script,2016/07/02,ccc_tax_script,0,0,0:00:00,0,0:00:00,0,0
2016-07-02-ccc_waste_recycling_script,2016/07/02,ccc_waste_recycling_script,0,0,0:00:00,0,0:00:00,0,0
2016-07-03-ccc_311_calgary_script,2016/07/03,ccc_311_calgary_script,1111,1088,0:00:19,19,0:07:21,23,20672
2016-07-03-ccc_311_lobby_ph_script,2016/07/03,ccc_311_lobby_ph_script,0,0,0:00:00,0,0:00:00,0,0
2016-07-03-ccc_aserv_info_script,2016/07/03,ccc_aserv_info_script,0,0,0:00:00,0,0:00:00,0,0
2016-07-03-ccc_bylaw_script,2016/07/03,ccc_bylaw_script,0,0,0:00:00,0,0:00:00,0,0
2016-07-03-ccc_city_script,2016/07/03,ccc_city_script,0,0,0:00:00,0,0:00:00,0,0
2016-07-03-ccc_cty_online_script,2016/07/03,ccc_cty_online_script,0,0,0:00:00,0,0:00:00,0,0
2016-07-03-ccc_feedback_script,2016/07/03,ccc_feedback_script,0,0,0:00:00,0,0:00:00,0,0
2016-07-03-ccc_fpb_script,2016/07/03,ccc_fpb_script,0,0,0:00:00,0,0:00:00,0,0
2016-07-03-ccc_help_script,2016/07/03,ccc_help_script,6,6,0:00:06,6,0:00:08,0,36
2016-07-03-ccc_link_script,2016/07/03,ccc_link_script,0,0,0:00:00,0,0:00:00,0,0
2016-07-03-ccc_media_line_script,2016/07/03,ccc_media_line_script,2,2,0:00:11,11,0:00:15,0,22
2016-07-03-ccc_priority_script,2016/07/03,ccc_priority_script,20,20,0:00:23,23,0:02:08,0,460
2016-07-03-ccc_tax_script,2016/07/03,ccc_tax_script,1,1,0:00:10,10,0:00:10,0,10
2016-07-03-ccc_waste_recycling_script,2016/07/03,ccc_waste_recycling_script,0,0,0:00:00,0,0:00:00,0,0
2016-07-04-ccc_311_calgary_script,2016/07/04,ccc_311_calgary_script,4483,3678,0:03:01,181,0:07:51,805,665718
2016-07-04-ccc_311_lobby_ph_script,2016/07/04,ccc_311_lobby_ph_script,2,2,0:00:15,15,0:00:22,0,30
2016-07-04-ccc_aserv_info_script,2016/07/04,ccc_aserv_info_script,0,0,0:00:00,0,0:00:00,0,0
2016-07-04-ccc_bylaw_script,2016/07/04,ccc_bylaw_script,0,0,0:00:00,0,0:00:00,0,0
2016-07-04-ccc_city_script,2016/07/04,ccc_city_script,34,33,0:00:53,53,0:04:38,1,1749
2016-07-04-ccc_cty_online_script,2016/07/04,ccc_cty_online_script,0,0,0:00:00,0,0:00:00,0,0
2016-07-04-ccc_feedback_script,2016/07/04,ccc_feedback_script,0,0,0:00:00,0,0:00:00,0,0
2016-07-04-ccc_fpb_script,2016/07/04,ccc_fpb_script,2,2,0:05:14,314,0:06:23,0,628
2016-07-04-ccc_help_script,2016/07/04,ccc_help_script,30,24,0:00:15,15,0:00:59,6,360
2016-07-04-ccc_link_script,2016/07/04,ccc_link_script,0,0,0:00:00,0,0:00:00,0,0
2016-07-04-ccc_media_line_script,2016/07/04,ccc_media_line_script,2,2,0:00:11,11,0:00:19,0,22
2016-07-04-ccc_priority_script,2016/07/04,ccc_priority_script,36,33,0:00:21,21,0:03:05,3,693
2016-07-04-ccc_tax_script,2016/07/04,ccc_tax_script,23,19,0:04:20,260,0:06:46,4,4940
2016-07-04-ccc_waste_recycling_script,2016/07/04,ccc_waste_recycling_script,0,0,0:00:00,0,0:00:00,0,0
2016-07-05-ccc_311_calgary_script,2016/07/05,ccc_311_calgary_script,4222,3084,0:05:12,312,0:12:37,1138,962208
2016-07-05-ccc_311_lobby_ph_script,2016/07/05,ccc_311_lobby_ph_script,6,5,0:00:14,14,0:00:18,1,70
2016-07-05-ccc_aserv_info_script,2016/07/05,ccc_aserv_info_script,0,0,0:00:00,0,0:00:00,0,0
2016-07-05-ccc_bylaw_script,2016/07/05,ccc_bylaw_script,0,0,0:00:00,0,0:00:00,0,0
2016-07-05-ccc_city_script,2016/07/05,ccc_city_script,26,24,0:03:35,215,0:08:41,2,5160
2016-07-05-ccc_cty_online_script,2016/07/05,ccc_cty_online_script,0,0,0:00:00,0,0:00:00,0,0
2016-07-05-ccc_feedback_script,2016/07/05,ccc_feedback_script,1,0,0:00:00,0,0:00:00,0,0
2016-07-05-ccc_fpb_script,2016/07/05,ccc_fpb_script,1,0,0:00:00,0,0:00:00,1,0
2016-07-05-ccc_help_script,2016/07/05,ccc_help_script,30,26,0:00:16,16,0:01:36,4,416
2016-07-05-ccc_link_script,2016/07/05,ccc_link_script,0,0,0:00:00,0,0:00:00,0,0
2016-07-05-ccc_media_line_script,2016/07/05,ccc_media_line_script,1,1,0:00:04,4,0:00:04,0,4
2016-07-05-ccc_priority_script,2016/07/05,ccc_priority_script,35,33,0:00:15,15,0:01:08,2,495
2016-07-05-ccc_tax_script,2016/07/05,ccc_tax_script,29,20,0:06:28,388,0:10:08,9,7760
2016-07-05-ccc_waste_recycling_script,2016/07/05,ccc_waste_recycling_script,0,0,0:00:00,0,0:00:00,0,0
2016-07-06-ccc_311_calgary_script,2016/07/06,ccc_311_calgary_script,4024,2889,0:05:07,307,0:20:32,1131,886923
2016-07-06-ccc_311_lobby_ph_script,2016/07/06,ccc_311_lobby_ph_script,6,3,0:00:17,17,0:00:36,3,51
2016-07-06-ccc_aserv_info_script,2016/07/06,ccc_aserv_info_script,0,0,0:00:00,0,0:00:00,0,0
2016-07-06-ccc_bylaw_script,2016/07/06,ccc_bylaw_script,0,0,0:00:00,0,0:00:00,0,0
2016-07-06-ccc_city_script,2016/07/06,ccc_city_script,19,18,0:02:42,162,0:07:45,1,2916
2016-07-06-ccc_cty_online_script,2016/07/06,ccc_cty_online_script,0,0,0:00:00,0,0:00:00,0,0
2016-07-06-ccc_feedback_script,2016/07/06,ccc_feedback_script,0,0,0:00:00,0,0:00:00,0,0
2016-07-06-ccc_fpb_script,2016/07/06,ccc_fpb_script,1,0,0:00:00,0,0:00:00,1,0
2016-07-06-ccc_help_script,2016/07/06,ccc_help_script,34,30,0:00:16,16,0:00:57,4,480
2016-07-06-ccc_link_script,2016/07/06,ccc_link_script,0,0,0:00:00,0,0:00:00,0,0
2016-07-06-ccc_media_line_script,2016/07/06,ccc_media_line_script,0,0,0:00:00,0,0:00:00,0,0
2016-07-06-ccc_priority_script,2016/07/06,ccc_priority_script,40,40,0:00:32,32,0:05:27,0,1280
2016-07-06-ccc_tax_script,2016/07/06,ccc_tax_script,31,23,0:04:42,282,0:10:15,8,6486
2016-07-06-ccc_waste_recycling_script,2016/07/06,ccc_waste_recycling_script,0,0,0:00:00,0,0:00:00,0,0
2016-07-07-ccc_311_calgary_script,2016/07/07,ccc_311_calgary_script,3845,3327,0:01:55,115,0:19:30,522,382605
2016-07-07-ccc_311_lobby_ph_script,2016/07/07,ccc_311_lobby_ph_script,3,3,0:00:04,4,0:00:06,0,12
2016-07-07-ccc_aserv_info_script,2016/07/07,ccc_aserv_info_script,0,0,0:00:00,0,0:00:00,0,0
2016-07-07-ccc_bylaw_script,2016/07/07,ccc_bylaw_script,0,0,0:00:00,0,0:00:00,0,0
2016-07-07-ccc_city_script,2016/07/07,ccc_city_script,24,22,0:00:39,39,0:03:19,2,858
2016-07-07-ccc_cty_online_script,2016/07/07,ccc_cty_online_script,0,0,0:00:00,0,0:00:00,0,0
2016-07-07-ccc_feedback_script,2016/07/07,ccc_feedback_script,0,0,0:00:00,0,0:00:00,0,0
2016-07-07-ccc_fpb_script,2016/07/07,ccc_fpb_script,2,2,0:00:29,29,0:00:50,0,58
2016-07-07-ccc_help_script,2016/07/07,ccc_help_script,13,12,0:00:11,11,0:00:33,1,132
2016-07-07-ccc_link_script,2016/07/07,ccc_link_script,0,0,0:00:00,0,0:00:00,0,0
2016-07-07-ccc_media_line_script,2016/07/07,ccc_media_line_script,3,2,0:00:10,10,0:00:12,1,20
2016-07-07-ccc_priority_script,2016/07/07,ccc_priority_script,36,35,0:00:21,21,0:03:26,1,735
2016-07-07-ccc_tax_script,2016/07/07,ccc_tax_script,18,16,0:00:45,45,0:04:30,2,720
2016-07-07-ccc_waste_recycling_script,2016/07/07,ccc_waste_recycling_script,0,0,0:00:00,0,0:00:00,0,0
2016-07-08-ccc_311_calgary_script,2016/07/08,ccc_311_calgary_script,3129,3000,0:00:33,33,0:06:52,129,99000
2016-07-08-ccc_311_lobby_ph_script,2016/07/08,ccc_311_lobby_ph_script,2,2,0:00:15,15,0:00:25,0,30
2016-07-08-ccc_aserv_info_script,2016/07/08,ccc_aserv_info_script,0,0,0:00:00,0,0:00:00,0,0
2016-07-08-ccc_bylaw_script,2016/07/08,ccc_bylaw_script,0,0,0:00:00,0,0:00:00,0,0
2016-07-08-ccc_city_script,2016/07/08,ccc_city_script,22,22,0:00:13,13,0:01:31,0,286
2016-07-08-ccc_cty_online_script,2016/07/08,ccc_cty_online_script,0,0,0:00:00,0,0:00:00,0,0
2016-07-08-ccc_feedback_script,2016/07/08,ccc_feedback_script,0,0,0:00:00,0,0:00:00,0,0
2016-07-08-ccc_fpb_script,2016/07/08,ccc_fpb_script,2,1,0:00:12,12,0:00:12,1,12
2016-07-08-ccc_help_script,2016/07/08,ccc_help_script,35,34,0:00:06,6,0:00:19,1,204
2016-07-08-ccc_link_script,2016/07/08,ccc_link_script,0,0,0:00:00,0,0:00:00,0,0
2016-07-08-ccc_media_line_script,2016/07/08,ccc_media_line_script,2,2,0:00:42,42,0:01:18,0,84
2016-07-08-ccc_priority_script,2016/07/08,ccc_priority_script,37,35,0:00:08,8,0:00:30,2,280
2016-07-08-ccc_tax_script,2016/07/08,ccc_tax_script,11,11,0:00:31,31,0:02:10,0,341
2016-07-08-ccc_waste_recycling_script,2016/07/08,ccc_waste_recycling_script,0,0,0:00:00,0,0:00:00,0,0
2016-07-09-ccc_311_calgary_script,2016/07/09,ccc_311_calgary_script,1725,1397,0:01:48,108,0:10:12,328,150876
2016-07-09-ccc_311_lobby_ph_script,2016/07/09,ccc_311_lobby_ph_script,0,0,0:00:00,0,0:00:00,0,0
2016-07-09-ccc_aserv_info_script,2016/07/09,ccc_aserv_info_script,0,0,0:00:00,0,0:00:00,0,0
2016-07-09-ccc_bylaw_script,2016/07/09,ccc_bylaw_script,0,0,0:00:00,0,0:00:00,0,0
2016-07-09-ccc_city_script,2016/07/09,ccc_city_script,0,0,0:00:00,0,0:00:00,0,0
2016-07-09-ccc_cty_online_script,2016/07/09,ccc_cty_online_script,0,0,0:00:00,0,0:00:00,0,0
2016-07-09-ccc_feedback_script,2016/07/09,ccc_feedback_script,0,0,0:00:00,0,0:00:00,0,0
2016-07-09-ccc_fpb_script,2016/07/09,ccc_fpb_script,0,0,0:00:00,0,0:00:00,0,0
2016-07-09-ccc_help_script,2016/07/09,ccc_help_script,9,8,0:00:20,20,0:01:37,1,160
2016-07-09-ccc_link_script,2016/07/09,ccc_link_script,0,0,0:00:00,0,0:00:00,0,0
2016-07-09-ccc_media_line_script,2016/07/09,ccc_media_line_script,4,4,0:00:48,48,0:02:01,0,192
2016-07-09-ccc_priority_script,2016/07/09,ccc_priority_script,51,48,0:00:23,23,0:02:16,3,1104
2016-07-09-ccc_tax_script,2016/07/09,ccc_tax_script,0,0,0:00:00,0,0:00:00,0,0
2016-07-09-ccc_waste_recycling_script,2016/07/09,ccc_waste_recycling_script,0,0,0:00:00,0,0:00:00,0,0
2016-07-10-ccc_311_calgary_script,2016/07/10,ccc_311_calgary_script,1131,1081,0:00:27,27,0:10:02,50,29187
2016-07-10-ccc_311_lobby_ph_script,2016/07/10,ccc_311_lobby_ph_script,0,0,0:00:00,0,0:00:00,0,0
2016-07-10-ccc_aserv_info_script,2016/07/10,ccc_aserv_info_script,0,0,0:00:00,0,0:00:00,0,0
2016-07-10-ccc_bylaw_script,2016/07/10,ccc_bylaw_script,0,0,0:00:00,0,0:00:00,0,0
2016-07-10-ccc_city_script,2016/07/10,ccc_city_script,0,0,0:00:00,0,0:00:00,0,0
2016-07-10-ccc_cty_online_script,2016/07/10,ccc_cty_online_script,0,0,0:00:00,0,0:00:00,0,0
2016-07-10-ccc_feedback_script,2016/07/10,ccc_feedback_script,0,0,0:00:00,0,0:00:00,0,0
2016-07-10-ccc_fpb_script,2016/07/10,ccc_fpb_script,0,0,0:00:00,0,0:00:00,0,0
2016-07-10-ccc_help_script,2016/07/10,ccc_help_script,9,9,0:00:21,21,0:01:18,0,189
2016-07-10-ccc_link_script,2016/07/10,ccc_link_script,0,0,0:00:00,0,0:00:00,0,0
2016-07-10-ccc_media_line_script,2016/07/10,ccc_media_line_script,2,2,0:00:19,19,0:00:25,0,38
2016-07-10-ccc_priority_script,2016/07/10,ccc_priority_script,27,24,0:00:16,16,0:01:04,3,384
2016-07-10-ccc_tax_script,2016/07/10,ccc_tax_script,0,0,0:00:00,0,0:00:00,0,0
2016-07-10-ccc_waste_recycling_script,2016/07/10,ccc_waste_recycling_script,0,0,0:00:00,0,0:00:00,0,0
2016-07-11-ccc_311_calgary_script,2016/07/11,ccc_311_calgary_script,3935,3540,0:01:18,78,0:07:25,395,276120
2016-07-11-ccc_311_lobby_ph_script,2016/07/11,ccc_311_lobby_ph_script,8,7,0:00:09,9,0:00:21,1,63
2016-07-11-ccc_aserv_info_script,2016/07/11,ccc_aserv_info_script,0,0,0:00:00,0,0:00:00,0,0
2016-07-11-ccc_bylaw_script,2016/07/11,ccc_bylaw_script,0,0,0:00:00,0,0:00:00,0,0
2016-07-11-ccc_city_script,2016/07/11,ccc_city_script,33,31,0:00:29,29,0:03:59,2,899
2016-07-11-ccc_cty_online_script,2016/07/11,ccc_cty_online_script,0,0,0:00:00,0,0:00:00,0,0
2016-07-11-ccc_feedback_script,2016/07/11,ccc_feedback_script,0,0,0:00:00,0,0:00:00,0,0
2016-07-11-ccc_fpb_script,2016/07/11,ccc_fpb_script,0,0,0:00:00,0,0:00:00,0,0
2016-07-11-ccc_help_script,2016/07/11,ccc_help_script,12,12,0:00:07,7,0:00:37,0,84
2016-07-11-ccc_link_script,2016/07/11,ccc_link_script,0,0,0:00:00,0,0:00:00,0,0
2016-07-11-ccc_media_line_script,2016/07/11,ccc_media_line_script,4,4,0:00:11,11,0:00:24,0,44
2016-07-11-ccc_priority_script,2016/07/11,ccc_priority_script,36,31,0:00:13,13,0:00:55,5,403
2016-07-11-ccc_tax_script,2016/07/11,ccc_tax_script,15,12,0:01:40,100,0:04:18,3,1200
2016-07-11-ccc_waste_recycling_script,2016/07/11,ccc_waste_recycling_script,0,0,0:00:00,0,0:00:00,0,0
2016-07-12-ccc_311_calgary_script,2016/07/12,ccc_311_calgary_script,3700,2990,0:02:32,152,0:09:09,710,454480
2016-07-12-ccc_311_lobby_ph_script,2016/07/12,ccc_311_lobby_ph_script,6,4,0:00:06,6,0:00:09,2,24
2016-07-12-ccc_aserv_info_script,2016/07/12,ccc_aserv_info_script,0,0,0:00:00,0,0:00:00,0,0
2016-07-12-ccc_bylaw_script,2016/07/12,ccc_bylaw_script,0,0,0:00:00,0,0:00:00,0,0
2016-07-12-ccc_city_script,2016/07/12,ccc_city_script,12,11,0:00:47,47,0:03:48,1,517
2016-07-12-ccc_cty_online_script,2016/07/12,ccc_cty_online_script,0,0,0:00:00,0,0:00:00,0,0
2016-07-12-ccc_feedback_script,2016/07/12,ccc_feedback_script,0,0,0:00:00,0,0:00:00,0,0
2016-07-12-ccc_fpb_script,2016/07/12,ccc_fpb_script,0,0,0:00:00,0,0:00:00,0,0
2016-07-12-ccc_help_script,2016/07/12,ccc_help_script,15,13,0:00:12,12,0:00:38,2,156
2016-07-12-ccc_link_script,2016/07/12,ccc_link_script,0,0,0:00:00,0,0:00:00,0,0
2016-07-12-ccc_media_line_script,2016/07/12,ccc_media_line_script,3,1,0:00:12,12,0:00:12,2,12
2016-07-12-ccc_priority_script,2016/07/12,ccc_priority_script,53,52,0:00:14,14,0:00:51,1,728
2016-07-12-ccc_tax_script,2016/07/12,ccc_tax_script,23,21,0:02:46,166,0:06:26,2,3486
2016-07-12-ccc_waste_recycling_script,2016/07/12,ccc_waste_recycling_script,0,0,0:00:00,0,0:00:00,0,0
2016-07-13-ccc_311_calgary_script,2016/07/13,ccc_311_calgary_script,3416,3073,0:01:21,81,0:13:57,343,248913
2016-07-13-ccc_311_lobby_ph_script,2016/07/13,ccc_311_lobby_ph_script,5,4,0:00:14,14,0:00:20,1,56
2016-07-13-ccc_aserv_info_script,2016/07/13,ccc_aserv_info_script,0,0,0:00:00,0,0:00:00,0,0
2016-07-13-ccc_bylaw_script,2016/07/13,ccc_bylaw_script,0,0,0:00:00,0,0:00:00,0,0
2016-07-13-ccc_city_script,2016/07/13,ccc_city_script,18,15,0:00:13,13,0:00:48,3,195
2016-07-13-ccc_cty_online_script,2016/07/13,ccc_cty_online_script,0,0,0:00:00,0,0:00:00,0,0
2016-07-13-ccc_feedback_script,2016/07/13,ccc_feedback_script,0,0,0:00:00,0,0:00:00,0,0
2016-07-13-ccc_fpb_script,2016/07/13,ccc_fpb_script,0,0,0:00:00,0,0:00:00,0,0
2016-07-13-ccc_help_script,2016/07/13,ccc_help_script,16,16,0:00:13,13,0:00:54,0,208
2016-07-13-ccc_link_script,2016/07/13,ccc_link_script,0,0,0:00:00,0,0:00:00,0,0
2016-07-13-ccc_media_line_script,2016/07/13,ccc_media_line_script,0,0,0:00:00,0,0:00:00,0,0
2016-07-13-ccc_priority_script,2016/07/13,ccc_priority_script,38,38,0:00:16,16,0:01:24,0,608
2016-07-13-ccc_tax_script,2016/07/13,ccc_tax_script,15,13,0:01:01,61,0:03:52,2,793
2016-07-13-ccc_waste_recycling_script,2016/07/13,ccc_waste_recycling_script,0,0,0:00:00,0,0:00:00,0,0
2016-07-14-ccc_311_calgary_script,2016/07/14,ccc_311_calgary_script,3118,3027,0:00:23,23,0:05:36,91,69621
2016-07-14-ccc_311_lobby_ph_script,2016/07/14,ccc_311_lobby_ph_script,3,1,0:00:04,4,0:00:04,2,4
2016-07-14-ccc_aserv_info_script,2016/07/14,ccc_aserv_info_script,0,0,0:00:00,0,0:00:00,0,0
2016-07-14-ccc_bylaw_script,2016/07/14,ccc_bylaw_script,0,0,0:00:00,0,0:00:00,0,0
2016-07-14-ccc_city_script,2016/07/14,ccc_city_script,16,16,0:00:09,9,0:00:32,0,144
2016-07-14-ccc_cty_online_script,2016/07/14,ccc_cty_online_script,0,0,0:00:00,0,0:00:00,0,0
2016-07-14-ccc_feedback_script,2016/07/14,ccc_feedback_script,0,0,0:00:00,0,0:00:00,0,0
2016-07-14-ccc_fpb_script,2016/07/14,ccc_fpb_script,1,1,0:00:53,53,0:00:53,0,53
2016-07-14-ccc_help_script,2016/07/14,ccc_help_script,21,21,0:00:06,6,0:00:22,0,126
2016-07-14-ccc_link_script,2016/07/14,ccc_link_script,1,0,0:00:00,0,0:00:00,1,0
2016-07-14-ccc_media_line_script,2016/07/14,ccc_media_line_script,4,4,0:00:08,8,0:00:12,0,32
2016-07-14-ccc_priority_script,2016/07/14,ccc_priority_script,35,35,0:00:11,11,0:01:06,0,385
2016-07-14-ccc_tax_script,2016/07/14,ccc_tax_script,18,18,0:00:15,15,0:01:29,0,270
2016-07-14-ccc_waste_recycling_script,2016/07/14,ccc_waste_recycling_script,0,0,0:00:00,0,0:00:00,0,0
2016-07-15-ccc_311_calgary_script,2016/07/15,ccc_311_calgary_script,2965,2642,0:01:14,74,0:08:40,315,195508
2016-07-15-ccc_311_lobby_ph_script,2016/07/15,ccc_311_lobby_ph_script,0,0,0:00:00,0,0:00:00,0,0
2016-07-15-ccc_aserv_info_script,2016/07/15,ccc_aserv_info_script,0,0,0:00:00,0,0:00:00,0,0
2016-07-15-ccc_bylaw_script,2016/07/15,ccc_bylaw_script,0,0,0:00:00,0,0:00:00,0,0
2016-07-15-ccc_city_script,2016/07/15,ccc_city_script,21,21,0:00:24,24,0:02:57,0,504
2016-07-15-ccc_cty_online_script,2016/07/15,ccc_cty_online_script,0,0,0:00:00,0,0:00:00,0,0
2016-07-15-ccc_feedback_script,2016/07/15,ccc_feedback_script,0,0,0:00:00,0,0:00:00,0,0
2016-07-15-ccc_fpb_script,2016/07/15,ccc_fpb_script,1,0,0:00:00,0,0:00:00,1,0
2016-07-15-ccc_help_script,2016/07/15,ccc_help_script,22,22,0:00:09,9,0:00:40,0,198
2016-07-15-ccc_link_script,2016/07/15,ccc_link_script,0,0,0:00:00,0,0:00:00,0,0
2016-07-15-ccc_media_line_script,2016/07/15,ccc_media_line_script,0,0,0:00:00,0,0:00:00,0,0
2016-07-15-ccc_priority_script,2016/07/15,ccc_priority_script,48,47,0:00:10,10,0:01:43,1,470
2016-07-15-ccc_tax_script,2016/07/15,ccc_tax_script,23,21,0:00:54,54,0:05:12,2,1134
2016-07-15-ccc_waste_recycling_script,2016/07/15,ccc_waste_recycling_script,0,0,0:00:00,0,0:00:00,0,0
2016-07-16-ccc_311_calgary_script,2016/07/16,ccc_311_calgary_script,1148,1123,0:00:13,13,0:05:39,25,14599
2016-07-16-ccc_311_lobby_ph_script,2016/07/16,ccc_311_lobby_ph_script,0,0,0:00:00,0,0:00:00,0,0
2016-07-16-ccc_aserv_info_script,2016/07/16,ccc_aserv_info_script,0,0,0:00:00,0,0:00:00,0,0
2016-07-16-ccc_bylaw_script,2016/07/16,ccc_bylaw_script,0,0,0:00:00,0,0:00:00,0,0
2016-07-16-ccc_city_script,2016/07/16,ccc_city_script,0,0,0:00:00,0,0:00:00,0,0
2016-07-16-ccc_cty_online_script,2016/07/16,ccc_cty_online_script,0,0,0:00:00,0,0:00:00,0,0
2016-07-16-ccc_feedback_script,2016/07/16,ccc_feedback_script,0,0,0:00:00,0,0:00:00,0,0
2016-07-16-ccc_fpb_script,2016/07/16,ccc_fpb_script,0,0,0:00:00,0,0:00:00,0,0
2016-07-16-ccc_help_script,2016/07/16,ccc_help_script,9,9,0:00:12,12,0:01:04,0,108
2016-07-16-ccc_link_script,2016/07/16,ccc_link_script,0,0,0:00:00,0,0:00:00,0,0
2016-07-16-ccc_media_line_script,2016/07/16,ccc_media_line_script,0,0,0:00:00,0,0:00:00,0,0
2016-07-16-ccc_priority_script,2016/07/16,ccc_priority_script,28,28,0:00:18,18,0:02:02,0,504
2016-07-16-ccc_tax_script,2016/07/16,ccc_tax_script,0,0,0:00:00,0,0:00:00,0,0
2016-07-16-ccc_waste_recycling_script,2016/07/16,ccc_waste_recycling_script,0,0,0:00:00,0,0:00:00,0,0
2016-07-17-ccc_311_calgary_script,2016/07/17,ccc_311_calgary_script,991,961,0:00:14,14,0:04:47,30,13454
2016-07-17-ccc_311_lobby_ph_script,2016/07/17,ccc_311_lobby_ph_script,0,0,0:00:00,0,0:00:00,0,0
2016-07-17-ccc_aserv_info_script,2016/07/17,ccc_aserv_info_script,0,0,0:00:00,0,0:00:00,0,0
2016-07-17-ccc_bylaw_script,2016/07/17,ccc_bylaw_script,0,0,0:00:00,0,0:00:00,0,0
2016-07-17-ccc_city_script,2016/07/17,ccc_city_script,0,0,0:00:00,0,0:00:00,0,0
2016-07-17-ccc_cty_online_script,2016/07/17,ccc_cty_online_script,0,0,0:00:00,0,0:00:00,0,0
2016-07-17-ccc_feedback_script,2016/07/17,ccc_feedback_script,0,0,0:00:00,0,0:00:00,0,0
2016-07-17-ccc_fpb_script,2016/07/17,ccc_fpb_script,0,0,0:00:00,0,0:00:00,0,0
2016-07-17-ccc_help_script,2016/07/17,ccc_help_script,11,11,0:00:13,13,0:00:23,0,143
2016-07-17-ccc_link_script,2016/07/17,ccc_link_script,0,0,0:00:00,0,0:00:00,0,0
2016-07-17-ccc_media_line_script,2016/07/17,ccc_media_line_script,4,4,0:00:04,4,0:00:07,0,16
2016-07-17-ccc_priority_script,2016/07/17,ccc_priority_script,31,28,0:00:13,13,0:02:12,3,364
2016-07-17-ccc_tax_script,2016/07/17,ccc_tax_script,0,0,0:00:00,0,0:00:00,0,0
2016-07-17-ccc_waste_recycling_script,2016/07/17,ccc_waste_recycling_script,0,0,0:00:00,0,0:00:00,0,0
2016-07-18-ccc_311_calgary_script,2016/07/18,ccc_311_calgary_script,3427,3205,0:00:46,46,0:28:49,222,147430
2016-07-18-ccc_311_lobby_ph_script,2016/07/18,ccc_311_lobby_ph_script,0,0,0:00:00,0,0:00:00,0,0
2016-07-18-ccc_aserv_info_script,2016/07/18,ccc_aserv_info_script,0,0,0:00:00,0,0:00:00,0,0
2016-07-18-ccc_bylaw_script,2016/07/18,ccc_bylaw_script,0,0,0:00:00,0,0:00:00,0,0
2016-07-18-ccc_city_script,2016/07/18,ccc_city_script,48,47,0:00:21,21,0:03:19,1,987
2016-07-18-ccc_cty_online_script,2016/07/18,ccc_cty_online_script,0,0,0:00:00,0,0:00:00,0,0
2016-07-18-ccc_feedback_script,2016/07/18,ccc_feedback_script,0,0,0:00:00,0,0:00:00,0,0
2016-07-18-ccc_fpb_script,2016/07/18,ccc_fpb_script,1,0,0:00:00,0,0:00:00,1,0
2016-07-18-ccc_help_script,2016/07/18,ccc_help_script,17,16,0:00:09,9,0:00:43,1,144
2016-07-18-ccc_link_script,2016/07/18,ccc_link_script,0,0,0:00:00,0,0:00:00,0,0
2016-07-18-ccc_media_line_script,2016/07/18,ccc_media_line_script,0,0,0:00:00,0,0:00:00,0,0
2016-07-18-ccc_priority_script,2016/07/18,ccc_priority_script,30,28,0:00:14,14,0:02:21,2,392
2016-07-18-ccc_tax_script,2016/07/18,ccc_tax_script,27,24,0:01:07,67,0:03:35,3,1608
2016-07-18-ccc_waste_recycling_script,2016/07/18,ccc_waste_recycling_script,0,0,0:00:00,0,0:00:00,0,0
2016-07-19-ccc_311_calgary_script,2016/07/19,ccc_311_calgary_script,3380,3076,0:01:15,75,0:24:54,303,230700
2016-07-19-ccc_311_lobby_ph_script,2016/07/19,ccc_311_lobby_ph_script,2,2,0:00:09,9,0:00:10,0,18
2016-07-19-ccc_aserv_info_script,2016/07/19,ccc_aserv_info_script,0,0,0:00:00,0,0:00:00,0,0
2016-07-19-ccc_bylaw_script,2016/07/19,ccc_bylaw_script,0,0,0:00:00,0,0:00:00,0,0
2016-07-19-ccc_city_script,2016/07/19,ccc_city_script,35,33,0:00:32,32,0:03:23,2,1056
2016-07-19-ccc_cty_online_script,2016/07/19,ccc_cty_online_script,0,0,0:00:00,0,0:00:00,0,0
2016-07-19-ccc_feedback_script,2016/07/19,ccc_feedback_script,0,0,0:00:00,0,0:00:00,0,0
2016-07-19-ccc_fpb_script,2016/07/19,ccc_fpb_script,1,1,0:00:08,8,0:00:08,0,8
2016-07-19-ccc_help_script,2016/07/19,ccc_help_script,20,20,0:00:10,10,0:00:33,0,200
2016-07-19-ccc_link_script,2016/07/19,ccc_link_script,0,0,0:00:00,0,0:00:00,0,0
2016-07-19-ccc_media_line_script,2016/07/19,ccc_media_line_script,1,1,0:00:05,5,0:00:05,0,5
2016-07-19-ccc_priority_script,2016/07/19,ccc_priority_script,49,46,0:00:22,22,0:03:02,3,1012
2016-07-19-ccc_tax_script,2016/07/19,ccc_tax_script,13,11,0:01:14,74,0:05:10,2,814
2016-07-19-ccc_waste_recycling_script,2016/07/19,ccc_waste_recycling_script,0,0,0:00:00,0,0:00:00,0,0
2016-07-20-ccc_311_calgary_script,2016/07/20,ccc_311_calgary_script,3796,3104,0:02:55,175,0:30:32,692,543200
2016-07-20-ccc_311_lobby_ph_script,2016/07/20,ccc_311_lobby_ph_script,3,3,0:00:07,7,0:00:13,0,21
2016-07-20-ccc_aserv_info_script,2016/07/20,ccc_aserv_info_script,0,0,0:00:00,0,0:00:00,0,0
2016-07-20-ccc_bylaw_script,2016/07/20,ccc_bylaw_script,0,0,0:00:00,0,0:00:00,0,0
2016-07-20-ccc_city_script,2016/07/20,ccc_city_script,25,22,0:01:56,116,0:07:47,3,2552
2016-07-20-ccc_cty_online_script,2016/07/20,ccc_cty_online_script,0,0,0:00:00,0,0:00:00,0,0
2016-07-20-ccc_feedback_script,2016/07/20,ccc_feedback_script,0,0,0:00:00,0,0:00:00,0,0
2016-07-20-ccc_fpb_script,2016/07/20,ccc_fpb_script,2,1,0:06:03,363,0:06:03,1,363
2016-07-20-ccc_help_script,2016/07/20,ccc_help_script,40,34,0:00:09,9,0:00:33,6,306
2016-07-20-ccc_link_script,2016/07/20,ccc_link_script,0,0,0:00:00,0,0:00:00,0,0
2016-07-20-ccc_media_line_script,2016/07/20,ccc_media_line_script,0,0,0:00:00,0,0:00:00,0,0
2016-07-20-ccc_priority_script,2016/07/20,ccc_priority_script,45,42,0:00:28,28,0:02:43,3,1176
2016-07-20-ccc_tax_script,2016/07/20,ccc_tax_script,25,22,0:03:54,234,0:17:54,3,5148
2016-07-20-ccc_waste_recycling_script,2016/07/20,ccc_waste_recycling_script,0,0,0:00:00,0,0:00:00,0,0
2016-07-21-ccc_311_calgary_script,2016/07/21,ccc_311_calgary_script,3893,3330,0:02:07,127,0:24:13,564,422910
2016-07-21-ccc_311_lobby_ph_script,2016/07/21,ccc_311_lobby_ph_script,3,3,0:00:22,22,0:00:42,0,66
2016-07-21-ccc_aserv_info_script,2016/07/21,ccc_aserv_info_script,0,0,0:00:00,0,0:00:00,0,0
2016-07-21-ccc_bylaw_script,2016/07/21,ccc_bylaw_script,0,0,0:00:00,0,0:00:00,0,0
2016-07-21-ccc_city_script,2016/07/21,ccc_city_script,24,21,0:01:10,70,0:06:40,3,1470
2016-07-21-ccc_cty_online_script,2016/07/21,ccc_cty_online_script,0,0,0:00:00,0,0:00:00,0,0
2016-07-21-ccc_feedback_script,2016/07/21,ccc_feedback_script,0,0,0:00:00,0,0:00:00,0,0
2016-07-21-ccc_fpb_script,2016/07/21,ccc_fpb_script,0,0,0:00:00,0,0:00:00,0,0
2016-07-21-ccc_help_script,2016/07/21,ccc_help_script,39,36,0:00:09,9,0:00:40,3,324
2016-07-21-ccc_link_script,2016/07/21,ccc_link_script,0,0,0:00:00,0,0:00:00,0,0
2016-07-21-ccc_media_line_script,2016/07/21,ccc_media_line_script,0,0,0:00:00,0,0:00:00,0,0
2016-07-21-ccc_priority_script,2016/07/21,ccc_priority_script,28,25,0:00:17,17,0:01:09,3,425
2016-07-21-ccc_tax_script,2016/07/21,ccc_tax_script,16,13,0:03:23,203,0:09:11,3,2639
2016-07-21-ccc_waste_recycling_script,2016/07/21,ccc_waste_recycling_script,0,0,0:00:00,0,0:00:00,0,0
2016-07-22-ccc_311_calgary_script,2016/07/22,ccc_311_calgary_script,3406,3068,0:01:31,91,0:09:04,338,279188
2016-07-22-ccc_311_lobby_ph_script,2016/07/22,ccc_311_lobby_ph_script,4,4,0:00:05,5,0:00:08,0,20
2016-07-22-ccc_aserv_info_script,2016/07/22,ccc_aserv_info_script,0,0,0:00:00,0,0:00:00,0,0
2016-07-22-ccc_bylaw_script,2016/07/22,ccc_bylaw_script,0,0,0:00:00,0,0:00:00,0,0
2016-07-22-ccc_city_script,2016/07/22,ccc_city_script,24,22,0:00:31,31,0:02:23,2,682
2016-07-22-ccc_cty_online_script,2016/07/22,ccc_cty_online_script,0,0,0:00:00,0,0:00:00,0,0
2016-07-22-ccc_feedback_script,2016/07/22,ccc_feedback_script,0,0,0:00:00,0,0:00:00,0,0
2016-07-22-ccc_fpb_script,2016/07/22,ccc_fpb_script,0,0,0:00:00,0,0:00:00,0,0
2016-07-22-ccc_help_script,2016/07/22,ccc_help_script,19,18,0:00:10,10,0:00:28,1,180
2016-07-22-ccc_link_script,2016/07/22,ccc_link_script,0,0,0:00:00,0,0:00:00,0,0
2016-07-22-ccc_media_line_script,2016/07/22,ccc_media_line_script,3,3,0:00:31,31,0:01:17,0,93
2016-07-22-ccc_priority_script,2016/07/22,ccc_priority_script,37,37,0:00:08,8,0:00:20,0,296
2016-07-22-ccc_tax_script,2016/07/22,ccc_tax_script,12,11,0:01:25,85,0:05:26,1,935
2016-07-22-ccc_waste_recycling_script,2016/07/22,ccc_waste_recycling_script,0,0,0:00:00,0,0:00:00,0,0
2016-07-23-ccc_311_calgary_script,2016/07/23,ccc_311_calgary_script,1333,1282,0:00:28,28,0:06:25,51,35896
2016-07-23-ccc_311_lobby_ph_script,2016/07/23,ccc_311_lobby_ph_script,0,0,0:00:00,0,0:00:00,0,0
2016-07-23-ccc_aserv_info_script,2016/07/23,ccc_aserv_info_script,0,0,0:00:00,0,0:00:00,0,0
2016-07-23-ccc_bylaw_script,2016/07/23,ccc_bylaw_script,0,0,0:00:00,0,0:00:00,0,0
2016-07-23-ccc_city_script,2016/07/23,ccc_city_script,0,0,0:00:00,0,0:00:00,0,0
2016-07-23-ccc_cty_online_script,2016/07/23,ccc_cty_online_script,0,0,0:00:00,0,0:00:00,0,0
2016-07-23-ccc_feedback_script,2016/07/23,ccc_feedback_script,0,0,0:00:00,0,0:00:00,0,0
2016-07-23-ccc_fpb_script,2016/07/23,ccc_fpb_script,0,0,0:00:00,0,0:00:00,0,0
2016-07-23-ccc_help_script,2016/07/23,ccc_help_script,8,8,0:00:15,15,0:01:12,0,120
2016-07-23-ccc_link_script,2016/07/23,ccc_link_script,0,0,0:00:00,0,0:00:00,0,0
2016-07-23-ccc_media_line_script,2016/07/23,ccc_media_line_script,1,1,0:00:04,4,0:00:04,0,4
2016-07-23-ccc_priority_script,2016/07/23,ccc_priority_script,23,23,0:00:06,6,0:00:25,0,138
2016-07-23-ccc_tax_script,2016/07/23,ccc_tax_script,1,1,0:00:04,4,0:00:04,0,4
2016-07-23-ccc_waste_recycling_script,2016/07/23,ccc_waste_recycling_script,0,0,0:00:00,0,0:00:00,0,0
2016-07-24-ccc_311_calgary_script,2016/07/24,ccc_311_calgary_script,1196,1141,0:00:24,24,0:09:43,55,27384
2016-07-24-ccc_311_lobby_ph_script,2016/07/24,ccc_311_lobby_ph_script,0,0,0:00:00,0,0:00:00,0,0
2016-07-24-ccc_aserv_info_script,2016/07/24,ccc_aserv_info_script,0,0,0:00:00,0,0:00:00,0,0
2016-07-24-ccc_bylaw_script,2016/07/24,ccc_bylaw_script,0,0,0:00:00,0,0:00:00,0,0
2016-07-24-ccc_city_script,2016/07/24,ccc_city_script,0,0,0:00:00,0,0:00:00,0,0
2016-07-24-ccc_cty_online_script,2016/07/24,ccc_cty_online_script,0,0,0:00:00,0,0:00:00,0,0
2016-07-24-ccc_feedback_script,2016/07/24,ccc_feedback_script,0,0,0:00:00,0,0:00:00,0,0
2016-07-24-ccc_fpb_script,2016/07/24,ccc_fpb_script,0,0,0:00:00,0,0:00:00,0,0
2016-07-24-ccc_help_script,2016/07/24,ccc_help_script,8,8,0:00:05,5,0:00:12,0,40
2016-07-24-ccc_link_script,2016/07/24,ccc_link_script,0,0,0:00:00,0,0:00:00,0,0
2016-07-24-ccc_media_line_script,2016/07/24,ccc_media_line_script,0,0,0:00:00,0,0:00:00,0,0
2016-07-24-ccc_priority_script,2016/07/24,ccc_priority_script,32,31,0:00:06,6,0:00:27,1,186
2016-07-24-ccc_tax_script,2016/07/24,ccc_tax_script,2,2,0:00:48,48,0:01:20,0,96
2016-07-24-ccc_waste_recycling_script,2016/07/24,ccc_waste_recycling_script,0,0,0:00:00,0,0:00:00,0,0
2016-07-25-ccc_311_calgary_script,2016/07/25,ccc_311_calgary_script,3942,3539,0:01:37,97,0:14:30,403,343283
2016-07-25-ccc_311_lobby_ph_script,2016/07/25,ccc_311_lobby_ph_script,3,3,0:00:20,20,0:00:24,0,60
2016-07-25-ccc_aserv_info_script,2016/07/25,ccc_aserv_info_script,0,0,0:00:00,0,0:00:00,0,0
2016-07-25-ccc_bylaw_script,2016/07/25,ccc_bylaw_script,0,0,0:00:00,0,0:00:00,0,0
2016-07-25-ccc_city_script,2016/07/25,ccc_city_script,24,21,0:00:19,19,0:01:57,3,399
2016-07-25-ccc_cty_online_script,2016/07/25,ccc_cty_online_script,0,0,0:00:00,0,0:00:00,0,0
2016-07-25-ccc_feedback_script,2016/07/25,ccc_feedback_script,0,0,0:00:00,0,0:00:00,0,0
2016-07-25-ccc_fpb_script,2016/07/25,ccc_fpb_script,1,1,0:00:09,9,0:00:09,0,9
2016-07-25-ccc_help_script,2016/07/25,ccc_help_script,21,21,0:00:06,6,0:00:34,0,126
2016-07-25-ccc_link_script,2016/07/25,ccc_link_script,0,0,0:00:00,0,0:00:00,0,0
2016-07-25-ccc_media_line_script,2016/07/25,ccc_media_line_script,2,2,0:00:17,17,0:00:30,0,34
2016-07-25-ccc_priority_script,2016/07/25,ccc_priority_script,48,47,0:00:07,7,0:00:38,1,329
2016-07-25-ccc_tax_script,2016/07/25,ccc_tax_script,27,23,0:01:36,96,0:04:57,4,2208
2016-07-25-ccc_waste_recycling_script,2016/07/25,ccc_waste_recycling_script,0,0,0:00:00,0,0:00:00,0,0
2016-07-26-ccc_311_calgary_script,2016/07/26,ccc_311_calgary_script,3893,3429,0:01:46,106,0:11:24,464,363474
2016-07-26-ccc_311_lobby_ph_script,2016/07/26,ccc_311_lobby_ph_script,3,2,0:00:10,10,0:00:15,1,20
2016-07-26-ccc_aserv_info_script,2016/07/26,ccc_aserv_info_script,0,0,0:00:00,0,0:00:00,0,0
2016-07-26-ccc_bylaw_script,2016/07/26,ccc_bylaw_script,0,0,0:00:00,0,0:00:00,0,0
2016-07-26-ccc_city_script,2016/07/26,ccc_city_script,29,27,0:00:28,28,0:04:40,2,756
2016-07-26-ccc_cty_online_script,2016/07/26,ccc_cty_online_script,0,0,0:00:00,0,0:00:00,0,0
2016-07-26-ccc_feedback_script,2016/07/26,ccc_feedback_script,0,0,0:00:00,0,0:00:00,0,0
2016-07-26-ccc_fpb_script,2016/07/26,ccc_fpb_script,0,0,0:00:00,0,0:00:00,0,0
2016-07-26-ccc_help_script,2016/07/26,ccc_help_script,25,25,0:00:11,11,0:00:45,0,275
2016-07-26-ccc_link_script,2016/07/26,ccc_link_script,0,0,0:00:00,0,0:00:00,0,0
2016-07-26-ccc_media_line_script,2016/07/26,ccc_media_line_script,5,4,0:00:10,10,0:00:18,1,40
2016-07-26-ccc_priority_script,2016/07/26,ccc_priority_script,32,32,0:00:11,11,0:00:38,0,352
2016-07-26-ccc_tax_script,2016/07/26,ccc_tax_script,17,15,0:01:39,99,0:08:59,2,1485
2016-07-26-ccc_waste_recycling_script,2016/07/26,ccc_waste_recycling_script,0,0,0:00:00,0,0:00:00,0,0
2016-07-27-ccc_311_calgary_script,2016/07/27,ccc_311_calgary_script,3530,3040,0:01:59,119,0:09:16,490,361760
2016-07-27-ccc_311_lobby_ph_script,2016/07/27,ccc_311_lobby_ph_script,5,5,0:00:29,29,0:00:52,0,145
2016-07-27-ccc_aserv_info_script,2016/07/27,ccc_aserv_info_script,0,0,0:00:00,0,0:00:00,0,0
2016-07-27-ccc_bylaw_script,2016/07/27,ccc_bylaw_script,0,0,0:00:00,0,0:00:00,0,0
2016-07-27-ccc_city_script,2016/07/27,ccc_city_script,21,21,0:00:32,32,0:03:31,0,672
2016-07-27-ccc_cty_online_script,2016/07/27,ccc_cty_online_script,0,0,0:00:00,0,0:00:00,0,0
2016-07-27-ccc_feedback_script,2016/07/27,ccc_feedback_script,0,0,0:00:00,0,0:00:00,0,0
2016-07-27-ccc_fpb_script,2016/07/27,ccc_fpb_script,1,0,0:00:00,0,0:00:00,1,0
2016-07-27-ccc_help_script,2016/07/27,ccc_help_script,19,17,0:00:16,16,0:01:01,2,272
2016-07-27-ccc_link_script,2016/07/27,ccc_link_script,0,0,0:00:00,0,0:00:00,0,0
2016-07-27-ccc_media_line_script,2016/07/27,ccc_media_line_script,0,0,0:00:00,0,0:00:00,0,0
2016-07-27-ccc_priority_script,2016/07/27,ccc_priority_script,38,38,0:00:11,11,0:01:28,0,418
2016-07-27-ccc_tax_script,2016/07/27,ccc_tax_script,18,18,0:01:52,112,0:05:00,0,2016
2016-07-27-ccc_waste_recycling_script,2016/07/27,ccc_waste_recycling_script,0,0,0:00:00,0,0:00:00,0,0
2016-07-28-ccc_311_calgary_script,2016/07/28,ccc_311_calgary_script,3650,3218,0:01:54,114,0:11:54,432,366852
2016-07-28-ccc_311_lobby_ph_script,2016/07/28,ccc_311_lobby_ph_script,3,3,0:00:14,14,0:00:20,0,42
2016-07-28-ccc_aserv_info_script,2016/07/28,ccc_aserv_info_script,0,0,0:00:00,0,0:00:00,0,0
2016-07-28-ccc_bylaw_script,2016/07/28,ccc_bylaw_script,0,0,0:00:00,0,0:00:00,0,0
2016-07-28-ccc_city_script,2016/07/28,ccc_city_script,23,23,0:00:30,30,0:06:33,0,690
2016-07-28-ccc_cty_online_script,2016/07/28,ccc_cty_online_script,0,0,0:00:00,0,0:00:00,0,0
2016-07-28-ccc_feedback_script,2016/07/28,ccc_feedback_script,0,0,0:00:00,0,0:00:00,0,0
2016-07-28-ccc_fpb_script,2016/07/28,ccc_fpb_script,1,0,0:00:00,0,0:00:00,1,0
2016-07-28-ccc_help_script,2016/07/28,ccc_help_script,15,14,0:00:12,12,0:00:38,1,168
2016-07-28-ccc_link_script,2016/07/28,ccc_link_script,0,0,0:00:00,0,0:00:00,0,0
2016-07-28-ccc_media_line_script,2016/07/28,ccc_media_line_script,2,2,0:00:06,6,0:00:10,0,12
2016-07-28-ccc_priority_script,2016/07/28,ccc_priority_script,46,45,0:00:10,10,0:00:44,1,450
2016-07-28-ccc_tax_script,2016/07/28,ccc_tax_script,18,15,0:01:25,85,0:11:17,3,1275
2016-07-28-ccc_waste_recycling_script,2016/07/28,ccc_waste_recycling_script,0,0,0:00:00,0,0:00:00,0,0
2016-07-29-ccc_311_calgary_script,2016/07/29,ccc_311_calgary_script,3174,2977,0:00:52,52,0:05:49,192,154804
2016-07-29-ccc_311_lobby_ph_script,2016/07/29,ccc_311_lobby_ph_script,2,2,0:00:04,4,0:00:05,0,8
2016-07-29-ccc_aserv_info_script,2016/07/29,ccc_aserv_info_script,0,0,0:00:00,0,0:00:00,0,0
2016-07-29-ccc_bylaw_script,2016/07/29,ccc_bylaw_script,0,0,0:00:00,0,0:00:00,0,0
2016-07-29-ccc_city_script,2016/07/29,ccc_city_script,21,20,0:00:11,11,0:00:44,1,220
2016-07-29-ccc_cty_online_script,2016/07/29,ccc_cty_online_script,0,0,0:00:00,0,0:00:00,0,0
2016-07-29-ccc_feedback_script,2016/07/29,ccc_feedback_script,0,0,0:00:00,0,0:00:00,0,0
2016-07-29-ccc_fpb_script,2016/07/29,ccc_fpb_script,0,0,0:00:00,0,0:00:00,0,0
2016-07-29-ccc_help_script,2016/07/29,ccc_help_script,16,16,0:00:08,8,0:00:34,0,128
2016-07-29-ccc_link_script,2016/07/29,ccc_link_script,0,0,0:00:00,0,0:00:00,0,0
2016-07-29-ccc_media_line_script,2016/07/29,ccc_media_line_script,2,2,0:00:34,34,0:01:00,0,68
2016-07-29-ccc_priority_script,2016/07/29,ccc_priority_script,34,34,0:00:05,5,0:00:28,0,170
2016-07-29-ccc_tax_script,2016/07/29,ccc_tax_script,18,16,0:01:51,111,0:05:25,2,1776
2016-07-29-ccc_waste_recycling_script,2016/07/29,ccc_waste_recycling_script,0,0,0:00:00,0,0:00:00,0,0
2016-07-30-ccc_311_calgary_script,2016/07/30,ccc_311_calgary_script,1384,1285,0:00:44,44,0:18:03,104,56540
2016-07-30-ccc_311_lobby_ph_script,2016/07/30,ccc_311_lobby_ph_script,0,0,0:00:00,0,0:00:00,0,0
2016-07-30-ccc_aserv_info_script,2016/07/30,ccc_aserv_info_script,0,0,0:00:00,0,0:00:00,0,0
2016-07-30-ccc_bylaw_script,2016/07/30,ccc_bylaw_script,0,0,0:00:00,0,0:00:00,0,0
2016-07-30-ccc_city_script,2016/07/30,ccc_city_script,0,0,0:00:00,0,0:00:00,0,0
2016-07-30-ccc_cty_online_script,2016/07/30,ccc_cty_online_script,0,0,0:00:00,0,0:00:00,0,0
2016-07-30-ccc_feedback_script,2016/07/30,ccc_feedback_script,0,0,0:00:00,0,0:00:00,0,0
2016-07-30-ccc_fpb_script,2016/07/30,ccc_fpb_script,0,0,0:00:00,0,0:00:00,0,0
2016-07-30-ccc_help_script,2016/07/30,ccc_help_script,12,11,0:00:07,7,0:00:25,1,77
2016-07-30-ccc_link_script,2016/07/30,ccc_link_script,0,0,0:00:00,0,0:00:00,0,0
2016-07-30-ccc_media_line_script,2016/07/30,ccc_media_line_script,1,1,0:00:13,13,0:00:13,0,13
2016-07-30-ccc_priority_script,2016/07/30,ccc_priority_script,60,58,0:00:16,16,0:01:50,2,928
2016-07-30-ccc_tax_script,2016/07/30,ccc_tax_script,1,1,0:00:06,6,0:00:06,0,6
2016-07-30-ccc_waste_recycling_script,2016/07/30,ccc_waste_recycling_script,0,0,0:00:00,0,0:00:00,0,0
2016-07-31-ccc_311_calgary_script,2016/07/31,ccc_311_calgary_script,1082,994,0:00:36,36,0:22:33,88,35784
2016-07-31-ccc_311_lobby_ph_script,2016/07/31,ccc_311_lobby_ph_script,0,0,0:00:00,0,0:00:00,0,0
2016-07-31-ccc_aserv_info_script,2016/07/31,ccc_aserv_info_script,0,0,0:00:00,0,0:00:00,0,0
2016-07-31-ccc_bylaw_script,2016/07/31,ccc_bylaw_script,0,0,0:00:00,0,0:00:00,0,0
2016-07-31-ccc_city_script,2016/07/31,ccc_city_script,0,0,0:00:00,0,0:00:00,0,0
2016-07-31-ccc_cty_online_script,2016/07/31,ccc_cty_online_script,0,0,0:00:00,0,0:00:00,0,0
2016-07-31-ccc_feedback_script,2016/07/31,ccc_feedback_script,0,0,0:00:00,0,0:00:00,0,0
2016-07-31-ccc_fpb_script,2016/07/31,ccc_fpb_script,0,0,0:00:00,0,0:00:00,0,0
2016-07-31-ccc_help_script,2016/07/31,ccc_help_script,11,10,0:00:09,9,0:00:17,1,90
2016-07-31-ccc_link_script,2016/07/31,ccc_link_script,0,0,0:00:00,0,0:00:00,0,0
2016-07-31-ccc_media_line_script,2016/07/31,ccc_media_line_script,1,0,0:00:00,0,0:00:00,1,0
2016-07-31-ccc_priority_script,2016/07/31,ccc_priority_script,23,23,0:00:24,24,0:02:54,0,552
2016-07-31-ccc_tax_script,2016/07/31,ccc_tax_script,0,0,0:00:00,0,0:00:00,0,0
2016-07-31-ccc_waste_recycling_script,2016/07/31,ccc_waste_recycling_script,0,0,0:00:00,0,0:00:00,0,0
2016-08-01-ccc_311_calgary_script,2016/08/01,ccc_311_calgary_script,1378,1350,0:00:14,14,0:12:17,28,18900
2016-08-01-ccc_311_lobby_ph_script,2016/08/01,ccc_311_lobby_ph_script,0,0,0:00:00,0,0:00:00,0,0
2016-08-01-ccc_aserv_info_script,2016/08/01,ccc_aserv_info_script,0,0,0:00:00,0,0:00:00,0,0
2016-08-01-ccc_bylaw_script,2016/08/01,ccc_bylaw_script,0,0,0:00:00,0,0:00:00,0,0
2016-08-01-ccc_city_script,2016/08/01,ccc_city_script,0,0,0:00:00,0,0:00:00,0,0
2016-08-01-ccc_cty_online_script,2016/08/01,ccc_cty_online_script,0,0,0:00:00,0,0:00:00,0,0
2016-08-01-ccc_feedback_script,2016/08/01,ccc_feedback_script,0,0,0:00:00,0,0:00:00,0,0
2016-08-01-ccc_fpb_script,2016/08/01,ccc_fpb_script,0,0,0:00:00,0,0:00:00,0,0
2016-08-01-ccc_help_script,2016/08/01,ccc_help_script,9,9,0:00:16,16,0:01:22,0,144
2016-08-01-ccc_link_script,2016/08/01,ccc_link_script,0,0,0:00:00,0,0:00:00,0,0
2016-08-01-ccc_media_line_script,2016/08/01,ccc_media_line_script,2,2,0:00:05,5,0:00:05,0,10
2016-08-01-ccc_priority_script,2016/08/01,ccc_priority_script,19,18,0:00:25,25,0:05:10,1,450
2016-08-01-ccc_tax_script,2016/08/01,ccc_tax_script,0,0,0:00:00,0,0:00:00,0,0
2016-08-01-ccc_waste_recycling_script,2016/08/01,ccc_waste_recycling_script,0,0,0:00:00,0,0:00:00,0,0
2016-08-02-ccc_311_calgary_script,2016/08/02,ccc_311_calgary_script,4016,3397,0:02:53,173,0:11:04,619,587681
2016-08-02-ccc_311_lobby_ph_script,2016/08/02,ccc_311_lobby_ph_script,3,3,0:00:06,6,0:00:09,0,18
2016-08-02-ccc_aserv_info_script,2016/08/02,ccc_aserv_info_script,0,0,0:00:00,0,0:00:00,0,0
2016-08-02-ccc_bylaw_script,2016/08/02,ccc_bylaw_script,0,0,0:00:00,0,0:00:00,0,0
2016-08-02-ccc_city_script,2016/08/02,ccc_city_script,28,27,0:00:42,42,0:04:19,1,1134
2016-08-02-ccc_cty_online_script,2016/08/02,ccc_cty_online_script,0,0,0:00:00,0,0:00:00,0,0
2016-08-02-ccc_feedback_script,2016/08/02,ccc_feedback_script,0,0,0:00:00,0,0:00:00,0,0
2016-08-02-ccc_fpb_script,2016/08/02,ccc_fpb_script,0,0,0:00:00,0,0:00:00,0,0
2016-08-02-ccc_help_script,2016/08/02,ccc_help_script,18,15,0:00:12,12,0:00:40,3,180
2016-08-02-ccc_link_script,2016/08/02,ccc_link_script,0,0,0:00:00,0,0:00:00,0,0
2016-08-02-ccc_media_line_script,2016/08/02,ccc_media_line_script,0,0,0:00:00,0,0:00:00,0,0
2016-08-02-ccc_priority_script,2016/08/02,ccc_priority_script,36,36,0:00:09,9,0:00:55,0,324
2016-08-02-ccc_tax_script,2016/08/02,ccc_tax_script,15,14,0:03:14,194,0:06:36,1,2716
2016-08-02-ccc_waste_recycling_script,2016/08/02,ccc_waste_recycling_script,0,0,0:00:00,0,0:00:00,0,0
2016-08-03-ccc_311_calgary_script,2016/08/03,ccc_311_calgary_script,3362,2743,0:03:22,202,0:13:34,619,554086
2016-08-03-ccc_311_lobby_ph_script,2016/08/03,ccc_311_lobby_ph_script,3,3,0:00:09,9,0:00:14,0,27
2016-08-03-ccc_aserv_info_script,2016/08/03,ccc_aserv_info_script,0,0,0:00:00,0,0:00:00,0,0
2016-08-03-ccc_bylaw_script,2016/08/03,ccc_bylaw_script,0,0,0:00:00,0,0:00:00,0,0
2016-08-03-ccc_city_script,2016/08/03,ccc_city_script,23,23,0:01:21,81,0:07:22,0,1863
2016-08-03-ccc_cty_online_script,2016/08/03,ccc_cty_online_script,0,0,0:00:00,0,0:00:00,0,0
2016-08-03-ccc_feedback_script,2016/08/03,ccc_feedback_script,0,0,0:00:00,0,0:00:00,0,0
2016-08-03-ccc_fpb_script,2016/08/03,ccc_fpb_script,1,1,0:02:55,175,0:02:55,0,175
2016-08-03-ccc_help_script,2016/08/03,ccc_help_script,17,16,0:00:07,7,0:00:15,1,112
2016-08-03-ccc_link_script,2016/08/03,ccc_link_script,0,0,0:00:00,0,0:00:00,0,0
2016-08-03-ccc_media_line_script,2016/08/03,ccc_media_line_script,1,1,0:01:04,64,0:01:04,0,64
2016-08-03-ccc_priority_script,2016/08/03,ccc_priority_script,27,26,0:00:09,9,0:00:47,1,234
2016-08-03-ccc_tax_script,2016/08/03,ccc_tax_script,16,15,0:03:42,222,0:08:31,1,3330
2016-08-03-ccc_waste_recycling_script,2016/08/03,ccc_waste_recycling_script,0,0,0:00:00,0,0:00:00,0,0
2016-08-04-ccc_311_calgary_script,2016/08/04,ccc_311_calgary_script,3508,2805,0:03:43,223,0:11:58,703,625515
2016-08-04-ccc_311_lobby_ph_script,2016/08/04,ccc_311_lobby_ph_script,1,0,0:00:00,0,0:00:00,1,0
2016-08-04-ccc_aserv_info_script,2016/08/04,ccc_aserv_info_script,0,0,0:00:00,0,0:00:00,0,0
2016-08-04-ccc_bylaw_script,2016/08/04,ccc_bylaw_script,0,0,0:00:00,0,0:00:00,0,0
2016-08-04-ccc_city_script,2016/08/04,ccc_city_script,32,31,0:01:23,83,0:05:56,1,2573
2016-08-04-ccc_cty_online_script,2016/08/04,ccc_cty_online_script,0,0,0:00:00,0,0:00:00,0,0
2016-08-04-ccc_feedback_script,2016/08/04,ccc_feedback_script,0,0,0:00:00,0,0:00:00,0,0
2016-08-04-ccc_fpb_script,2016/08/04,ccc_fpb_script,1,0,0:00:00,0,0:00:00,1,0
2016-08-04-ccc_help_script,2016/08/04,ccc_help_script,16,16,0:00:14,14,0:01:11,0,224
2016-08-04-ccc_link_script,2016/08/04,ccc_link_script,0,0,0:00:00,0,0:00:00,0,0
2016-08-04-ccc_media_line_script,2016/08/04,ccc_media_line_script,0,0,0:00:00,0,0:00:00,0,0
2016-08-04-ccc_priority_script,2016/08/04,ccc_priority_script,41,37,0:00:17,17,0:01:42,4,629
2016-08-04-ccc_tax_script,2016/08/04,ccc_tax_script,12,10,0:03:29,209,0:07:27,2,2090
2016-08-04-ccc_waste_recycling_script,2016/08/04,ccc_waste_recycling_script,0,0,0:00:00,0,0:00:00,0,0
2016-08-05-ccc_311_calgary_script,2016/08/05,ccc_311_calgary_script,3354,2836,0:02:31,151,0:08:09,518,428236
2016-08-05-ccc_311_lobby_ph_script,2016/08/05,ccc_311_lobby_ph_script,0,0,0:00:00,0,0:00:00,0,0
2016-08-05-ccc_aserv_info_script,2016/08/05,ccc_aserv_info_script,0,0,0:00:00,0,0:00:00,0,0
2016-08-05-ccc_bylaw_script,2016/08/05,ccc_bylaw_script,0,0,0:00:00,0,0:00:00,0,0
2016-08-05-ccc_city_script,2016/08/05,ccc_city_script,31,29,0:01:15,75,0:06:54,2,2175
2016-08-05-ccc_cty_online_script,2016/08/05,ccc_cty_online_script,0,0,0:00:00,0,0:00:00,0,0
2016-08-05-ccc_feedback_script,2016/08/05,ccc_feedback_script,0,0,0:00:00,0,0:00:00,0,0
2016-08-05-ccc_fpb_script,2016/08/05,ccc_fpb_script,0,0,0:00:00,0,0:00:00,0,0
2016-08-05-ccc_help_script,2016/08/05,ccc_help_script,9,6,0:00:13,13,0:00:35,3,78
2016-08-05-ccc_link_script,2016/08/05,ccc_link_script,0,0,0:00:00,0,0:00:00,0,0
2016-08-05-ccc_media_line_script,2016/08/05,ccc_media_line_script,0,0,0:00:00,0,0:00:00,0,0
2016-08-05-ccc_priority_script,2016/08/05,ccc_priority_script,43,41,0:00:09,9,0:01:35,2,369
2016-08-05-ccc_tax_script,2016/08/05,ccc_tax_script,11,10,0:04:14,254,0:07:36,1,2540
2016-08-05-ccc_waste_recycling_script,2016/08/05,ccc_waste_recycling_script,0,0,0:00:00,0,0:00:00,0,0
2016-08-06-ccc_311_calgary_script,2016/08/06,ccc_311_calgary_script,1375,1165,0:01:44,104,0:12:18,208,121160
2016-08-06-ccc_311_lobby_ph_script,2016/08/06,ccc_311_lobby_ph_script,0,0,0:00:00,0,0:00:00,0,0
2016-08-06-ccc_aserv_info_script,2016/08/06,ccc_aserv_info_script,0,0,0:00:00,0,0:00:00,0,0
2016-08-06-ccc_bylaw_script,2016/08/06,ccc_bylaw_script,0,0,0:00:00,0,0:00:00,0,0
2016-08-06-ccc_city_script,2016/08/06,ccc_city_script,0,0,0:00:00,0,0:00:00,0,0
2016-08-06-ccc_cty_online_script,2016/08/06,ccc_cty_online_script,0,0,0:00:00,0,0:00:00,0,0
2016-08-06-ccc_feedback_script,2016/08/06,ccc_feedback_script,0,0,0:00:00,0,0:00:00,0,0
2016-08-06-ccc_fpb_script,2016/08/06,ccc_fpb_script,0,0,0:00:00,0,0:00:00,0,0
2016-08-06-ccc_help_script,2016/08/06,ccc_help_script,6,6,0:00:08,8,0:00:11,0,48
2016-08-06-ccc_link_script,2016/08/06,ccc_link_script,0,0,0:00:00,0,0:00:00,0,0
2016-08-06-ccc_media_line_script,2016/08/06,ccc_media_line_script,1,1,0:00:05,5,0:00:05,0,5
2016-08-06-ccc_priority_script,2016/08/06,ccc_priority_script,41,40,0:00:45,45,0:04:32,1,1800
2016-08-06-ccc_tax_script,2016/08/06,ccc_tax_script,0,0,0:00:00,0,0:00:00,0,0
2016-08-06-ccc_waste_recycling_script,2016/08/06,ccc_waste_recycling_script,0,0,0:00:00,0,0:00:00,0,0
2016-08-07-ccc_311_calgary_script,2016/08/07,ccc_311_calgary_script,1220,1126,0:00:51,51,0:13:49,96,57426
2016-08-07-ccc_311_lobby_ph_script,2016/08/07,ccc_311_lobby_ph_script,0,0,0:00:00,0,0:00:00,0,0
2016-08-07-ccc_aserv_info_script,2016/08/07,ccc_aserv_info_script,0,0,0:00:00,0,0:00:00,0,0
2016-08-07-ccc_bylaw_script,2016/08/07,ccc_bylaw_script,0,0,0:00:00,0,0:00:00,0,0
2016-08-07-ccc_city_script,2016/08/07,ccc_city_script,0,0,0:00:00,0,0:00:00,0,0
2016-08-07-ccc_cty_online_script,2016/08/07,ccc_cty_online_script,0,0,0:00:00,0,0:00:00,0,0
2016-08-07-ccc_feedback_script,2016/08/07,ccc_feedback_script,0,0,0:00:00,0,0:00:00,0,0
2016-08-07-ccc_fpb_script,2016/08/07,ccc_fpb_script,0,0,0:00:00,0,0:00:00,0,0
2016-08-07-ccc_help_script,2016/08/07,ccc_help_script,2,2,0:00:05,5,0:00:06,0,10
2016-08-07-ccc_link_script,2016/08/07,ccc_link_script,0,0,0:00:00,0,0:00:00,0,0
2016-08-07-ccc_media_line_script,2016/08/07,ccc_media_line_script,1,1,0:00:38,38,0:00:38,0,38
2016-08-07-ccc_priority_script,2016/08/07,ccc_priority_script,31,28,0:00:32,32,0:04:05,3,896
2016-08-07-ccc_tax_script,2016/08/07,ccc_tax_script,0,0,0:00:00,0,0:00:00,0,0
2016-08-07-ccc_waste_recycling_script,2016/08/07,ccc_waste_recycling_script,0,0,0:00:00,0,0:00:00,0,0
2016-08-08-ccc_311_calgary_script,2016/08/08,ccc_311_calgary_script,4316,2860,0:06:33,393,0:17:42,1453,1123980
2016-08-08-ccc_311_lobby_ph_script,2016/08/08,ccc_311_lobby_ph_script,5,3,0:00:16,16,0:00:24,2,48
2016-08-08-ccc_aserv_info_script,2016/08/08,ccc_aserv_info_script,0,0,0:00:00,0,0:00:00,0,0
2016-08-08-ccc_bylaw_script,2016/08/08,ccc_bylaw_script,0,0,0:00:00,0,0:00:00,0,0
2016-08-08-ccc_city_script,2016/08/08,ccc_city_script,24,19,0:02:54,174,0:07:39,5,3306
2016-08-08-ccc_cty_online_script,2016/08/08,ccc_cty_online_script,0,0,0:00:00,0,0:00:00,0,0
2016-08-08-ccc_feedback_script,2016/08/08,ccc_feedback_script,0,0,0:00:00,0,0:00:00,0,0
2016-08-08-ccc_fpb_script,2016/08/08,ccc_fpb_script,1,0,0:00:00,0,0:00:00,1,0
2016-08-08-ccc_help_script,2016/08/08,ccc_help_script,33,28,0:00:14,14,0:00:43,5,392
2016-08-08-ccc_link_script,2016/08/08,ccc_link_script,0,0,0:00:00,0,0:00:00,0,0
2016-08-08-ccc_media_line_script,2016/08/08,ccc_media_line_script,1,1,0:00:04,4,0:00:04,0,4
2016-08-08-ccc_priority_script,2016/08/08,ccc_priority_script,38,34,0:00:13,13,0:01:14,4,442
2016-08-08-ccc_tax_script,2016/08/08,ccc_tax_script,24,10,0:08:13,493,0:15:27,14,4930
2016-08-08-ccc_waste_recycling_script,2016/08/08,ccc_waste_recycling_script,0,0,0:00:00,0,0:00:00,0,0
2016-08-09-ccc_311_calgary_script,2016/08/09,ccc_311_calgary_script,3967,2983,0:04:29,269,0:14:01,985,802427
2016-08-09-ccc_311_lobby_ph_script,2016/08/09,ccc_311_lobby_ph_script,6,3,0:00:13,13,0:00:18,3,39
2016-08-09-ccc_aserv_info_script,2016/08/09,ccc_aserv_info_script,0,0,0:00:00,0,0:00:00,0,0
2016-08-09-ccc_bylaw_script,2016/08/09,ccc_bylaw_script,1,0,0:00:00,0,0:00:00,1,0
2016-08-09-ccc_city_script,2016/08/09,ccc_city_script,14,14,0:01:15,75,0:08:27,0,1050
2016-08-09-ccc_cty_online_script,2016/08/09,ccc_cty_online_script,0,0,0:00:00,0,0:00:00,0,0
2016-08-09-ccc_feedback_script,2016/08/09,ccc_feedback_script,0,0,0:00:00,0,0:00:00,0,0
2016-08-09-ccc_fpb_script,2016/08/09,ccc_fpb_script,3,0,0:00:00,0,0:00:00,3,0
2016-08-09-ccc_help_script,2016/08/09,ccc_help_script,38,33,0:00:22,22,0:04:41,5,726
2016-08-09-ccc_link_script,2016/08/09,ccc_link_script,0,0,0:00:00,0,0:00:00,0,0
2016-08-09-ccc_media_line_script,2016/08/09,ccc_media_line_script,0,0,0:00:00,0,0:00:00,0,0
2016-08-09-ccc_priority_script,2016/08/09,ccc_priority_script,35,33,0:00:12,12,0:00:38,2,396
2016-08-09-ccc_tax_script,2016/08/09,ccc_tax_script,35,24,0:04:43,283,0:10:11,11,6792
2016-08-09-ccc_waste_recycling_script,2016/08/09,ccc_waste_recycling_script,0,0,0:00:00,0,0:00:00,0,0
2016-08-10-ccc_311_calgary_script,2016/08/10,ccc_311_calgary_script,3565,2534,0:06:35,395,0:15:53,1033,1000930
2016-08-10-ccc_311_lobby_ph_script,2016/08/10,ccc_311_lobby_ph_script,5,5,0:00:11,11,0:00:18,0,55
2016-08-10-ccc_aserv_info_script,2016/08/10,ccc_aserv_info_script,0,0,0:00:00,0,0:00:00,0,0
2016-08-10-ccc_bylaw_script,2016/08/10,ccc_bylaw_script,0,0,0:00:00,0,0:00:00,0,0
2016-08-10-ccc_city_script,2016/08/10,ccc_city_script,12,11,0:04:20,260,0:14:16,1,2860
2016-08-10-ccc_cty_online_script,2016/08/10,ccc_cty_online_script,0,0,0:00:00,0,0:00:00,0,0
2016-08-10-ccc_feedback_script,2016/08/10,ccc_feedback_script,0,0,0:00:00,0,0:00:00,0,0
2016-08-10-ccc_fpb_script,2016/08/10,ccc_fpb_script,0,0,0:00:00,0,0:00:00,0,0
2016-08-10-ccc_help_script,2016/08/10,ccc_help_script,21,16,0:00:18,18,0:01:02,5,288
2016-08-10-ccc_link_script,2016/08/10,ccc_link_script,0,0,0:00:00,0,0:00:00,0,0
2016-08-10-ccc_media_line_script,2016/08/10,ccc_media_line_script,1,1,0:00:07,7,0:00:07,0,7
2016-08-10-ccc_priority_script,2016/08/10,ccc_priority_script,26,25,0:00:12,12,0:00:37,1,300
2016-08-10-ccc_tax_script,2016/08/10,ccc_tax_script,16,12,0:09:50,590,0:14:42,4,7080
2016-08-10-ccc_waste_recycling_script,2016/08/10,ccc_waste_recycling_script,0,0,0:00:00,0,0:00:00,0,0
2016-08-11-ccc_311_calgary_script,2016/08/11,ccc_311_calgary_script,3557,2690,0:04:15,255,0:12:05,867,685950
2016-08-11-ccc_311_lobby_ph_script,2016/08/11,ccc_311_lobby_ph_script,3,3,0:00:16,16,0:00:22,0,48
2016-08-11-ccc_aserv_info_script,2016/08/11,ccc_aserv_info_script,0,0,0:00:00,0,0:00:00,0,0
2016-08-11-ccc_bylaw_script,2016/08/11,ccc_bylaw_script,0,0,0:00:00,0,0:00:00,0,0
2016-08-11-ccc_city_script,2016/08/11,ccc_city_script,14,12,0:01:03,63,0:03:49,2,756
2016-08-11-ccc_cty_online_script,2016/08/11,ccc_cty_online_script,0,0,0:00:00,0,0:00:00,0,0
2016-08-11-ccc_feedback_script,2016/08/11,ccc_feedback_script,0,0,0:00:00,0,0:00:00,0,0
2016-08-11-ccc_fpb_script,2016/08/11,ccc_fpb_script,2,1,0:07:02,422,0:07:02,1,422
2016-08-11-ccc_help_script,2016/08/11,ccc_help_script,19,19,0:00:10,10,0:00:59,0,190
2016-08-11-ccc_link_script,2016/08/11,ccc_link_script,0,0,0:00:00,0,0:00:00,0,0
2016-08-11-ccc_media_line_script,2016/08/11,ccc_media_line_script,0,0,0:00:00,0,0:00:00,0,0
2016-08-11-ccc_priority_script,2016/08/11,ccc_priority_script,27,25,0:00:06,6,0:00:18,2,150
2016-08-11-ccc_tax_script,2016/08/11,ccc_tax_script,18,11,0:05:15,315,0:10:42,7,3465
2016-08-11-ccc_waste_recycling_script,2016/08/11,ccc_waste_recycling_script,0,0,0:00:00,0,0:00:00,0,0
2016-08-12-ccc_311_calgary_script,2016/08/12,ccc_311_calgary_script,3147,2618,0:02:57,177,0:10:28,529,463386
2016-08-12-ccc_311_lobby_ph_script,2016/08/12,ccc_311_lobby_ph_script,0,0,0:00:00,0,0:00:00,0,0
2016-08-12-ccc_aserv_info_script,2016/08/12,ccc_aserv_info_script,0,0,0:00:00,0,0:00:00,0,0
2016-08-12-ccc_bylaw_script,2016/08/12,ccc_bylaw_script,0,0,0:00:00,0,0:00:00,0,0
2016-08-12-ccc_city_script,2016/08/12,ccc_city_script,26,25,0:00:57,57,0:04:11,1,1425
2016-08-12-ccc_cty_online_script,2016/08/12,ccc_cty_online_script,0,0,0:00:00,0,0:00:00,0,0
2016-08-12-ccc_feedback_script,2016/08/12,ccc_feedback_script,0,0,0:00:00,0,0:00:00,0,0
2016-08-12-ccc_fpb_script,2016/08/12,ccc_fpb_script,4,2,0:02:39,159,0:03:45,2,318
2016-08-12-ccc_help_script,2016/08/12,ccc_help_script,16,15,0:00:19,19,0:03:00,1,285
2016-08-12-ccc_link_script,2016/08/12,ccc_link_script,0,0,0:00:00,0,0:00:00,0,0
2016-08-12-ccc_media_line_script,2016/08/12,ccc_media_line_script,1,1,0:00:02,2,0:00:02,0,2
2016-08-12-ccc_priority_script,2016/08/12,ccc_priority_script,35,32,0:00:19,19,0:01:07,3,608
2016-08-12-ccc_tax_script,2016/08/12,ccc_tax_script,14,12,0:03:56,236,0:07:30,2,2832
2016-08-12-ccc_waste_recycling_script,2016/08/12,ccc_waste_recycling_script,0,0,0:00:00,0,0:00:00,0,0
2016-08-13-ccc_311_calgary_script,2016/08/13,ccc_311_calgary_script,1360,1170,0:01:50,110,0:10:22,190,128700
2016-08-13-ccc_311_lobby_ph_script,2016/08/13,ccc_311_lobby_ph_script,0,0,0:00:00,0,0:00:00,0,0
2016-08-13-ccc_aserv_info_script,2016/08/13,ccc_aserv_info_script,0,0,0:00:00,0,0:00:00,0,0
2016-08-13-ccc_bylaw_script,2016/08/13,ccc_bylaw_script,0,0,0:00:00,0,0:00:00,0,0
2016-08-13-ccc_city_script,2016/08/13,ccc_city_script,0,0,0:00:00,0,0:00:00,0,0
2016-08-13-ccc_cty_online_script,2016/08/13,ccc_cty_online_script,0,0,0:00:00,0,0:00:00,0,0
2016-08-13-ccc_feedback_script,2016/08/13,ccc_feedback_script,0,0,0:00:00,0,0:00:00,0,0
2016-08-13-ccc_fpb_script,2016/08/13,ccc_fpb_script,0,0,0:00:00,0,0:00:00,0,0
2016-08-13-ccc_help_script,2016/08/13,ccc_help_script,6,5,0:00:06,6,0:00:07,1,30
2016-08-13-ccc_link_script,2016/08/13,ccc_link_script,0,0,0:00:00,0,0:00:00,0,0
2016-08-13-ccc_media_line_script,2016/08/13,ccc_media_line_script,0,0,0:00:00,0,0:00:00,0,0
2016-08-13-ccc_priority_script,2016/08/13,ccc_priority_script,25,23,0:00:14,14,0:01:38,2,322
2016-08-13-ccc_tax_script,2016/08/13,ccc_tax_script,0,0,0:00:00,0,0:00:00,0,0
2016-08-13-ccc_waste_recycling_script,2016/08/13,ccc_waste_recycling_script,0,0,0:00:00,0,0:00:00,0,0
2016-08-14-ccc_311_calgary_script,2016/08/14,ccc_311_calgary_script,1085,1016,0:00:54,54,0:11:37,69,54864
2016-08-14-ccc_311_lobby_ph_script,2016/08/14,ccc_311_lobby_ph_script,0,0,0:00:00,0,0:00:00,0,0
2016-08-14-ccc_aserv_info_script,2016/08/14,ccc_aserv_info_script,0,0,0:00:00,0,0:00:00,0,0
2016-08-14-ccc_bylaw_script,2016/08/14,ccc_bylaw_script,0,0,0:00:00,0,0:00:00,0,0
2016-08-14-ccc_city_script,2016/08/14,ccc_city_script,0,0,0:00:00,0,0:00:00,0,0
2016-08-14-ccc_cty_online_script,2016/08/14,ccc_cty_online_script,0,0,0:00:00,0,0:00:00,0,0
2016-08-14-ccc_feedback_script,2016/08/14,ccc_feedback_script,0,0,0:00:00,0,0:00:00,0,0
2016-08-14-ccc_fpb_script,2016/08/14,ccc_fpb_script,0,0,0:00:00,0,0:00:00,0,0
2016-08-14-ccc_help_script,2016/08/14,ccc_help_script,1,1,0:00:05,5,0:00:05,0,5
2016-08-14-ccc_link_script,2016/08/14,ccc_link_script,0,0,0:00:00,0,0:00:00,0,0
2016-08-14-ccc_media_line_script,2016/08/14,ccc_media_line_script,0,0,0:00:00,0,0:00:00,0,0
2016-08-14-ccc_priority_script,2016/08/14,ccc_priority_script,23,23,0:00:17,17,0:03:39,0,391
2016-08-14-ccc_tax_script,2016/08/14,ccc_tax_script,1,1,0:00:07,7,0:00:07,0,7
2016-08-14-ccc_waste_recycling_script,2016/08/14,ccc_waste_recycling_script,0,0,0:00:00,0,0:00:00,0,0
2016-08-15-ccc_311_calgary_script,2016/08/15,ccc_311_calgary_script,3932,3194,0:03:18,198,0:11:43,738,632412
2016-08-15-ccc_311_lobby_ph_script,2016/08/15,ccc_311_lobby_ph_script,1,1,0:00:02,2,0:00:02,0,2
2016-08-15-ccc_aserv_info_script,2016/08/15,ccc_aserv_info_script,0,0,0:00:00,0,0:00:00,0,0
2016-08-15-ccc_bylaw_script,2016/08/15,ccc_bylaw_script,0,0,0:00:00,0,0:00:00,0,0
2016-08-15-ccc_city_script,2016/08/15,ccc_city_script,28,24,0:00:55,55,0:05:09,4,1320
2016-08-15-ccc_cty_online_script,2016/08/15,ccc_cty_online_script,0,0,0:00:00,0,0:00:00,0,0
2016-08-15-ccc_feedback_script,2016/08/15,ccc_feedback_script,0,0,0:00:00,0,0:00:00,0,0
2016-08-15-ccc_fpb_script,2016/08/15,ccc_fpb_script,0,0,0:00:00,0,0:00:00,0,0
2016-08-15-ccc_help_script,2016/08/15,ccc_help_script,17,15,0:00:15,15,0:01:03,2,225
2016-08-15-ccc_link_script,2016/08/15,ccc_link_script,0,0,0:00:00,0,0:00:00,0,0
2016-08-15-ccc_media_line_script,2016/08/15,ccc_media_line_script,0,0,0:00:00,0,0:00:00,0,0
2016-08-15-ccc_priority_script,2016/08/15,ccc_priority_script,23,20,0:00:12,12,0:00:51,3,240
2016-08-15-ccc_tax_script,2016/08/15,ccc_tax_script,15,13,0:03:18,198,0:07:09,2,2574
2016-08-15-ccc_waste_recycling_script,2016/08/15,ccc_waste_recycling_script,0,0,0:00:00,0,0:00:00,0,0
2016-08-16-ccc_311_calgary_script,2016/08/16,ccc_311_calgary_script,3656,3094,0:01:50,110,0:07:45,508,340340
2016-08-16-ccc_311_lobby_ph_script,2016/08/16,ccc_311_lobby_ph_script,0,0,0:00:00,0,0:00:00,0,0
2016-08-16-ccc_aserv_info_script,2016/08/16,ccc_aserv_info_script,0,0,0:00:00,0,0:00:00,0,0
2016-08-16-ccc_bylaw_script,2016/08/16,ccc_bylaw_script,0,0,0:00:00,0,0:00:00,0,0
2016-08-16-ccc_city_script,2016/08/16,ccc_city_script,28,24,0:00:43,43,0:03:53,3,1032
2016-08-16-ccc_cty_online_script,2016/08/16,ccc_cty_online_script,0,0,0:00:00,0,0:00:00,0,0
2016-08-16-ccc_feedback_script,2016/08/16,ccc_feedback_script,0,0,0:00:00,0,0:00:00,0,0
2016-08-16-ccc_fpb_script,2016/08/16,ccc_fpb_script,0,0,0:00:00,0,0:00:00,0,0
2016-08-16-ccc_help_script,2016/08/16,ccc_help_script,23,20,0:00:10,10,0:00:34,2,200
2016-08-16-ccc_link_script,2016/08/16,ccc_link_script,2,0,0:00:00,0,0:00:00,1,0
2016-08-16-ccc_media_line_script,2016/08/16,ccc_media_line_script,2,1,0:01:44,104,0:01:44,1,104
2016-08-16-ccc_priority_script,2016/08/16,ccc_priority_script,24,21,0:00:08,8,0:00:35,2,168
2016-08-16-ccc_tax_script,2016/08/16,ccc_tax_script,13,13,0:01:14,74,0:03:48,0,962
2016-08-16-ccc_waste_recycling_script,2016/08/16,ccc_waste_recycling_script,0,0,0:00:00,0,0:00:00,0,0
2016-08-17-ccc_311_calgary_script,2016/08/17,ccc_311_calgary_script,3400,2858,0:02:41,161,0:11:25,542,460138
2016-08-17-ccc_311_lobby_ph_script,2016/08/17,ccc_311_lobby_ph_script,2,2,0:00:38,38,0:00:44,0,76
2016-08-17-ccc_aserv_info_script,2016/08/17,ccc_aserv_info_script,0,0,0:00:00,0,0:00:00,0,0
2016-08-17-ccc_bylaw_script,2016/08/17,ccc_bylaw_script,0,0,0:00:00,0,0:00:00,0,0
2016-08-17-ccc_city_script,2016/08/17,ccc_city_script,28,28,0:01:02,62,0:06:17,0,1736
2016-08-17-ccc_cty_online_script,2016/08/17,ccc_cty_online_script,0,0,0:00:00,0,0:00:00,0,0
2016-08-17-ccc_feedback_script,2016/08/17,ccc_feedback_script,0,0,0:00:00,0,0:00:00,0,0
2016-08-17-ccc_fpb_script,2016/08/17,ccc_fpb_script,2,0,0:00:00,0,0:00:00,2,0
2016-08-17-ccc_help_script,2016/08/17,ccc_help_script,36,25,0:00:18,18,0:02:33,11,450
2016-08-17-ccc_link_script,2016/08/17,ccc_link_script,0,0,0:00:00,0,0:00:00,0,0
2016-08-17-ccc_media_line_script,2016/08/17,ccc_media_line_script,3,3,0:00:08,8,0:00:12,0,24
2016-08-17-ccc_priority_script,2016/08/17,ccc_priority_script,38,37,0:00:12,12,0:01:09,1,444
2016-08-17-ccc_tax_script,2016/08/17,ccc_tax_script,8,8,0:01:10,70,0:05:51,0,560
2016-08-17-ccc_waste_recycling_script,2016/08/17,ccc_waste_recycling_script,0,0,0:00:00,0,0:00:00,0,0
2016-08-18-ccc_311_calgary_script,2016/08/18,ccc_311_calgary_script,3003,2900,0:00:27,27,0:11:50,103,78300
2016-08-18-ccc_311_lobby_ph_script,2016/08/18,ccc_311_lobby_ph_script,2,2,0:00:06,6,0:00:08,0,12
2016-08-18-ccc_aserv_info_script,2016/08/18,ccc_aserv_info_script,0,0,0:00:00,0,0:00:00,0,0
2016-08-18-ccc_bylaw_script,2016/08/18,ccc_bylaw_script,0,0,0:00:00,0,0:00:00,0,0
2016-08-18-ccc_city_script,2016/08/18,ccc_city_script,22,22,0:00:07,7,0:00:19,0,154
2016-08-18-ccc_cty_online_script,2016/08/18,ccc_cty_online_script,0,0,0:00:00,0,0:00:00,0,0
2016-08-18-ccc_feedback_script,2016/08/18,ccc_feedback_script,1,0,0:00:00,0,0:00:00,0,0
2016-08-18-ccc_fpb_script,2016/08/18,ccc_fpb_script,1,1,0:00:06,6,0:00:06,0,6
2016-08-18-ccc_help_script,2016/08/18,ccc_help_script,12,12,0:00:05,5,0:00:07,0,60
2016-08-18-ccc_link_script,2016/08/18,ccc_link_script,0,0,0:00:00,0,0:00:00,0,0
2016-08-18-ccc_media_line_script,2016/08/18,ccc_media_line_script,0,0,0:00:00,0,0:00:00,0,0
2016-08-18-ccc_priority_script,2016/08/18,ccc_priority_script,24,24,0:00:14,14,0:01:42,0,336
2016-08-18-ccc_tax_script,2016/08/18,ccc_tax_script,15,15,0:00:29,29,0:01:39,0,435
2016-08-18-ccc_waste_recycling_script,2016/08/18,ccc_waste_recycling_script,0,0,0:00:00,0,0:00:00,0,0
2016-08-19-ccc_311_calgary_script,2016/08/19,ccc_311_calgary_script,2909,2847,0:00:17,17,0:15:25,62,48399
2016-08-19-ccc_311_lobby_ph_script,2016/08/19,ccc_311_lobby_ph_script,2,2,0:00:03,3,0:00:03,0,6
2016-08-19-ccc_aserv_info_script,2016/08/19,ccc_aserv_info_script,0,0,0:00:00,0,0:00:00,0,0
2016-08-19-ccc_bylaw_script,2016/08/19,ccc_bylaw_script,0,0,0:00:00,0,0:00:00,0,0
2016-08-19-ccc_city_script,2016/08/19,ccc_city_script,22,22,0:00:06,6,0:00:19,0,132
2016-08-19-ccc_cty_online_script,2016/08/19,ccc_cty_online_script,0,0,0:00:00,0,0:00:00,0,0
2016-08-19-ccc_feedback_script,2016/08/19,ccc_feedback_script,0,0,0:00:00,0,0:00:00,0,0
2016-08-19-ccc_fpb_script,2016/08/19,ccc_fpb_script,1,1,0:00:02,2,0:00:02,0,2
2016-08-19-ccc_help_script,2016/08/19,ccc_help_script,16,16,0:00:15,15,0:01:13,0,240
2016-08-19-ccc_link_script,2016/08/19,ccc_link_script,0,0,0:00:00,0,0:00:00,0,0
2016-08-19-ccc_media_line_script,2016/08/19,ccc_media_line_script,0,0,0:00:00,0,0:00:00,0,0
2016-08-19-ccc_priority_script,2016/08/19,ccc_priority_script,18,17,0:00:13,13,0:01:52,1,221
2016-08-19-ccc_tax_script,2016/08/19,ccc_tax_script,19,19,0:00:05,5,0:00:19,0,95
2016-08-19-ccc_waste_recycling_script,2016/08/19,ccc_waste_recycling_script,0,0,0:00:00,0,0:00:00,0,0
2016-08-20-ccc_311_calgary_script,2016/08/20,ccc_311_calgary_script,1295,1217,0:00:33,33,0:19:04,78,40161
2016-08-20-ccc_311_lobby_ph_script,2016/08/20,ccc_311_lobby_ph_script,0,0,0:00:00,0,0:00:00,0,0
2016-08-20-ccc_aserv_info_script,2016/08/20,ccc_aserv_info_script,0,0,0:00:00,0,0:00:00,0,0
2016-08-20-ccc_bylaw_script,2016/08/20,ccc_bylaw_script,0,0,0:00:00,0,0:00:00,0,0
2016-08-20-ccc_city_script,2016/08/20,ccc_city_script,0,0,0:00:00,0,0:00:00,0,0
2016-08-20-ccc_cty_online_script,2016/08/20,ccc_cty_online_script,0,0,0:00:00,0,0:00:00,0,0
2016-08-20-ccc_feedback_script,2016/08/20,ccc_feedback_script,0,0,0:00:00,0,0:00:00,0,0
2016-08-20-ccc_fpb_script,2016/08/20,ccc_fpb_script,0,0,0:00:00,0,0:00:00,0,0
2016-08-20-ccc_help_script,2016/08/20,ccc_help_script,9,9,0:00:30,30,0:01:48,0,270
2016-08-20-ccc_link_script,2016/08/20,ccc_link_script,0,0,0:00:00,0,0:00:00,0,0
2016-08-20-ccc_media_line_script,2016/08/20,ccc_media_line_script,2,2,0:00:14,14,0:00:26,0,28
2016-08-20-ccc_priority_script,2016/08/20,ccc_priority_script,25,24,0:00:19,19,0:02:52,1,456
2016-08-20-ccc_tax_script,2016/08/20,ccc_tax_script,0,0,0:00:00,0,0:00:00,0,0
2016-08-20-ccc_waste_recycling_script,2016/08/20,ccc_waste_recycling_script,0,0,0:00:00,0,0:00:00,0,0
2016-08-21-ccc_311_calgary_script,2016/08/21,ccc_311_calgary_script,1086,997,0:00:51,51,0:20:19,88,50847
2016-08-21-ccc_311_lobby_ph_script,2016/08/21,ccc_311_lobby_ph_script,0,0,0:00:00,0,0:00:00,0,0
2016-08-21-ccc_aserv_info_script,2016/08/21,ccc_aserv_info_script,0,0,0:00:00,0,0:00:00,0,0
2016-08-21-ccc_bylaw_script,2016/08/21,ccc_bylaw_script,0,0,0:00:00,0,0:00:00,0,0
2016-08-21-ccc_city_script,2016/08/21,ccc_city_script,0,0,0:00:00,0,0:00:00,0,0
2016-08-21-ccc_cty_online_script,2016/08/21,ccc_cty_online_script,0,0,0:00:00,0,0:00:00,0,0
2016-08-21-ccc_feedback_script,2016/08/21,ccc_feedback_script,0,0,0:00:00,0,0:00:00,0,0
2016-08-21-ccc_fpb_script,2016/08/21,ccc_fpb_script,0,0,0:00:00,0,0:00:00,0,0
2016-08-21-ccc_help_script,2016/08/21,ccc_help_script,1,1,0:00:07,7,0:00:07,0,7
2016-08-21-ccc_link_script,2016/08/21,ccc_link_script,0,0,0:00:00,0,0:00:00,0,0
2016-08-21-ccc_media_line_script,2016/08/21,ccc_media_line_script,3,3,0:00:25,25,0:00:55,0,75
2016-08-21-ccc_priority_script,2016/08/21,ccc_priority_script,19,18,0:00:24,24,0:03:18,1,432
2016-08-21-ccc_tax_script,2016/08/21,ccc_tax_script,0,0,0:00:00,0,0:00:00,0,0
2016-08-21-ccc_waste_recycling_script,2016/08/21,ccc_waste_recycling_script,0,0,0:00:00,0,0:00:00,0,0
2016-08-22-ccc_311_calgary_script,2016/08/22,ccc_311_calgary_script,3678,3512,0:00:39,39,0:09:16,166,136968
2016-08-22-ccc_311_lobby_ph_script,2016/08/22,ccc_311_lobby_ph_script,3,3,0:00:04,4,0:00:07,0,12
2016-08-22-ccc_aserv_info_script,2016/08/22,ccc_aserv_info_script,0,0,0:00:00,0,0:00:00,0,0
2016-08-22-ccc_bylaw_script,2016/08/22,ccc_bylaw_script,1,1,0:00:32,32,0:00:32,0,32
2016-08-22-ccc_city_script,2016/08/22,ccc_city_script,19,19,0:00:12,12,0:00:33,0,228
2016-08-22-ccc_cty_online_script,2016/08/22,ccc_cty_online_script,0,0,0:00:00,0,0:00:00,0,0
2016-08-22-ccc_feedback_script,2016/08/22,ccc_feedback_script,0,0,0:00:00,0,0:00:00,0,0
2016-08-22-ccc_fpb_script,2016/08/22,ccc_fpb_script,0,0,0:00:00,0,0:00:00,0,0
2016-08-22-ccc_help_script,2016/08/22,ccc_help_script,24,24,0:00:06,6,0:00:27,0,144
2016-08-22-ccc_link_script,2016/08/22,ccc_link_script,0,0,0:00:00,0,0:00:00,0,0
2016-08-22-ccc_media_line_script,2016/08/22,ccc_media_line_script,1,1,0:00:03,3,0:00:03,0,3
2016-08-22-ccc_priority_script,2016/08/22,ccc_priority_script,34,32,0:00:21,21,0:03:29,2,672
2016-08-22-ccc_tax_script,2016/08/22,ccc_tax_script,18,17,0:00:36,36,0:03:41,1,612
2016-08-22-ccc_waste_recycling_script,2016/08/22,ccc_waste_recycling_script,0,0,0:00:00,0,0:00:00,0,0
2016-08-23-ccc_311_calgary_script,2016/08/23,ccc_311_calgary_script,3704,3362,0:01:18,78,0:08:19,342,262236
2016-08-23-ccc_311_lobby_ph_script,2016/08/23,ccc_311_lobby_ph_script,4,2,0:00:08,8,0:00:12,2,16
2016-08-23-ccc_aserv_info_script,2016/08/23,ccc_aserv_info_script,0,0,0:00:00,0,0:00:00,0,0
2016-08-23-ccc_bylaw_script,2016/08/23,ccc_bylaw_script,0,0,0:00:00,0,0:00:00,0,0
2016-08-23-ccc_city_script,2016/08/23,ccc_city_script,23,22,0:00:16,16,0:00:48,1,352
2016-08-23-ccc_cty_online_script,2016/08/23,ccc_cty_online_script,0,0,0:00:00,0,0:00:00,0,0
2016-08-23-ccc_feedback_script,2016/08/23,ccc_feedback_script,1,0,0:00:00,0,0:00:00,0,0
2016-08-23-ccc_fpb_script,2016/08/23,ccc_fpb_script,1,1,0:01:16,76,0:01:16,0,76
2016-08-23-ccc_help_script,2016/08/23,ccc_help_script,25,24,0:00:11,11,0:00:26,1,264
2016-08-23-ccc_link_script,2016/08/23,ccc_link_script,0,0,0:00:00,0,0:00:00,0,0
2016-08-23-ccc_media_line_script,2016/08/23,ccc_media_line_script,2,2,0:00:08,8,0:00:14,0,16
2016-08-23-ccc_priority_script,2016/08/23,ccc_priority_script,39,38,0:00:11,11,0:00:40,1,418
2016-08-23-ccc_tax_script,2016/08/23,ccc_tax_script,11,11,0:01:20,80,0:02:55,0,880
2016-08-23-ccc_waste_recycling_script,2016/08/23,ccc_waste_recycling_script,0,0,0:00:00,0,0:00:00,0,0
2016-08-24-ccc_311_calgary_script,2016/08/24,ccc_311_calgary_script,3497,3303,0:00:44,44,0:12:35,194,145332
2016-08-24-ccc_311_lobby_ph_script,2016/08/24,ccc_311_lobby_ph_script,7,6,0:00:06,6,0:00:12,1,36
2016-08-24-ccc_aserv_info_script,2016/08/24,ccc_aserv_info_script,0,0,0:00:00,0,0:00:00,0,0
2016-08-24-ccc_bylaw_script,2016/08/24,ccc_bylaw_script,0,0,0:00:00,0,0:00:00,0,0
2016-08-24-ccc_city_script,2016/08/24,ccc_city_script,19,19,0:00:10,10,0:00:43,0,190
2016-08-24-ccc_cty_online_script,2016/08/24,ccc_cty_online_script,0,0,0:00:00,0,0:00:00,0,0
2016-08-24-ccc_feedback_script,2016/08/24,ccc_feedback_script,0,0,0:00:00,0,0:00:00,0,0
2016-08-24-ccc_fpb_script,2016/08/24,ccc_fpb_script,0,0,0:00:00,0,0:00:00,0,0
2016-08-24-ccc_help_script,2016/08/24,ccc_help_script,22,20,0:00:11,11,0:00:40,2,220
2016-08-24-ccc_link_script,2016/08/24,ccc_link_script,0,0,0:00:00,0,0:00:00,0,0
2016-08-24-ccc_media_line_script,2016/08/24,ccc_media_line_script,0,0,0:00:00,0,0:00:00,0,0
2016-08-24-ccc_priority_script,2016/08/24,ccc_priority_script,18,17,0:00:12,12,0:00:51,1,204
2016-08-24-ccc_tax_script,2016/08/24,ccc_tax_script,19,19,0:00:30,30,0:03:43,0,570
2016-08-24-ccc_waste_recycling_script,2016/08/24,ccc_waste_recycling_script,0,0,0:00:00,0,0:00:00,0,0
2016-08-25-ccc_311_calgary_script,2016/08/25,ccc_311_calgary_script,3175,3120,0:00:12,12,0:08:45,55,37440
2016-08-25-ccc_311_lobby_ph_script,2016/08/25,ccc_311_lobby_ph_script,1,1,0:00:02,2,0:00:02,0,2
2016-08-25-ccc_aserv_info_script,2016/08/25,ccc_aserv_info_script,0,0,0:00:00,0,0:00:00,0,0
2016-08-25-ccc_bylaw_script,2016/08/25,ccc_bylaw_script,0,0,0:00:00,0,0:00:00,0,0
2016-08-25-ccc_city_script,2016/08/25,ccc_city_script,9,9,0:00:07,7,0:00:17,0,63
2016-08-25-ccc_cty_online_script,2016/08/25,ccc_cty_online_script,0,0,0:00:00,0,0:00:00,0,0
2016-08-25-ccc_feedback_script,2016/08/25,ccc_feedback_script,0,0,0:00:00,0,0:00:00,0,0
2016-08-25-ccc_fpb_script,2016/08/25,ccc_fpb_script,2,2,0:00:03,3,0:00:04,0,6
2016-08-25-ccc_help_script,2016/08/25,ccc_help_script,20,20,0:00:06,6,0:00:12,0,120
2016-08-25-ccc_link_script,2016/08/25,ccc_link_script,0,0,0:00:00,0,0:00:00,0,0
2016-08-25-ccc_media_line_script,2016/08/25,ccc_media_line_script,2,2,0:00:06,6,0:00:07,0,12
2016-08-25-ccc_priority_script,2016/08/25,ccc_priority_script,36,36,0:00:06,6,0:00:22,0,216
2016-08-25-ccc_tax_script,2016/08/25,ccc_tax_script,23,23,0:00:08,8,0:00:34,0,184
2016-08-25-ccc_waste_recycling_script,2016/08/25,ccc_waste_recycling_script,0,0,0:00:00,0,0:00:00,0,0
2016-08-26-ccc_311_calgary_script,2016/08/26,ccc_311_calgary_script,3178,3115,0:00:14,14,0:05:54,63,43610
2016-08-26-ccc_311_lobby_ph_script,2016/08/26,ccc_311_lobby_ph_script,2,2,0:00:08,8,0:00:11,0,16
2016-08-26-ccc_aserv_info_script,2016/08/26,ccc_aserv_info_script,0,0,0:00:00,0,0:00:00,0,0
2016-08-26-ccc_bylaw_script,2016/08/26,ccc_bylaw_script,0,0,0:00:00,0,0:00:00,0,0
2016-08-26-ccc_city_script,2016/08/26,ccc_city_script,17,17,0:00:07,7,0:00:22,0,119
2016-08-26-ccc_cty_online_script,2016/08/26,ccc_cty_online_script,0,0,0:00:00,0,0:00:00,0,0
2016-08-26-ccc_feedback_script,2016/08/26,ccc_feedback_script,0,0,0:00:00,0,0:00:00,0,0
2016-08-26-ccc_fpb_script,2016/08/26,ccc_fpb_script,1,1,0:00:04,4,0:00:04,0,4
2016-08-26-ccc_help_script,2016/08/26,ccc_help_script,10,10,0:00:14,14,0:01:21,0,140
2016-08-26-ccc_link_script,2016/08/26,ccc_link_script,0,0,0:00:00,0,0:00:00,0,0
2016-08-26-ccc_media_line_script,2016/08/26,ccc_media_line_script,0,0,0:00:00,0,0:00:00,0,0
2016-08-26-ccc_priority_script,2016/08/26,ccc_priority_script,21,21,0:00:05,5,0:00:19,0,105
2016-08-26-ccc_tax_script,2016/08/26,ccc_tax_script,12,12,0:00:16,16,0:01:00,0,192
2016-08-26-ccc_waste_recycling_script,2016/08/26,ccc_waste_recycling_script,0,0,0:00:00,0,0:00:00,0,0
2016-08-27-ccc_311_calgary_script,2016/08/27,ccc_311_calgary_script,1308,1274,0:00:16,16,0:06:14,34,20384
2016-08-27-ccc_311_lobby_ph_script,2016/08/27,ccc_311_lobby_ph_script,0,0,0:00:00,0,0:00:00,0,0
2016-08-27-ccc_aserv_info_script,2016/08/27,ccc_aserv_info_script,0,0,0:00:00,0,0:00:00,0,0
2016-08-27-ccc_bylaw_script,2016/08/27,ccc_bylaw_script,0,0,0:00:00,0,0:00:00,0,0
2016-08-27-ccc_city_script,2016/08/27,ccc_city_script,0,0,0:00:00,0,0:00:00,0,0
2016-08-27-ccc_cty_online_script,2016/08/27,ccc_cty_online_script,0,0,0:00:00,0,0:00:00,0,0
2016-08-27-ccc_feedback_script,2016/08/27,ccc_feedback_script,0,0,0:00:00,0,0:00:00,0,0
2016-08-27-ccc_fpb_script,2016/08/27,ccc_fpb_script,0,0,0:00:00,0,0:00:00,0,0
2016-08-27-ccc_help_script,2016/08/27,ccc_help_script,6,6,0:00:08,8,0:00:17,0,48
2016-08-27-ccc_link_script,2016/08/27,ccc_link_script,0,0,0:00:00,0,0:00:00,0,0
2016-08-27-ccc_media_line_script,2016/08/27,ccc_media_line_script,1,1,0:00:04,4,0:00:04,0,4
2016-08-27-ccc_priority_script,2016/08/27,ccc_priority_script,19,19,0:00:05,5,0:00:14,0,95
2016-08-27-ccc_tax_script,2016/08/27,ccc_tax_script,0,0,0:00:00,0,0:00:00,0,0
2016-08-27-ccc_waste_recycling_script,2016/08/27,ccc_waste_recycling_script,0,0,0:00:00,0,0:00:00,0,0
2016-08-28-ccc_311_calgary_script,2016/08/28,ccc_311_calgary_script,950,912,0:00:25,25,0:09:32,38,22800
2016-08-28-ccc_311_lobby_ph_script,2016/08/28,ccc_311_lobby_ph_script,0,0,0:00:00,0,0:00:00,0,0
2016-08-28-ccc_aserv_info_script,2016/08/28,ccc_aserv_info_script,0,0,0:00:00,0,0:00:00,0,0
2016-08-28-ccc_bylaw_script,2016/08/28,ccc_bylaw_script,0,0,0:00:00,0,0:00:00,0,0
2016-08-28-ccc_city_script,2016/08/28,ccc_city_script,0,0,0:00:00,0,0:00:00,0,0
2016-08-28-ccc_cty_online_script,2016/08/28,ccc_cty_online_script,0,0,0:00:00,0,0:00:00,0,0
2016-08-28-ccc_feedback_script,2016/08/28,ccc_feedback_script,0,0,0:00:00,0,0:00:00,0,0
2016-08-28-ccc_fpb_script,2016/08/28,ccc_fpb_script,0,0,0:00:00,0,0:00:00,0,0
2016-08-28-ccc_help_script,2016/08/28,ccc_help_script,3,3,0:00:12,12,0:00:23,0,36
2016-08-28-ccc_link_script,2016/08/28,ccc_link_script,0,0,0:00:00,0,0:00:00,0,0
2016-08-28-ccc_media_line_script,2016/08/28,ccc_media_line_script,1,1,0:00:06,6,0:00:06,0,6
2016-08-28-ccc_priority_script,2016/08/28,ccc_priority_script,11,11,0:00:07,7,0:00:12,0,77
2016-08-28-ccc_tax_script,2016/08/28,ccc_tax_script,0,0,0:00:00,0,0:00:00,0,0
2016-08-28-ccc_waste_recycling_script,2016/08/28,ccc_waste_recycling_script,0,0,0:00:00,0,0:00:00,0,0
2016-08-29-ccc_311_calgary_script,2016/08/29,ccc_311_calgary_script,3595,3456,0:00:33,33,0:05:54,139,114048
2016-08-29-ccc_311_lobby_ph_script,2016/08/29,ccc_311_lobby_ph_script,0,0,0:00:00,0,0:00:00,0,0
2016-08-29-ccc_aserv_info_script,2016/08/29,ccc_aserv_info_script,0,0,0:00:00,0,0:00:00,0,0
2016-08-29-ccc_bylaw_script,2016/08/29,ccc_bylaw_script,0,0,0:00:00,0,0:00:00,0,0
2016-08-29-ccc_city_script,2016/08/29,ccc_city_script,25,25,0:00:09,9,0:00:30,0,225
2016-08-29-ccc_cty_online_script,2016/08/29,ccc_cty_online_script,0,0,0:00:00,0,0:00:00,0,0
2016-08-29-ccc_feedback_script,2016/08/29,ccc_feedback_script,0,0,0:00:00,0,0:00:00,0,0
2016-08-29-ccc_fpb_script,2016/08/29,ccc_fpb_script,3,3,0:00:20,20,0:00:39,0,60
2016-08-29-ccc_help_script,2016/08/29,ccc_help_script,30,29,0:00:06,6,0:00:17,1,174
2016-08-29-ccc_link_script,2016/08/29,ccc_link_script,0,0,0:00:00,0,0:00:00,0,0
2016-08-29-ccc_media_line_script,2016/08/29,ccc_media_line_script,0,0,0:00:00,0,0:00:00,0,0
2016-08-29-ccc_priority_script,2016/08/29,ccc_priority_script,29,27,0:00:12,12,0:01:09,2,324
2016-08-29-ccc_tax_script,2016/08/29,ccc_tax_script,20,19,0:00:20,20,0:00:55,1,380
2016-08-29-ccc_waste_recycling_script,2016/08/29,ccc_waste_recycling_script,0,0,0:00:00,0,0:00:00,0,0
2016-08-30-ccc_311_calgary_script,2016/08/30,ccc_311_calgary_script,3617,3319,0:00:55,55,0:07:41,298,182545
2016-08-30-ccc_311_lobby_ph_script,2016/08/30,ccc_311_lobby_ph_script,2,1,0:00:05,5,0:00:05,1,5
2016-08-30-ccc_aserv_info_script,2016/08/30,ccc_aserv_info_script,0,0,0:00:00,0,0:00:00,0,0
2016-08-30-ccc_bylaw_script,2016/08/30,ccc_bylaw_script,0,0,0:00:00,0,0:00:00,0,0
2016-08-30-ccc_city_script,2016/08/30,ccc_city_script,33,31,0:00:17,17,0:02:54,2,527
2016-08-30-ccc_cty_online_script,2016/08/30,ccc_cty_online_script,0,0,0:00:00,0,0:00:00,0,0
2016-08-30-ccc_feedback_script,2016/08/30,ccc_feedback_script,0,0,0:00:00,0,0:00:00,0,0
2016-08-30-ccc_fpb_script,2016/08/30,ccc_fpb_script,1,0,0:00:00,0,0:00:00,1,0
2016-08-30-ccc_help_script,2016/08/30,ccc_help_script,24,21,0:00:10,10,0:00:57,3,210
2016-08-30-ccc_link_script,2016/08/30,ccc_link_script,0,0,0:00:00,0,0:00:00,0,0
2016-08-30-ccc_media_line_script,2016/08/30,ccc_media_line_script,1,1,0:00:03,3,0:00:03,0,3
2016-08-30-ccc_priority_script,2016/08/30,ccc_priority_script,25,25,0:00:10,10,0:01:37,0,250
2016-08-30-ccc_tax_script,2016/08/30,ccc_tax_script,19,17,0:00:51,51,0:02:27,2,867
2016-08-30-ccc_waste_recycling_script,2016/08/30,ccc_waste_recycling_script,0,0,0:00:00,0,0:00:00,0,0
2016-08-31-ccc_311_calgary_script,2016/08/31,ccc_311_calgary_script,3657,3499,0:00:33,33,0:06:48,158,115467
2016-08-31-ccc_311_lobby_ph_script,2016/08/31,ccc_311_lobby_ph_script,4,4,0:00:06,6,0:00:13,0,24
2016-08-31-ccc_aserv_info_script,2016/08/31,ccc_aserv_info_script,0,0,0:00:00,0,0:00:00,0,0
2016-08-31-ccc_bylaw_script,2016/08/31,ccc_bylaw_script,0,0,0:00:00,0,0:00:00,0,0
2016-08-31-ccc_city_script,2016/08/31,ccc_city_script,19,19,0:00:08,8,0:00:19,0,152
2016-08-31-ccc_cty_online_script,2016/08/31,ccc_cty_online_script,0,0,0:00:00,0,0:00:00,0,0
2016-08-31-ccc_feedback_script,2016/08/31,ccc_feedback_script,0,0,0:00:00,0,0:00:00,0,0
2016-08-31-ccc_fpb_script,2016/08/31,ccc_fpb_script,0,0,0:00:00,0,0:00:00,0,0
2016-08-31-ccc_help_script,2016/08/31,ccc_help_script,20,19,0:00:11,11,0:01:01,1,209
2016-08-31-ccc_link_script,2016/08/31,ccc_link_script,0,0,0:00:00,0,0:00:00,0,0
2016-08-31-ccc_media_line_script,2016/08/31,ccc_media_line_script,1,1,0:00:40,40,0:00:40,0,40
2016-08-31-ccc_priority_script,2016/08/31,ccc_priority_script,37,36,0:00:08,8,0:00:41,1,288
2016-08-31-ccc_tax_script,2016/08/31,ccc_tax_script,29,27,0:00:32,32,0:03:12,2,864
2016-08-31-ccc_waste_recycling_script,2016/08/31,ccc_waste_recycling_script,0,0,0:00:00,0,0:00:00,0,0
2016-09-01-ccc_311_calgary_script,2016/09/01,ccc_311_calgary_script,3423,3295,0:00:27,27,0:06:11,128,88965
2016-09-01-ccc_311_lobby_ph_script,2016/09/01,ccc_311_lobby_ph_script,3,3,0:00:13,13,0:00:25,0,39
2016-09-01-ccc_aserv_info_script,2016/09/01,ccc_aserv_info_script,0,0,0:00:00,0,0:00:00,0,0
2016-09-01-ccc_bylaw_script,2016/09/01,ccc_bylaw_script,0,0,0:00:00,0,0:00:00,0,0
2016-09-01-ccc_city_script,2016/09/01,ccc_city_script,27,27,0:00:11,11,0:01:33,0,297
2016-09-01-ccc_cty_online_script,2016/09/01,ccc_cty_online_script,0,0,0:00:00,0,0:00:00,0,0
2016-09-01-ccc_feedback_script,2016/09/01,ccc_feedback_script,1,0,0:00:00,0,0:00:00,0,0
2016-09-01-ccc_fpb_script,2016/09/01,ccc_fpb_script,0,0,0:00:00,0,0:00:00,0,0
2016-09-01-ccc_help_script,2016/09/01,ccc_help_script,25,23,0:00:16,16,0:01:45,2,368
2016-09-01-ccc_link_script,2016/09/01,ccc_link_script,0,0,0:00:00,0,0:00:00,0,0
2016-09-01-ccc_media_line_script,2016/09/01,ccc_media_line_script,0,0,0:00:00,0,0:00:00,0,0
2016-09-01-ccc_priority_script,2016/09/01,ccc_priority_script,36,35,0:00:10,10,0:01:17,1,350
2016-09-01-ccc_tax_script,2016/09/01,ccc_tax_script,7,7,0:00:24,24,0:01:20,0,168
2016-09-01-ccc_waste_recycling_script,2016/09/01,ccc_waste_recycling_script,0,0,0:00:00,0,0:00:00,0,0
2016-09-02-ccc_311_calgary_script,2016/09/02,ccc_311_calgary_script,2931,2870,0:00:13,13,0:02:59,61,37310
2016-09-02-ccc_311_lobby_ph_script,2016/09/02,ccc_311_lobby_ph_script,1,1,0:00:02,2,0:00:02,0,2
2016-09-02-ccc_aserv_info_script,2016/09/02,ccc_aserv_info_script,0,0,0:00:00,0,0:00:00,0,0
2016-09-02-ccc_bylaw_script,2016/09/02,ccc_bylaw_script,0,0,0:00:00,0,0:00:00,0,0
2016-09-02-ccc_city_script,2016/09/02,ccc_city_script,22,21,0:00:12,12,0:01:09,1,252
2016-09-02-ccc_cty_online_script,2016/09/02,ccc_cty_online_script,0,0,0:00:00,0,0:00:00,0,0
2016-09-02-ccc_feedback_script,2016/09/02,ccc_feedback_script,0,0,0:00:00,0,0:00:00,0,0
2016-09-02-ccc_fpb_script,2016/09/02,ccc_fpb_script,0,0,0:00:00,0,0:00:00,0,0
2016-09-02-ccc_help_script,2016/09/02,ccc_help_script,15,14,0:00:07,7,0:00:14,1,98
2016-09-02-ccc_link_script,2016/09/02,ccc_link_script,0,0,0:00:00,0,0:00:00,0,0
2016-09-02-ccc_media_line_script,2016/09/02,ccc_media_line_script,1,1,0:00:03,3,0:00:03,0,3
2016-09-02-ccc_priority_script,2016/09/02,ccc_priority_script,30,29,0:00:07,7,0:00:29,1,203
2016-09-02-ccc_tax_script,2016/09/02,ccc_tax_script,12,12,0:00:11,11,0:01:12,0,132
2016-09-02-ccc_waste_recycling_script,2016/09/02,ccc_waste_recycling_script,0,0,0:00:00,0,0:00:00,0,0
2016-09-03-ccc_311_calgary_script,2016/09/03,ccc_311_calgary_script,1263,1197,0:00:42,42,0:06:28,66,50274
2016-09-03-ccc_311_lobby_ph_script,2016/09/03,ccc_311_lobby_ph_script,0,0,0:00:00,0,0:00:00,0,0
2016-09-03-ccc_aserv_info_script,2016/09/03,ccc_aserv_info_script,0,0,0:00:00,0,0:00:00,0,0
2016-09-03-ccc_bylaw_script,2016/09/03,ccc_bylaw_script,0,0,0:00:00,0,0:00:00,0,0
2016-09-03-ccc_city_script,2016/09/03,ccc_city_script,0,0,0:00:00,0,0:00:00,0,0
2016-09-03-ccc_cty_online_script,2016/09/03,ccc_cty_online_script,0,0,0:00:00,0,0:00:00,0,0
2016-09-03-ccc_feedback_script,2016/09/03,ccc_feedback_script,0,0,0:00:00,0,0:00:00,0,0
2016-09-03-ccc_fpb_script,2016/09/03,ccc_fpb_script,0,0,0:00:00,0,0:00:00,0,0
2016-09-03-ccc_help_script,2016/09/03,ccc_help_script,5,5,0:00:07,7,0:00:10,0,35
2016-09-03-ccc_link_script,2016/09/03,ccc_link_script,0,0,0:00:00,0,0:00:00,0,0
2016-09-03-ccc_media_line_script,2016/09/03,ccc_media_line_script,0,0,0:00:00,0,0:00:00,0,0
2016-09-03-ccc_priority_script,2016/09/03,ccc_priority_script,11,11,0:00:08,8,0:00:31,0,88
2016-09-03-ccc_tax_script,2016/09/03,ccc_tax_script,0,0,0:00:00,0,0:00:00,0,0
2016-09-03-ccc_waste_recycling_script,2016/09/03,ccc_waste_recycling_script,0,0,0:00:00,0,0:00:00,0,0
2016-09-04-ccc_311_calgary_script,2016/09/04,ccc_311_calgary_script,943,916,0:00:18,18,0:06:31,27,16488
2016-09-04-ccc_311_lobby_ph_script,2016/09/04,ccc_311_lobby_ph_script,0,0,0:00:00,0,0:00:00,0,0
2016-09-04-ccc_aserv_info_script,2016/09/04,ccc_aserv_info_script,0,0,0:00:00,0,0:00:00,0,0
2016-09-04-ccc_bylaw_script,2016/09/04,ccc_bylaw_script,0,0,0:00:00,0,0:00:00,0,0
2016-09-04-ccc_city_script,2016/09/04,ccc_city_script,0,0,0:00:00,0,0:00:00,0,0
2016-09-04-ccc_cty_online_script,2016/09/04,ccc_cty_online_script,0,0,0:00:00,0,0:00:00,0,0
2016-09-04-ccc_feedback_script,2016/09/04,ccc_feedback_script,0,0,0:00:00,0,0:00:00,0,0
2016-09-04-ccc_fpb_script,2016/09/04,ccc_fpb_script,0,0,0:00:00,0,0:00:00,0,0
2016-09-04-ccc_help_script,2016/09/04,ccc_help_script,6,6,0:00:11,11,0:00:31,0,66
2016-09-04-ccc_link_script,2016/09/04,ccc_link_script,0,0,0:00:00,0,0:00:00,0,0
2016-09-04-ccc_media_line_script,2016/09/04,ccc_media_line_script,2,1,0:00:05,5,0:00:05,1,5
2016-09-04-ccc_priority_script,2016/09/04,ccc_priority_script,16,16,0:00:16,16,0:02:23,0,256
2016-09-04-ccc_tax_script,2016/09/04,ccc_tax_script,0,0,0:00:00,0,0:00:00,0,0
2016-09-04-ccc_waste_recycling_script,2016/09/04,ccc_waste_recycling_script,0,0,0:00:00,0,0:00:00,0,0
2016-09-05-ccc_311_calgary_script,2016/09/05,ccc_311_calgary_script,1188,1171,0:00:07,7,0:03:32,17,8197
2016-09-05-ccc_311_lobby_ph_script,2016/09/05,ccc_311_lobby_ph_script,0,0,0:00:00,0,0:00:00,0,0
2016-09-05-ccc_aserv_info_script,2016/09/05,ccc_aserv_info_script,0,0,0:00:00,0,0:00:00,0,0
2016-09-05-ccc_bylaw_script,2016/09/05,ccc_bylaw_script,0,0,0:00:00,0,0:00:00,0,0
2016-09-05-ccc_city_script,2016/09/05,ccc_city_script,0,0,0:00:00,0,0:00:00,0,0
2016-09-05-ccc_cty_online_script,2016/09/05,ccc_cty_online_script,0,0,0:00:00,0,0:00:00,0,0
2016-09-05-ccc_feedback_script,2016/09/05,ccc_feedback_script,0,0,0:00:00,0,0:00:00,0,0
2016-09-05-ccc_fpb_script,2016/09/05,ccc_fpb_script,0,0,0:00:00,0,0:00:00,0,0
2016-09-05-ccc_help_script,2016/09/05,ccc_help_script,4,3,0:00:04,4,0:00:05,1,12
2016-09-05-ccc_link_script,2016/09/05,ccc_link_script,0,0,0:00:00,0,0:00:00,0,0
2016-09-05-ccc_media_line_script,2016/09/05,ccc_media_line_script,3,3,0:00:09,9,0:00:19,0,27
2016-09-05-ccc_priority_script,2016/09/05,ccc_priority_script,16,16,0:00:05,5,0:00:10,0,80
2016-09-05-ccc_tax_script,2016/09/05,ccc_tax_script,0,0,0:00:00,0,0:00:00,0,0
2016-09-05-ccc_waste_recycling_script,2016/09/05,ccc_waste_recycling_script,0,0,0:00:00,0,0:00:00,0,0
2016-09-06-ccc_311_calgary_script,2016/09/06,ccc_311_calgary_script,4285,4026,0:00:48,48,0:05:26,259,193248
2016-09-06-ccc_311_lobby_ph_script,2016/09/06,ccc_311_lobby_ph_script,3,2,0:00:03,3,0:00:05,1,6
2016-09-06-ccc_aserv_info_script,2016/09/06,ccc_aserv_info_script,0,0,0:00:00,0,0:00:00,0,0
2016-09-06-ccc_bylaw_script,2016/09/06,ccc_bylaw_script,0,0,0:00:00,0,0:00:00,0,0
2016-09-06-ccc_city_script,2016/09/06,ccc_city_script,29,29,0:00:13,13,0:02:21,0,377
2016-09-06-ccc_cty_online_script,2016/09/06,ccc_cty_online_script,0,0,0:00:00,0,0:00:00,0,0
2016-09-06-ccc_feedback_script,2016/09/06,ccc_feedback_script,0,0,0:00:00,0,0:00:00,0,0
2016-09-06-ccc_fpb_script,2016/09/06,ccc_fpb_script,4,4,0:00:59,59,0:01:31,0,236
2016-09-06-ccc_help_script,2016/09/06,ccc_help_script,21,20,0:00:09,9,0:00:36,1,180
2016-09-06-ccc_link_script,2016/09/06,ccc_link_script,0,0,0:00:00,0,0:00:00,0,0
2016-09-06-ccc_media_line_script,2016/09/06,ccc_media_line_script,3,1,0:00:02,2,0:00:02,2,2
2016-09-06-ccc_priority_script,2016/09/06,ccc_priority_script,35,35,0:00:11,11,0:00:41,0,385
2016-09-06-ccc_tax_script,2016/09/06,ccc_tax_script,25,23,0:01:03,63,0:03:08,2,1449
2016-09-06-ccc_waste_recycling_script,2016/09/06,ccc_waste_recycling_script,0,0,0:00:00,0,0:00:00,0,0
2016-09-07-ccc_311_calgary_script,2016/09/07,ccc_311_calgary_script,3822,3378,0:01:40,100,0:07:47,444,337800
2016-09-07-ccc_311_lobby_ph_script,2016/09/07,ccc_311_lobby_ph_script,1,1,0:00:04,4,0:00:04,0,4
2016-09-07-ccc_aserv_info_script,2016/09/07,ccc_aserv_info_script,0,0,0:00:00,0,0:00:00,0,0
2016-09-07-ccc_bylaw_script,2016/09/07,ccc_bylaw_script,0,0,0:00:00,0,0:00:00,0,0
2016-09-07-ccc_city_script,2016/09/07,ccc_city_script,16,15,0:00:14,14,0:00:27,1,210
2016-09-07-ccc_cty_online_script,2016/09/07,ccc_cty_online_script,0,0,0:00:00,0,0:00:00,0,0
2016-09-07-ccc_feedback_script,2016/09/07,ccc_feedback_script,0,0,0:00:00,0,0:00:00,0,0
2016-09-07-ccc_fpb_script,2016/09/07,ccc_fpb_script,0,0,0:00:00,0,0:00:00,0,0
2016-09-07-ccc_help_script,2016/09/07,ccc_help_script,26,26,0:00:09,9,0:00:25,0,234
2016-09-07-ccc_link_script,2016/09/07,ccc_link_script,0,0,0:00:00,0,0:00:00,0,0
2016-09-07-ccc_media_line_script,2016/09/07,ccc_media_line_script,1,1,0:00:10,10,0:00:10,0,10
2016-09-07-ccc_priority_script,2016/09/07,ccc_priority_script,48,42,0:00:10,10,0:01:03,2,420
2016-09-07-ccc_tax_script,2016/09/07,ccc_tax_script,20,19,0:02:12,132,0:07:13,1,2508
2016-09-07-ccc_waste_recycling_script,2016/09/07,ccc_waste_recycling_script,0,0,0:00:00,0,0:00:00,0,0
2016-09-08-ccc_311_calgary_script,2016/09/08,ccc_311_calgary_script,3410,3216,0:00:46,46,0:06:22,194,147936
2016-09-08-ccc_311_lobby_ph_script,2016/09/08,ccc_311_lobby_ph_script,2,2,0:00:02,2,0:00:03,0,4
2016-09-08-ccc_aserv_info_script,2016/09/08,ccc_aserv_info_script,0,0,0:00:00,0,0:00:00,0,0
2016-09-08-ccc_bylaw_script,2016/09/08,ccc_bylaw_script,0,0,0:00:00,0,0:00:00,0,0
2016-09-08-ccc_city_script,2016/09/08,ccc_city_script,14,13,0:00:14,14,0:00:58,1,182
2016-09-08-ccc_cty_online_script,2016/09/08,ccc_cty_online_script,0,0,0:00:00,0,0:00:00,0,0
2016-09-08-ccc_feedback_script,2016/09/08,ccc_feedback_script,0,0,0:00:00,0,0:00:00,0,0
2016-09-08-ccc_fpb_script,2016/09/08,ccc_fpb_script,1,1,0:00:03,3,0:00:03,0,3
2016-09-08-ccc_help_script,2016/09/08,ccc_help_script,16,14,0:00:11,11,0:00:43,2,154
2016-09-08-ccc_link_script,2016/09/08,ccc_link_script,0,0,0:00:00,0,0:00:00,0,0
2016-09-08-ccc_media_line_script,2016/09/08,ccc_media_line_script,2,2,0:00:08,8,0:00:13,0,16
2016-09-08-ccc_priority_script,2016/09/08,ccc_priority_script,23,23,0:00:07,7,0:00:25,0,161
2016-09-08-ccc_tax_script,2016/09/08,ccc_tax_script,15,14,0:00:37,37,0:02:15,1,518
2016-09-08-ccc_waste_recycling_script,2016/09/08,ccc_waste_recycling_script,0,0,0:00:00,0,0:00:00,0,0
2016-09-09-ccc_311_calgary_script,2016/09/09,ccc_311_calgary_script,3148,3091,0:00:15,15,0:06:45,57,46365
2016-09-09-ccc_311_lobby_ph_script,2016/09/09,ccc_311_lobby_ph_script,4,4,0:00:05,5,0:00:10,0,20
2016-09-09-ccc_aserv_info_script,2016/09/09,ccc_aserv_info_script,0,0,0:00:00,0,0:00:00,0,0
2016-09-09-ccc_bylaw_script,2016/09/09,ccc_bylaw_script,0,0,0:00:00,0,0:00:00,0,0
2016-09-09-ccc_city_script,2016/09/09,ccc_city_script,19,18,0:00:12,12,0:00:43,1,216
2016-09-09-ccc_cty_online_script,2016/09/09,ccc_cty_online_script,0,0,0:00:00,0,0:00:00,0,0
2016-09-09-ccc_feedback_script,2016/09/09,ccc_feedback_script,0,0,0:00:00,0,0:00:00,0,0
2016-09-09-ccc_fpb_script,2016/09/09,ccc_fpb_script,2,2,0:00:31,31,0:00:58,0,62
2016-09-09-ccc_help_script,2016/09/09,ccc_help_script,22,22,0:00:06,6,0:00:12,0,132
2016-09-09-ccc_link_script,2016/09/09,ccc_link_script,0,0,0:00:00,0,0:00:00,0,0
2016-09-09-ccc_media_line_script,2016/09/09,ccc_media_line_script,0,0,0:00:00,0,0:00:00,0,0
2016-09-09-ccc_priority_script,2016/09/09,ccc_priority_script,24,23,0:00:06,6,0:00:24,1,138
2016-09-09-ccc_tax_script,2016/09/09,ccc_tax_script,20,20,0:00:14,14,0:01:20,0,280
2016-09-09-ccc_waste_recycling_script,2016/09/09,ccc_waste_recycling_script,0,0,0:00:00,0,0:00:00,0,0
2016-09-10-ccc_311_calgary_script,2016/09/10,ccc_311_calgary_script,1362,1253,0:00:55,55,0:21:52,108,68915
2016-09-10-ccc_311_lobby_ph_script,2016/09/10,ccc_311_lobby_ph_script,0,0,0:00:00,0,0:00:00,0,0
2016-09-10-ccc_aserv_info_script,2016/09/10,ccc_aserv_info_script,0,0,0:00:00,0,0:00:00,0,0
2016-09-10-ccc_bylaw_script,2016/09/10,ccc_bylaw_script,0,0,0:00:00,0,0:00:00,0,0
2016-09-10-ccc_city_script,2016/09/10,ccc_city_script,0,0,0:00:00,0,0:00:00,0,0
2016-09-10-ccc_cty_online_script,2016/09/10,ccc_cty_online_script,0,0,0:00:00,0,0:00:00,0,0
2016-09-10-ccc_feedback_script,2016/09/10,ccc_feedback_script,0,0,0:00:00,0,0:00:00,0,0
2016-09-10-ccc_fpb_script,2016/09/10,ccc_fpb_script,0,0,0:00:00,0,0:00:00,0,0
2016-09-10-ccc_help_script,2016/09/10,ccc_help_script,11,10,0:00:08,8,0:00:17,1,80
2016-09-10-ccc_link_script,2016/09/10,ccc_link_script,0,0,0:00:00,0,0:00:00,0,0
2016-09-10-ccc_media_line_script,2016/09/10,ccc_media_line_script,0,0,0:00:00,0,0:00:00,0,0
2016-09-10-ccc_priority_script,2016/09/10,ccc_priority_script,32,32,0:00:35,35,0:03:45,0,1120
2016-09-10-ccc_tax_script,2016/09/10,ccc_tax_script,0,0,0:00:00,0,0:00:00,0,0
2016-09-10-ccc_waste_recycling_script,2016/09/10,ccc_waste_recycling_script,0,0,0:00:00,0,0:00:00,0,0
2016-09-11-ccc_311_calgary_script,2016/09/11,ccc_311_calgary_script,901,885,0:00:11,11,0:05:22,16,9735
2016-09-11-ccc_311_lobby_ph_script,2016/09/11,ccc_311_lobby_ph_script,0,0,0:00:00,0,0:00:00,0,0
2016-09-11-ccc_aserv_info_script,2016/09/11,ccc_aserv_info_script,0,0,0:00:00,0,0:00:00,0,0
2016-09-11-ccc_bylaw_script,2016/09/11,ccc_bylaw_script,0,0,0:00:00,0,0:00:00,0,0
2016-09-11-ccc_city_script,2016/09/11,ccc_city_script,0,0,0:00:00,0,0:00:00,0,0
2016-09-11-ccc_cty_online_script,2016/09/11,ccc_cty_online_script,0,0,0:00:00,0,0:00:00,0,0
2016-09-11-ccc_feedback_script,2016/09/11,ccc_feedback_script,0,0,0:00:00,0,0:00:00,0,0
2016-09-11-ccc_fpb_script,2016/09/11,ccc_fpb_script,0,0,0:00:00,0,0:00:00,0,0
2016-09-11-ccc_help_script,2016/09/11,ccc_help_script,5,5,0:00:04,4,0:00:09,0,20
2016-09-11-ccc_link_script,2016/09/11,ccc_link_script,0,0,0:00:00,0,0:00:00,0,0
2016-09-11-ccc_media_line_script,2016/09/11,ccc_media_line_script,0,0,0:00:00,0,0:00:00,0,0
2016-09-11-ccc_priority_script,2016/09/11,ccc_priority_script,15,15,0:00:13,13,0:02:12,0,195
2016-09-11-ccc_tax_script,2016/09/11,ccc_tax_script,2,2,0:00:02,2,0:00:02,0,4
2016-09-11-ccc_waste_recycling_script,2016/09/11,ccc_waste_recycling_script,0,0,0:00:00,0,0:00:00,0,0
2016-09-12-ccc_311_calgary_script,2016/09/12,ccc_311_calgary_script,3642,3531,0:00:23,23,0:08:15,110,81213
2016-09-12-ccc_311_lobby_ph_script,2016/09/12,ccc_311_lobby_ph_script,0,0,0:00:00,0,0:00:00,0,0
2016-09-12-ccc_aserv_info_script,2016/09/12,ccc_aserv_info_script,0,0,0:00:00,0,0:00:00,0,0
2016-09-12-ccc_bylaw_script,2016/09/12,ccc_bylaw_script,0,0,0:00:00,0,0:00:00,0,0
2016-09-12-ccc_city_script,2016/09/12,ccc_city_script,25,25,0:00:08,8,0:00:39,0,200
2016-09-12-ccc_cty_online_script,2016/09/12,ccc_cty_online_script,0,0,0:00:00,0,0:00:00,0,0
2016-09-12-ccc_feedback_script,2016/09/12,ccc_feedback_script,0,0,0:00:00,0,0:00:00,0,0
2016-09-12-ccc_fpb_script,2016/09/12,ccc_fpb_script,3,3,0:00:23,23,0:00:54,0,69
2016-09-12-ccc_help_script,2016/09/12,ccc_help_script,23,22,0:00:10,10,0:01:06,1,220
2016-09-12-ccc_link_script,2016/09/12,ccc_link_script,0,0,0:00:00,0,0:00:00,0,0
2016-09-12-ccc_media_line_script,2016/09/12,ccc_media_line_script,1,1,0:00:06,6,0:00:06,0,6
2016-09-12-ccc_priority_script,2016/09/12,ccc_priority_script,19,18,0:00:12,12,0:01:17,1,216
2016-09-12-ccc_tax_script,2016/09/12,ccc_tax_script,16,16,0:00:22,22,0:01:16,0,352
2016-09-12-ccc_waste_recycling_script,2016/09/12,ccc_waste_recycling_script,0,0,0:00:00,0,0:00:00,0,0
2016-09-13-ccc_311_calgary_script,2016/09/13,ccc_311_calgary_script,3322,3246,0:00:15,15,0:06:18,77,48690
2016-09-13-ccc_311_lobby_ph_script,2016/09/13,ccc_311_lobby_ph_script,2,1,0:00:02,2,0:00:02,1,2
2016-09-13-ccc_aserv_info_script,2016/09/13,ccc_aserv_info_script,0,0,0:00:00,0,0:00:00,0,0
2016-09-13-ccc_bylaw_script,2016/09/13,ccc_bylaw_script,0,0,0:00:00,0,0:00:00,0,0
2016-09-13-ccc_city_script,2016/09/13,ccc_city_script,23,22,0:00:06,6,0:00:20,1,132
2016-09-13-ccc_cty_online_script,2016/09/13,ccc_cty_online_script,0,0,0:00:00,0,0:00:00,0,0
2016-09-13-ccc_feedback_script,2016/09/13,ccc_feedback_script,0,0,0:00:00,0,0:00:00,0,0
2016-09-13-ccc_fpb_script,2016/09/13,ccc_fpb_script,0,0,0:00:00,0,0:00:00,0,0
2016-09-13-ccc_help_script,2016/09/13,ccc_help_script,27,26,0:00:08,8,0:00:41,1,208
2016-09-13-ccc_link_script,2016/09/13,ccc_link_script,0,0,0:00:00,0,0:00:00,0,0
2016-09-13-ccc_media_line_script,2016/09/13,ccc_media_line_script,1,1,0:00:12,12,0:00:12,0,12
2016-09-13-ccc_priority_script,2016/09/13,ccc_priority_script,24,23,0:00:06,6,0:00:21,1,138
2016-09-13-ccc_tax_script,2016/09/13,ccc_tax_script,18,18,0:00:07,7,0:00:22,0,126
2016-09-13-ccc_waste_recycling_script,2016/09/13,ccc_waste_recycling_script,0,0,0:00:00,0,0:00:00,0,0
2016-09-14-ccc_311_calgary_script,2016/09/14,ccc_311_calgary_script,3383,3226,0:00:32,32,0:07:23,157,103232
2016-09-14-ccc_311_lobby_ph_script,2016/09/14,ccc_311_lobby_ph_script,3,3,0:00:04,4,0:00:06,0,12
2016-09-14-ccc_aserv_info_script,2016/09/14,ccc_aserv_info_script,0,0,0:00:00,0,0:00:00,0,0
2016-09-14-ccc_bylaw_script,2016/09/14,ccc_bylaw_script,0,0,0:00:00,0,0:00:00,0,0
2016-09-14-ccc_city_script,2016/09/14,ccc_city_script,25,25,0:00:07,7,0:00:21,0,175
2016-09-14-ccc_cty_online_script,2016/09/14,ccc_cty_online_script,0,0,0:00:00,0,0:00:00,0,0
2016-09-14-ccc_feedback_script,2016/09/14,ccc_feedback_script,0,0,0:00:00,0,0:00:00,0,0
2016-09-14-ccc_fpb_script,2016/09/14,ccc_fpb_script,0,0,0:00:00,0,0:00:00,0,0
2016-09-14-ccc_help_script,2016/09/14,ccc_help_script,43,39,0:00:06,6,0:00:28,4,234
2016-09-14-ccc_link_script,2016/09/14,ccc_link_script,0,0,0:00:00,0,0:00:00,0,0
2016-09-14-ccc_media_line_script,2016/09/14,ccc_media_line_script,1,1,0:00:07,7,0:00:07,0,7
2016-09-14-ccc_priority_script,2016/09/14,ccc_priority_script,33,32,0:00:07,7,0:00:35,1,224
2016-09-14-ccc_tax_script,2016/09/14,ccc_tax_script,11,11,0:00:09,9,0:00:48,0,99
2016-09-14-ccc_waste_recycling_script,2016/09/14,ccc_waste_recycling_script,0,0,0:00:00,0,0:00:00,0,0
2016-09-15-ccc_311_calgary_script,2016/09/15,ccc_311_calgary_script,3302,3219,0:00:14,14,0:08:10,82,45066
2016-09-15-ccc_311_lobby_ph_script,2016/09/15,ccc_311_lobby_ph_script,4,3,0:00:04,4,0:00:07,1,12
2016-09-15-ccc_aserv_info_script,2016/09/15,ccc_aserv_info_script,0,0,0:00:00,0,0:00:00,0,0
2016-09-15-ccc_bylaw_script,2016/09/15,ccc_bylaw_script,0,0,0:00:00,0,0:00:00,0,0
2016-09-15-ccc_city_script,2016/09/15,ccc_city_script,28,28,0:00:05,5,0:00:10,0,140
2016-09-15-ccc_cty_online_script,2016/09/15,ccc_cty_online_script,0,0,0:00:00,0,0:00:00,0,0
2016-09-15-ccc_feedback_script,2016/09/15,ccc_feedback_script,0,0,0:00:00,0,0:00:00,0,0
2016-09-15-ccc_fpb_script,2016/09/15,ccc_fpb_script,1,1,0:00:03,3,0:00:03,0,3
2016-09-15-ccc_help_script,2016/09/15,ccc_help_script,32,31,0:00:13,13,0:02:27,1,403
2016-09-15-ccc_link_script,2016/09/15,ccc_link_script,0,0,0:00:00,0,0:00:00,0,0
2016-09-15-ccc_media_line_script,2016/09/15,ccc_media_line_script,6,4,0:00:10,10,0:00:19,2,40
2016-09-15-ccc_priority_script,2016/09/15,ccc_priority_script,32,32,0:00:06,6,0:00:21,0,192
2016-09-15-ccc_tax_script,2016/09/15,ccc_tax_script,15,15,0:00:08,8,0:00:17,0,120
2016-09-15-ccc_waste_recycling_script,2016/09/15,ccc_waste_recycling_script,0,0,0:00:00,0,0:00:00,0,0
2016-09-16-ccc_311_calgary_script,2016/09/16,ccc_311_calgary_script,3083,2886,0:00:43,43,0:07:50,198,124098
2016-09-16-ccc_311_lobby_ph_script,2016/09/16,ccc_311_lobby_ph_script,4,4,0:00:13,13,0:00:30,0,52
2016-09-16-ccc_aserv_info_script,2016/09/16,ccc_aserv_info_script,0,0,0:00:00,0,0:00:00,0,0
2016-09-16-ccc_bylaw_script,2016/09/16,ccc_bylaw_script,0,0,0:00:00,0,0:00:00,0,0
2016-09-16-ccc_city_script,2016/09/16,ccc_city_script,33,30,0:00:19,19,0:02:59,3,570
2016-09-16-ccc_cty_online_script,2016/09/16,ccc_cty_online_script,0,0,0:00:00,0,0:00:00,0,0
2016-09-16-ccc_feedback_script,2016/09/16,ccc_feedback_script,0,0,0:00:00,0,0:00:00,0,0
2016-09-16-ccc_fpb_script,2016/09/16,ccc_fpb_script,1,1,0:00:49,49,0:00:49,0,49
2016-09-16-ccc_help_script,2016/09/16,ccc_help_script,22,21,0:00:06,6,0:00:30,1,126
2016-09-16-ccc_link_script,2016/09/16,ccc_link_script,0,0,0:00:00,0,0:00:00,0,0
2016-09-16-ccc_media_line_script,2016/09/16,ccc_media_line_script,2,2,0:00:09,9,0:00:12,0,18
2016-09-16-ccc_priority_script,2016/09/16,ccc_priority_script,38,37,0:00:07,7,0:00:33,1,259
2016-09-16-ccc_tax_script,2016/09/16,ccc_tax_script,4,4,0:02:00,120,0:05:48,0,480
2016-09-16-ccc_waste_recycling_script,2016/09/16,ccc_waste_recycling_script,0,0,0:00:00,0,0:00:00,0,0
2016-09-17-ccc_311_calgary_script,2016/09/17,ccc_311_calgary_script,1395,1302,0:00:33,33,0:09:04,93,42966
2016-09-17-ccc_311_lobby_ph_script,2016/09/17,ccc_311_lobby_ph_script,0,0,0:00:00,0,0:00:00,0,0
2016-09-17-ccc_aserv_info_script,2016/09/17,ccc_aserv_info_script,0,0,0:00:00,0,0:00:00,0,0
2016-09-17-ccc_bylaw_script,2016/09/17,ccc_bylaw_script,0,0,0:00:00,0,0:00:00,0,0
2016-09-17-ccc_city_script,2016/09/17,ccc_city_script,0,0,0:00:00,0,0:00:00,0,0
2016-09-17-ccc_cty_online_script,2016/09/17,ccc_cty_online_script,0,0,0:00:00,0,0:00:00,0,0
2016-09-17-ccc_feedback_script,2016/09/17,ccc_feedback_script,0,0,0:00:00,0,0:00:00,0,0
2016-09-17-ccc_fpb_script,2016/09/17,ccc_fpb_script,0,0,0:00:00,0,0:00:00,0,0
2016-09-17-ccc_help_script,2016/09/17,ccc_help_script,2,2,0:00:45,45,0:01:21,0,90
2016-09-17-ccc_link_script,2016/09/17,ccc_link_script,0,0,0:00:00,0,0:00:00,0,0
2016-09-17-ccc_media_line_script,2016/09/17,ccc_media_line_script,10,10,0:00:10,10,0:00:25,0,100
2016-09-17-ccc_priority_script,2016/09/17,ccc_priority_script,25,24,0:00:13,13,0:01:49,1,312
2016-09-17-ccc_tax_script,2016/09/17,ccc_tax_script,1,1,0:00:34,34,0:00:34,0,34
2016-09-17-ccc_waste_recycling_script,2016/09/17,ccc_waste_recycling_script,0,0,0:00:00,0,0:00:00,0,0
2016-09-18-ccc_311_calgary_script,2016/09/18,ccc_311_calgary_script,1110,1039,0:00:28,28,0:06:09,71,29092
2016-09-18-ccc_311_lobby_ph_script,2016/09/18,ccc_311_lobby_ph_script,0,0,0:00:00,0,0:00:00,0,0
2016-09-18-ccc_aserv_info_script,2016/09/18,ccc_aserv_info_script,0,0,0:00:00,0,0:00:00,0,0
2016-09-18-ccc_bylaw_script,2016/09/18,ccc_bylaw_script,0,0,0:00:00,0,0:00:00,0,0
2016-09-18-ccc_city_script,2016/09/18,ccc_city_script,0,0,0:00:00,0,0:00:00,0,0
2016-09-18-ccc_cty_online_script,2016/09/18,ccc_cty_online_script,0,0,0:00:00,0,0:00:00,0,0
2016-09-18-ccc_feedback_script,2016/09/18,ccc_feedback_script,0,0,0:00:00,0,0:00:00,0,0
2016-09-18-ccc_fpb_script,2016/09/18,ccc_fpb_script,0,0,0:00:00,0,0:00:00,0,0
2016-09-18-ccc_help_script,2016/09/18,ccc_help_script,4,3,0:00:19,19,0:00:47,1,57
2016-09-18-ccc_link_script,2016/09/18,ccc_link_script,0,0,0:00:00,0,0:00:00,0,0
2016-09-18-ccc_media_line_script,2016/09/18,ccc_media_line_script,4,3,0:00:04,4,0:00:07,1,12
2016-09-18-ccc_priority_script,2016/09/18,ccc_priority_script,15,14,0:00:15,15,0:01:12,1,210
2016-09-18-ccc_tax_script,2016/09/18,ccc_tax_script,1,1,0:00:04,4,0:00:04,0,4
2016-09-18-ccc_waste_recycling_script,2016/09/18,ccc_waste_recycling_script,0,0,0:00:00,0,0:00:00,0,0
2016-09-19-ccc_311_calgary_script,2016/09/19,ccc_311_calgary_script,3479,3301,0:00:38,38,0:07:23,178,125438
2016-09-19-ccc_311_lobby_ph_script,2016/09/19,ccc_311_lobby_ph_script,6,5,0:00:10,10,0:00:19,1,50
2016-09-19-ccc_aserv_info_script,2016/09/19,ccc_aserv_info_script,0,0,0:00:00,0,0:00:00,0,0
2016-09-19-ccc_bylaw_script,2016/09/19,ccc_bylaw_script,0,0,0:00:00,0,0:00:00,0,0
2016-09-19-ccc_city_script,2016/09/19,ccc_city_script,14,14,0:00:09,9,0:00:36,0,126
2016-09-19-ccc_cty_online_script,2016/09/19,ccc_cty_online_script,0,0,0:00:00,0,0:00:00,0,0
2016-09-19-ccc_feedback_script,2016/09/19,ccc_feedback_script,0,0,0:00:00,0,0:00:00,0,0
2016-09-19-ccc_fpb_script,2016/09/19,ccc_fpb_script,0,0,0:00:00,0,0:00:00,0,0
2016-09-19-ccc_help_script,2016/09/19,ccc_help_script,39,38,0:00:09,9,0:01:13,1,342
2016-09-19-ccc_link_script,2016/09/19,ccc_link_script,0,0,0:00:00,0,0:00:00,0,0
2016-09-19-ccc_media_line_script,2016/09/19,ccc_media_line_script,3,3,0:00:04,4,0:00:07,0,12
2016-09-19-ccc_priority_script,2016/09/19,ccc_priority_script,24,23,0:00:12,12,0:00:47,1,276
2016-09-19-ccc_tax_script,2016/09/19,ccc_tax_script,17,17,0:00:06,6,0:00:38,0,102
2016-09-19-ccc_waste_recycling_script,2016/09/19,ccc_waste_recycling_script,0,0,0:00:00,0,0:00:00,0,0
2016-09-20-ccc_311_calgary_script,2016/09/20,ccc_311_calgary_script,3078,2986,0:00:19,19,0:06:36,92,56734
2016-09-20-ccc_311_lobby_ph_script,2016/09/20,ccc_311_lobby_ph_script,5,5,0:00:05,5,0:00:07,0,25
2016-09-20-ccc_aserv_info_script,2016/09/20,ccc_aserv_info_script,0,0,0:00:00,0,0:00:00,0,0
2016-09-20-ccc_bylaw_script,2016/09/20,ccc_bylaw_script,0,0,0:00:00,0,0:00:00,0,0
2016-09-20-ccc_city_script,2016/09/20,ccc_city_script,18,18,0:00:07,7,0:00:17,0,126
2016-09-20-ccc_cty_online_script,2016/09/20,ccc_cty_online_script,0,0,0:00:00,0,0:00:00,0,0
2016-09-20-ccc_feedback_script,2016/09/20,ccc_feedback_script,0,0,0:00:00,0,0:00:00,0,0
2016-09-20-ccc_fpb_script,2016/09/20,ccc_fpb_script,2,1,0:00:03,3,0:00:03,1,3
2016-09-20-ccc_help_script,2016/09/20,ccc_help_script,16,16,0:00:12,12,0:01:13,0,192
2016-09-20-ccc_link_script,2016/09/20,ccc_link_script,0,0,0:00:00,0,0:00:00,0,0
2016-09-20-ccc_media_line_script,2016/09/20,ccc_media_line_script,5,4,0:00:08,8,0:00:14,1,32
2016-09-20-ccc_priority_script,2016/09/20,ccc_priority_script,22,22,0:00:13,13,0:01:43,0,286
2016-09-20-ccc_tax_script,2016/09/20,ccc_tax_script,28,27,0:00:20,20,0:01:31,1,540
2016-09-20-ccc_waste_recycling_script,2016/09/20,ccc_waste_recycling_script,0,0,0:00:00,0,0:00:00,0,0
2016-09-21-ccc_311_calgary_script,2016/09/21,ccc_311_calgary_script,3152,2979,0:00:34,34,0:07:13,173,101286
2016-09-21-ccc_311_lobby_ph_script,2016/09/21,ccc_311_lobby_ph_script,0,0,0:00:00,0,0:00:00,0,0
2016-09-21-ccc_aserv_info_script,2016/09/21,ccc_aserv_info_script,0,0,0:00:00,0,0:00:00,0,0
2016-09-21-ccc_bylaw_script,2016/09/21,ccc_bylaw_script,0,0,0:00:00,0,0:00:00,0,0
2016-09-21-ccc_city_script,2016/09/21,ccc_city_script,15,15,0:00:09,9,0:00:25,0,135
2016-09-21-ccc_cty_online_script,2016/09/21,ccc_cty_online_script,0,0,0:00:00,0,0:00:00,0,0
2016-09-21-ccc_feedback_script,2016/09/21,ccc_feedback_script,0,0,0:00:00,0,0:00:00,0,0
2016-09-21-ccc_fpb_script,2016/09/21,ccc_fpb_script,2,2,0:00:03,3,0:00:03,0,6
2016-09-21-ccc_help_script,2016/09/21,ccc_help_script,22,22,0:00:07,7,0:00:27,0,154
2016-09-21-ccc_link_script,2016/09/21,ccc_link_script,0,0,0:00:00,0,0:00:00,0,0
2016-09-21-ccc_media_line_script,2016/09/21,ccc_media_line_script,1,0,0:00:00,0,0:00:00,1,0
2016-09-21-ccc_priority_script,2016/09/21,ccc_priority_script,29,28,0:00:18,18,0:02:52,1,504
2016-09-21-ccc_tax_script,2016/09/21,ccc_tax_script,22,21,0:00:26,26,0:02:01,1,546
2016-09-21-ccc_waste_recycling_script,2016/09/21,ccc_waste_recycling_script,0,0,0:00:00,0,0:00:00,0,0
2016-09-22-ccc_311_calgary_script,2016/09/22,ccc_311_calgary_script,2852,2781,0:00:17,17,0:05:25,71,47277
2016-09-22-ccc_311_lobby_ph_script,2016/09/22,ccc_311_lobby_ph_script,1,1,0:00:02,2,0:00:02,0,2
2016-09-22-ccc_aserv_info_script,2016/09/22,ccc_aserv_info_script,0,0,0:00:00,0,0:00:00,0,0
2016-09-22-ccc_bylaw_script,2016/09/22,ccc_bylaw_script,0,0,0:00:00,0,0:00:00,0,0
2016-09-22-ccc_city_script,2016/09/22,ccc_city_script,11,11,0:00:05,5,0:00:08,0,55
2016-09-22-ccc_cty_online_script,2016/09/22,ccc_cty_online_script,0,0,0:00:00,0,0:00:00,0,0
2016-09-22-ccc_feedback_script,2016/09/22,ccc_feedback_script,0,0,0:00:00,0,0:00:00,0,0
2016-09-22-ccc_fpb_script,2016/09/22,ccc_fpb_script,0,0,0:00:00,0,0:00:00,0,0
2016-09-22-ccc_help_script,2016/09/22,ccc_help_script,17,17,0:00:06,6,0:00:29,0,102
2016-09-22-ccc_link_script,2016/09/22,ccc_link_script,0,0,0:00:00,0,0:00:00,0,0
2016-09-22-ccc_media_line_script,2016/09/22,ccc_media_line_script,0,0,0:00:00,0,0:00:00,0,0
2016-09-22-ccc_priority_script,2016/09/22,ccc_priority_script,26,26,0:00:07,7,0:00:22,0,182
2016-09-22-ccc_tax_script,2016/09/22,ccc_tax_script,15,14,0:00:11,11,0:00:57,1,154
2016-09-22-ccc_waste_recycling_script,2016/09/22,ccc_waste_recycling_script,0,0,0:00:00,0,0:00:00,0,0
2016-09-23-ccc_311_calgary_script,2016/09/23,ccc_311_calgary_script,2939,2800,0:00:33,33,0:05:21,138,92400
2016-09-23-ccc_311_lobby_ph_script,2016/09/23,ccc_311_lobby_ph_script,5,5,0:00:10,10,0:00:31,0,50
2016-09-23-ccc_aserv_info_script,2016/09/23,ccc_aserv_info_script,0,0,0:00:00,0,0:00:00,0,0
2016-09-23-ccc_bylaw_script,2016/09/23,ccc_bylaw_script,0,0,0:00:00,0,0:00:00,0,0
2016-09-23-ccc_city_script,2016/09/23,ccc_city_script,12,10,0:00:19,19,0:01:10,2,190
2016-09-23-ccc_cty_online_script,2016/09/23,ccc_cty_online_script,0,0,0:00:00,0,0:00:00,0,0
2016-09-23-ccc_feedback_script,2016/09/23,ccc_feedback_script,0,0,0:00:00,0,0:00:00,0,0
2016-09-23-ccc_fpb_script,2016/09/23,ccc_fpb_script,0,0,0:00:00,0,0:00:00,0,0
2016-09-23-ccc_help_script,2016/09/23,ccc_help_script,12,11,0:00:05,5,0:00:12,1,55
2016-09-23-ccc_link_script,2016/09/23,ccc_link_script,0,0,0:00:00,0,0:00:00,0,0
2016-09-23-ccc_media_line_script,2016/09/23,ccc_media_line_script,0,0,0:00:00,0,0:00:00,0,0
2016-09-23-ccc_priority_script,2016/09/23,ccc_priority_script,15,14,0:00:05,5,0:00:10,1,70
2016-09-23-ccc_tax_script,2016/09/23,ccc_tax_script,12,11,0:00:37,37,0:02:43,1,407
2016-09-23-ccc_waste_recycling_script,2016/09/23,ccc_waste_recycling_script,0,0,0:00:00,0,0:00:00,0,0
2016-09-24-ccc_311_calgary_script,2016/09/24,ccc_311_calgary_script,1186,1154,0:00:13,13,0:06:58,32,15002
2016-09-24-ccc_311_lobby_ph_script,2016/09/24,ccc_311_lobby_ph_script,0,0,0:00:00,0,0:00:00,0,0
2016-09-24-ccc_aserv_info_script,2016/09/24,ccc_aserv_info_script,0,0,0:00:00,0,0:00:00,0,0
2016-09-24-ccc_bylaw_script,2016/09/24,ccc_bylaw_script,0,0,0:00:00,0,0:00:00,0,0
2016-09-24-ccc_city_script,2016/09/24,ccc_city_script,0,0,0:00:00,0,0:00:00,0,0
2016-09-24-ccc_cty_online_script,2016/09/24,ccc_cty_online_script,0,0,0:00:00,0,0:00:00,0,0
2016-09-24-ccc_feedback_script,2016/09/24,ccc_feedback_script,0,0,0:00:00,0,0:00:00,0,0
2016-09-24-ccc_fpb_script,2016/09/24,ccc_fpb_script,0,0,0:00:00,0,0:00:00,0,0
2016-09-24-ccc_help_script,2016/09/24,ccc_help_script,8,5,0:00:04,4,0:00:06,3,20
2016-09-24-ccc_link_script,2016/09/24,ccc_link_script,0,0,0:00:00,0,0:00:00,0,0
2016-09-24-ccc_media_line_script,2016/09/24,ccc_media_line_script,3,3,0:00:04,4,0:00:07,0,12
2016-09-24-ccc_priority_script,2016/09/24,ccc_priority_script,15,15,0:00:06,6,0:00:24,0,90
2016-09-24-ccc_tax_script,2016/09/24,ccc_tax_script,0,0,0:00:00,0,0:00:00,0,0
2016-09-24-ccc_waste_recycling_script,2016/09/24,ccc_waste_recycling_script,0,0,0:00:00,0,0:00:00,0,0
2016-09-25-ccc_311_calgary_script,2016/09/25,ccc_311_calgary_script,914,874,0:00:18,18,0:05:50,41,15732
2016-09-25-ccc_311_lobby_ph_script,2016/09/25,ccc_311_lobby_ph_script,0,0,0:00:00,0,0:00:00,0,0
2016-09-25-ccc_aserv_info_script,2016/09/25,ccc_aserv_info_script,0,0,0:00:00,0,0:00:00,0,0
2016-09-25-ccc_bylaw_script,2016/09/25,ccc_bylaw_script,0,0,0:00:00,0,0:00:00,0,0
2016-09-25-ccc_city_script,2016/09/25,ccc_city_script,0,0,0:00:00,0,0:00:00,0,0
2016-09-25-ccc_cty_online_script,2016/09/25,ccc_cty_online_script,0,0,0:00:00,0,0:00:00,0,0
2016-09-25-ccc_feedback_script,2016/09/25,ccc_feedback_script,0,0,0:00:00,0,0:00:00,0,0
2016-09-25-ccc_fpb_script,2016/09/25,ccc_fpb_script,0,0,0:00:00,0,0:00:00,0,0
2016-09-25-ccc_help_script,2016/09/25,ccc_help_script,5,5,0:00:31,31,0:02:10,0,155
2016-09-25-ccc_link_script,2016/09/25,ccc_link_script,0,0,0:00:00,0,0:00:00,0,0
2016-09-25-ccc_media_line_script,2016/09/25,ccc_media_line_script,0,0,0:00:00,0,0:00:00,0,0
2016-09-25-ccc_priority_script,2016/09/25,ccc_priority_script,18,17,0:00:12,12,0:01:41,1,204
2016-09-25-ccc_tax_script,2016/09/25,ccc_tax_script,0,0,0:00:00,0,0:00:00,0,0
2016-09-25-ccc_waste_recycling_script,2016/09/25,ccc_waste_recycling_script,0,0,0:00:00,0,0:00:00,0,0
2016-09-26-ccc_311_calgary_script,2016/09/26,ccc_311_calgary_script,3317,3216,0:00:18,18,0:04:07,101,57888
2016-09-26-ccc_311_lobby_ph_script,2016/09/26,ccc_311_lobby_ph_script,2,2,0:00:03,3,0:00:04,0,6
2016-09-26-ccc_aserv_info_script,2016/09/26,ccc_aserv_info_script,0,0,0:00:00,0,0:00:00,0,0
2016-09-26-ccc_bylaw_script,2016/09/26,ccc_bylaw_script,0,0,0:00:00,0,0:00:00,0,0
2016-09-26-ccc_city_script,2016/09/26,ccc_city_script,38,34,0:00:12,12,0:02:46,4,408
2016-09-26-ccc_cty_online_script,2016/09/26,ccc_cty_online_script,0,0,0:00:00,0,0:00:00,0,0
2016-09-26-ccc_feedback_script,2016/09/26,ccc_feedback_script,0,0,0:00:00,0,0:00:00,0,0
2016-09-26-ccc_fpb_script,2016/09/26,ccc_fpb_script,0,0,0:00:00,0,0:00:00,0,0
2016-09-26-ccc_help_script,2016/09/26,ccc_help_script,12,12,0:00:09,9,0:00:20,0,108
2016-09-26-ccc_link_script,2016/09/26,ccc_link_script,0,0,0:00:00,0,0:00:00,0,0
2016-09-26-ccc_media_line_script,2016/09/26,ccc_media_line_script,0,0,0:00:00,0,0:00:00,0,0
2016-09-26-ccc_priority_script,2016/09/26,ccc_priority_script,29,28,0:00:06,6,0:00:26,1,168
2016-09-26-ccc_tax_script,2016/09/26,ccc_tax_script,14,14,0:00:37,37,0:02:31,0,518
2016-09-26-ccc_waste_recycling_script,2016/09/26,ccc_waste_recycling_script,0,0,0:00:00,0,0:00:00,0,0
2016-09-27-ccc_311_calgary_script,2016/09/27,ccc_311_calgary_script,3218,3080,0:00:24,24,0:05:30,138,73920
2016-09-27-ccc_311_lobby_ph_script,2016/09/27,ccc_311_lobby_ph_script,1,1,0:00:12,12,0:00:12,0,12
2016-09-27-ccc_aserv_info_script,2016/09/27,ccc_aserv_info_script,0,0,0:00:00,0,0:00:00,0,0
2016-09-27-ccc_bylaw_script,2016/09/27,ccc_bylaw_script,0,0,0:00:00,0,0:00:00,0,0
2016-09-27-ccc_city_script,2016/09/27,ccc_city_script,25,25,0:00:08,8,0:00:19,0,200
2016-09-27-ccc_cty_online_script,2016/09/27,ccc_cty_online_script,0,0,0:00:00,0,0:00:00,0,0
2016-09-27-ccc_feedback_script,2016/09/27,ccc_feedback_script,0,0,0:00:00,0,0:00:00,0,0
2016-09-27-ccc_fpb_script,2016/09/27,ccc_fpb_script,0,0,0:00:00,0,0:00:00,0,0
2016-09-27-ccc_help_script,2016/09/27,ccc_help_script,28,27,0:00:10,10,0:01:10,1,270
2016-09-27-ccc_link_script,2016/09/27,ccc_link_script,0,0,0:00:00,0,0:00:00,0,0
2016-09-27-ccc_media_line_script,2016/09/27,ccc_media_line_script,0,0,0:00:00,0,0:00:00,0,0
2016-09-27-ccc_priority_script,2016/09/27,ccc_priority_script,29,29,0:00:09,9,0:00:18,0,261
2016-09-27-ccc_tax_script,2016/09/27,ccc_tax_script,19,18,0:00:25,25,0:02:09,1,450
2016-09-27-ccc_waste_recycling_script,2016/09/27,ccc_waste_recycling_script,0,0,0:00:00,0,0:00:00,0,0
2016-09-28-ccc_311_calgary_script,2016/09/28,ccc_311_calgary_script,3155,2893,0:01:09,69,0:09:35,262,199617
2016-09-28-ccc_311_lobby_ph_script,2016/09/28,ccc_311_lobby_ph_script,2,2,0:00:10,10,0:00:13,0,20
2016-09-28-ccc_aserv_info_script,2016/09/28,ccc_aserv_info_script,0,0,0:00:00,0,0:00:00,0,0
2016-09-28-ccc_bylaw_script,2016/09/28,ccc_bylaw_script,0,0,0:00:00,0,0:00:00,0,0
2016-09-28-ccc_city_script,2016/09/28,ccc_city_script,25,25,0:00:14,14,0:01:01,0,350
2016-09-28-ccc_cty_online_script,2016/09/28,ccc_cty_online_script,0,0,0:00:00,0,0:00:00,0,0
2016-09-28-ccc_feedback_script,2016/09/28,ccc_feedback_script,0,0,0:00:00,0,0:00:00,0,0
2016-09-28-ccc_fpb_script,2016/09/28,ccc_fpb_script,2,1,0:00:06,6,0:00:06,1,6
2016-09-28-ccc_help_script,2016/09/28,ccc_help_script,17,16,0:00:08,8,0:00:22,1,128
2016-09-28-ccc_link_script,2016/09/28,ccc_link_script,0,0,0:00:00,0,0:00:00,0,0
2016-09-28-ccc_media_line_script,2016/09/28,ccc_media_line_script,0,0,0:00:00,0,0:00:00,0,0
2016-09-28-ccc_priority_script,2016/09/28,ccc_priority_script,18,18,0:00:09,9,0:00:48,0,162
2016-09-28-ccc_tax_script,2016/09/28,ccc_tax_script,16,16,0:00:55,55,0:04:28,0,880
2016-09-28-ccc_waste_recycling_script,2016/09/28,ccc_waste_recycling_script,0,0,0:00:00,0,0:00:00,0,0
2016-09-29-ccc_311_calgary_script,2016/09/29,ccc_311_calgary_script,3206,2939,0:01:05,65,0:11:09,267,191035
2016-09-29-ccc_311_lobby_ph_script,2016/09/29,ccc_311_lobby_ph_script,3,2,0:00:13,13,0:00:18,1,26
2016-09-29-ccc_aserv_info_script,2016/09/29,ccc_aserv_info_script,0,0,0:00:00,0,0:00:00,0,0
2016-09-29-ccc_bylaw_script,2016/09/29,ccc_bylaw_script,0,0,0:00:00,0,0:00:00,0,0
2016-09-29-ccc_city_script,2016/09/29,ccc_city_script,34,32,0:00:28,28,0:03:55,2,896
2016-09-29-ccc_cty_online_script,2016/09/29,ccc_cty_online_script,0,0,0:00:00,0,0:00:00,0,0
2016-09-29-ccc_feedback_script,2016/09/29,ccc_feedback_script,0,0,0:00:00,0,0:00:00,0,0
2016-09-29-ccc_fpb_script,2016/09/29,ccc_fpb_script,1,1,0:00:03,3,0:00:03,0,3
2016-09-29-ccc_help_script,2016/09/29,ccc_help_script,30,29,0:00:10,10,0:00:44,1,290
2016-09-29-ccc_link_script,2016/09/29,ccc_link_script,0,0,0:00:00,0,0:00:00,0,0
2016-09-29-ccc_media_line_script,2016/09/29,ccc_media_line_script,1,0,0:00:00,0,0:00:00,1,0
2016-09-29-ccc_priority_script,2016/09/29,ccc_priority_script,36,35,0:00:15,15,0:01:19,1,525
2016-09-29-ccc_tax_script,2016/09/29,ccc_tax_script,19,19,0:00:47,47,0:03:50,0,893
2016-09-29-ccc_waste_recycling_script,2016/09/29,ccc_waste_recycling_script,0,0,0:00:00,0,0:00:00,0,0
2016-09-30-ccc_311_calgary_script,2016/09/30,ccc_311_calgary_script,3101,2902,0:00:44,44,0:06:07,199,127688
2016-09-30-ccc_311_lobby_ph_script,2016/09/30,ccc_311_lobby_ph_script,2,2,0:00:08,8,0:00:10,0,16
2016-09-30-ccc_aserv_info_script,2016/09/30,ccc_aserv_info_script,0,0,0:00:00,0,0:00:00,0,0
2016-09-30-ccc_bylaw_script,2016/09/30,ccc_bylaw_script,0,0,0:00:00,0,0:00:00,0,0
2016-09-30-ccc_city_script,2016/09/30,ccc_city_script,22,21,0:00:10,10,0:00:35,1,210
2016-09-30-ccc_cty_online_script,2016/09/30,ccc_cty_online_script,0,0,0:00:00,0,0:00:00,0,0
2016-09-30-ccc_feedback_script,2016/09/30,ccc_feedback_script,0,0,0:00:00,0,0:00:00,0,0
2016-09-30-ccc_fpb_script,2016/09/30,ccc_fpb_script,0,0,0:00:00,0,0:00:00,0,0
2016-09-30-ccc_help_script,2016/09/30,ccc_help_script,21,21,0:00:10,10,0:00:28,0,210
2016-09-30-ccc_link_script,2016/09/30,ccc_link_script,0,0,0:00:00,0,0:00:00,0,0
2016-09-30-ccc_media_line_script,2016/09/30,ccc_media_line_script,1,1,0:00:03,3,0:00:03,0,3
2016-09-30-ccc_priority_script,2016/09/30,ccc_priority_script,31,30,0:00:10,10,0:00:52,1,300
2016-09-30-ccc_tax_script,2016/09/30,ccc_tax_script,25,24,0:00:51,51,0:04:00,1,1224
2016-09-30-ccc_waste_recycling_script,2016/09/30,ccc_waste_recycling_script,0,0,0:00:00,0,0:00:00,0,0
2016-10-01-ccc_311_calgary_script,2016/10/01,ccc_311_calgary_script,1101,1062,0:00:23,23,0:07:57,39,24426
2016-10-01-ccc_311_lobby_ph_script,2016/10/01,ccc_311_lobby_ph_script,0,0,0:00:00,0,0:00:00,0,0
2016-10-01-ccc_aserv_info_script,2016/10/01,ccc_aserv_info_script,0,0,0:00:00,0,0:00:00,0,0
2016-10-01-ccc_bylaw_script,2016/10/01,ccc_bylaw_script,0,0,0:00:00,0,0:00:00,0,0
2016-10-01-ccc_city_script,2016/10/01,ccc_city_script,0,0,0:00:00,0,0:00:00,0,0
2016-10-01-ccc_cty_online_script,2016/10/01,ccc_cty_online_script,0,0,0:00:00,0,0:00:00,0,0
2016-10-01-ccc_feedback_script,2016/10/01,ccc_feedback_script,0,0,0:00:00,0,0:00:00,0,0
2016-10-01-ccc_fpb_script,2016/10/01,ccc_fpb_script,0,0,0:00:00,0,0:00:00,0,0
2016-10-01-ccc_help_script,2016/10/01,ccc_help_script,16,16,0:00:16,16,0:01:17,0,256
2016-10-01-ccc_link_script,2016/10/01,ccc_link_script,0,0,0:00:00,0,0:00:00,0,0
2016-10-01-ccc_media_line_script,2016/10/01,ccc_media_line_script,0,0,0:00:00,0,0:00:00,0,0
2016-10-01-ccc_priority_script,2016/10/01,ccc_priority_script,22,22,0:00:16,16,0:02:16,0,352
2016-10-01-ccc_tax_script,2016/10/01,ccc_tax_script,0,0,0:00:00,0,0:00:00,0,0
2016-10-01-ccc_waste_recycling_script,2016/10/01,ccc_waste_recycling_script,0,0,0:00:00,0,0:00:00,0,0
2016-10-02-ccc_311_calgary_script,2016/10/02,ccc_311_calgary_script,1227,1117,0:00:44,44,0:10:13,110,49148
2016-10-02-ccc_311_lobby_ph_script,2016/10/02,ccc_311_lobby_ph_script,0,0,0:00:00,0,0:00:00,0,0
2016-10-02-ccc_aserv_info_script,2016/10/02,ccc_aserv_info_script,0,0,0:00:00,0,0:00:00,0,0
2016-10-02-ccc_bylaw_script,2016/10/02,ccc_bylaw_script,0,0,0:00:00,0,0:00:00,0,0
2016-10-02-ccc_city_script,2016/10/02,ccc_city_script,0,0,0:00:00,0,0:00:00,0,0
2016-10-02-ccc_cty_online_script,2016/10/02,ccc_cty_online_script,0,0,0:00:00,0,0:00:00,0,0
2016-10-02-ccc_feedback_script,2016/10/02,ccc_feedback_script,0,0,0:00:00,0,0:00:00,0,0
2016-10-02-ccc_fpb_script,2016/10/02,ccc_fpb_script,0,0,0:00:00,0,0:00:00,0,0
2016-10-02-ccc_help_script,2016/10/02,ccc_help_script,13,12,0:00:13,13,0:00:55,1,156
2016-10-02-ccc_link_script,2016/10/02,ccc_link_script,0,0,0:00:00,0,0:00:00,0,0
2016-10-02-ccc_media_line_script,2016/10/02,ccc_media_line_script,0,0,0:00:00,0,0:00:00,0,0
2016-10-02-ccc_priority_script,2016/10/02,ccc_priority_script,26,26,0:00:09,9,0:01:28,0,234
2016-10-02-ccc_tax_script,2016/10/02,ccc_tax_script,0,0,0:00:00,0,0:00:00,0,0
2016-10-02-ccc_waste_recycling_script,2016/10/02,ccc_waste_recycling_script,0,0,0:00:00,0,0:00:00,0,0
2016-10-03-ccc_311_calgary_script,2016/10/03,ccc_311_calgary_script,3471,3357,0:00:30,30,0:04:38,114,100710
2016-10-03-ccc_311_lobby_ph_script,2016/10/03,ccc_311_lobby_ph_script,1,1,0:00:05,5,0:00:05,0,5
2016-10-03-ccc_aserv_info_script,2016/10/03,ccc_aserv_info_script,0,0,0:00:00,0,0:00:00,0,0
2016-10-03-ccc_bylaw_script,2016/10/03,ccc_bylaw_script,0,0,0:00:00,0,0:00:00,0,0
2016-10-03-ccc_city_script,2016/10/03,ccc_city_script,25,25,0:00:11,11,0:00:42,0,275
2016-10-03-ccc_cty_online_script,2016/10/03,ccc_cty_online_script,0,0,0:00:00,0,0:00:00,0,0
2016-10-03-ccc_feedback_script,2016/10/03,ccc_feedback_script,0,0,0:00:00,0,0:00:00,0,0
2016-10-03-ccc_fpb_script,2016/10/03,ccc_fpb_script,0,0,0:00:00,0,0:00:00,0,0
2016-10-03-ccc_help_script,2016/10/03,ccc_help_script,31,30,0:00:08,8,0:00:27,1,240
2016-10-03-ccc_link_script,2016/10/03,ccc_link_script,0,0,0:00:00,0,0:00:00,0,0
2016-10-03-ccc_media_line_script,2016/10/03,ccc_media_line_script,1,1,0:00:06,6,0:00:06,0,6
2016-10-03-ccc_priority_script,2016/10/03,ccc_priority_script,23,23,0:00:09,9,0:00:35,0,207
2016-10-03-ccc_tax_script,2016/10/03,ccc_tax_script,22,22,0:00:47,47,0:03:01,0,1034
2016-10-03-ccc_waste_recycling_script,2016/10/03,ccc_waste_recycling_script,0,0,0:00:00,0,0:00:00,0,0
2016-10-04-ccc_311_calgary_script,2016/10/04,ccc_311_calgary_script,3225,2960,0:01:09,69,0:09:10,265,204240
2016-10-04-ccc_311_lobby_ph_script,2016/10/04,ccc_311_lobby_ph_script,3,2,0:00:08,8,0:00:13,1,16
2016-10-04-ccc_aserv_info_script,2016/10/04,ccc_aserv_info_script,0,0,0:00:00,0,0:00:00,0,0
2016-10-04-ccc_bylaw_script,2016/10/04,ccc_bylaw_script,0,0,0:00:00,0,0:00:00,0,0
2016-10-04-ccc_city_script,2016/10/04,ccc_city_script,20,19,0:00:28,28,0:03:43,1,532
2016-10-04-ccc_cty_online_script,2016/10/04,ccc_cty_online_script,0,0,0:00:00,0,0:00:00,0,0
2016-10-04-ccc_feedback_script,2016/10/04,ccc_feedback_script,0,0,0:00:00,0,0:00:00,0,0
2016-10-04-ccc_fpb_script,2016/10/04,ccc_fpb_script,1,1,0:00:04,4,0:00:04,0,4
2016-10-04-ccc_help_script,2016/10/04,ccc_help_script,16,15,0:00:12,12,0:00:34,1,180
2016-10-04-ccc_link_script,2016/10/04,ccc_link_script,0,0,0:00:00,0,0:00:00,0,0
2016-10-04-ccc_media_line_script,2016/10/04,ccc_media_line_script,1,1,0:00:12,12,0:00:12,0,12
2016-10-04-ccc_priority_script,2016/10/04,ccc_priority_script,35,34,0:00:15,15,0:02:25,1,510
2016-10-04-ccc_tax_script,2016/10/04,ccc_tax_script,20,19,0:01:55,115,0:07:01,1,2185
2016-10-04-ccc_waste_recycling_script,2016/10/04,ccc_waste_recycling_script,0,0,0:00:00,0,0:00:00,0,0
2016-10-05-ccc_311_calgary_script,2016/10/05,ccc_311_calgary_script,2901,2858,0:00:13,13,0:07:43,43,37154
2016-10-05-ccc_311_lobby_ph_script,2016/10/05,ccc_311_lobby_ph_script,0,0,0:00:00,0,0:00:00,0,0
2016-10-05-ccc_aserv_info_script,2016/10/05,ccc_aserv_info_script,0,0,0:00:00,0,0:00:00,0,0
2016-10-05-ccc_bylaw_script,2016/10/05,ccc_bylaw_script,0,0,0:00:00,0,0:00:00,0,0
2016-10-05-ccc_city_script,2016/10/05,ccc_city_script,12,12,0:00:07,7,0:00:25,0,84
2016-10-05-ccc_cty_online_script,2016/10/05,ccc_cty_online_script,0,0,0:00:00,0,0:00:00,0,0
2016-10-05-ccc_feedback_script,2016/10/05,ccc_feedback_script,0,0,0:00:00,0,0:00:00,0,0
2016-10-05-ccc_fpb_script,2016/10/05,ccc_fpb_script,0,0,0:00:00,0,0:00:00,0,0
2016-10-05-ccc_help_script,2016/10/05,ccc_help_script,19,18,0:00:07,7,0:00:27,1,126
2016-10-05-ccc_link_script,2016/10/05,ccc_link_script,0,0,0:00:00,0,0:00:00,0,0
2016-10-05-ccc_media_line_script,2016/10/05,ccc_media_line_script,0,0,0:00:00,0,0:00:00,0,0
2016-10-05-ccc_priority_script,2016/10/05,ccc_priority_script,21,21,0:00:07,7,0:00:37,0,147
2016-10-05-ccc_tax_script,2016/10/05,ccc_tax_script,24,23,0:00:09,9,0:01:11,1,207
2016-10-05-ccc_waste_recycling_script,2016/10/05,ccc_waste_recycling_script,0,0,0:00:00,0,0:00:00,0,0
2016-10-06-ccc_311_calgary_script,2016/10/06,ccc_311_calgary_script,2794,2729,0:00:13,13,0:09:11,65,35477
2016-10-06-ccc_311_lobby_ph_script,2016/10/06,ccc_311_lobby_ph_script,4,4,0:00:06,6,0:00:12,0,24
2016-10-06-ccc_aserv_info_script,2016/10/06,ccc_aserv_info_script,0,0,0:00:00,0,0:00:00,0,0
2016-10-06-ccc_bylaw_script,2016/10/06,ccc_bylaw_script,0,0,0:00:00,0,0:00:00,0,0
2016-10-06-ccc_city_script,2016/10/06,ccc_city_script,25,22,0:00:08,8,0:01:01,3,176
2016-10-06-ccc_cty_online_script,2016/10/06,ccc_cty_online_script,0,0,0:00:00,0,0:00:00,0,0
2016-10-06-ccc_feedback_script,2016/10/06,ccc_feedback_script,0,0,0:00:00,0,0:00:00,0,0
2016-10-06-ccc_fpb_script,2016/10/06,ccc_fpb_script,1,1,0:00:01,1,0:00:01,0,1
2016-10-06-ccc_help_script,2016/10/06,ccc_help_script,9,9,0:00:06,6,0:00:14,0,54
2016-10-06-ccc_link_script,2016/10/06,ccc_link_script,0,0,0:00:00,0,0:00:00,0,0
2016-10-06-ccc_media_line_script,2016/10/06,ccc_media_line_script,2,2,0:00:03,3,0:00:03,0,6
2016-10-06-ccc_priority_script,2016/10/06,ccc_priority_script,32,32,0:00:07,7,0:01:18,0,224
2016-10-06-ccc_tax_script,2016/10/06,ccc_tax_script,24,24,0:00:06,6,0:00:19,0,144
2016-10-06-ccc_waste_recycling_script,2016/10/06,ccc_waste_recycling_script,0,0,0:00:00,0,0:00:00,0,0
2016-10-07-ccc_311_calgary_script,2016/10/07,ccc_311_calgary_script,2363,2328,0:00:08,8,0:03:53,35,18624
2016-10-07-ccc_311_lobby_ph_script,2016/10/07,ccc_311_lobby_ph_script,1,1,0:00:03,3,0:00:03,0,3
2016-10-07-ccc_aserv_info_script,2016/10/07,ccc_aserv_info_script,0,0,0:00:00,0,0:00:00,0,0
2016-10-07-ccc_bylaw_script,2016/10/07,ccc_bylaw_script,0,0,0:00:00,0,0:00:00,0,0
2016-10-07-ccc_city_script,2016/10/07,ccc_city_script,13,13,0:00:06,6,0:00:21,0,78
2016-10-07-ccc_cty_online_script,2016/10/07,ccc_cty_online_script,0,0,0:00:00,0,0:00:00,0,0
2016-10-07-ccc_feedback_script,2016/10/07,ccc_feedback_script,2,0,0:00:00,0,0:00:00,0,0
2016-10-07-ccc_fpb_script,2016/10/07,ccc_fpb_script,0,0,0:00:00,0,0:00:00,0,0
2016-10-07-ccc_help_script,2016/10/07,ccc_help_script,6,6,0:00:07,7,0:00:09,0,42
2016-10-07-ccc_link_script,2016/10/07,ccc_link_script,0,0,0:00:00,0,0:00:00,0,0
2016-10-07-ccc_media_line_script,2016/10/07,ccc_media_line_script,2,2,0:00:06,6,0:00:06,0,12
2016-10-07-ccc_priority_script,2016/10/07,ccc_priority_script,27,27,0:00:14,14,0:02:32,0,378
2016-10-07-ccc_tax_script,2016/10/07,ccc_tax_script,19,19,0:00:07,7,0:00:15,0,133
2016-10-07-ccc_waste_recycling_script,2016/10/07,ccc_waste_recycling_script,0,0,0:00:00,0,0:00:00,0,0
2016-10-08-ccc_311_calgary_script,2016/10/08,ccc_311_calgary_script,829,808,0:00:14,14,0:12:05,21,11312
2016-10-08-ccc_311_lobby_ph_script,2016/10/08,ccc_311_lobby_ph_script,0,0,0:00:00,0,0:00:00,0,0
2016-10-08-ccc_aserv_info_script,2016/10/08,ccc_aserv_info_script,0,0,0:00:00,0,0:00:00,0,0
2016-10-08-ccc_bylaw_script,2016/10/08,ccc_bylaw_script,0,0,0:00:00,0,0:00:00,0,0
2016-10-08-ccc_city_script,2016/10/08,ccc_city_script,0,0,0:00:00,0,0:00:00,0,0
2016-10-08-ccc_cty_online_script,2016/10/08,ccc_cty_online_script,0,0,0:00:00,0,0:00:00,0,0
2016-10-08-ccc_feedback_script,2016/10/08,ccc_feedback_script,0,0,0:00:00,0,0:00:00,0,0
2016-10-08-ccc_fpb_script,2016/10/08,ccc_fpb_script,0,0,0:00:00,0,0:00:00,0,0
2016-10-08-ccc_help_script,2016/10/08,ccc_help_script,6,6,0:00:07,7,0:00:12,0,42
2016-10-08-ccc_link_script,2016/10/08,ccc_link_script,0,0,0:00:00,0,0:00:00,0,0
2016-10-08-ccc_media_line_script,2016/10/08,ccc_media_line_script,2,2,0:00:04,4,0:00:06,0,8
2016-10-08-ccc_priority_script,2016/10/08,ccc_priority_script,31,31,0:00:09,9,0:00:58,0,279
2016-10-08-ccc_tax_script,2016/10/08,ccc_tax_script,0,0,0:00:00,0,0:00:00,0,0
2016-10-08-ccc_waste_recycling_script,2016/10/08,ccc_waste_recycling_script,0,0,0:00:00,0,0:00:00,0,0
2016-10-09-ccc_311_calgary_script,2016/10/09,ccc_311_calgary_script,661,648,0:00:09,9,0:03:42,13,5832
2016-10-09-ccc_311_lobby_ph_script,2016/10/09,ccc_311_lobby_ph_script,0,0,0:00:00,0,0:00:00,0,0
2016-10-09-ccc_aserv_info_script,2016/10/09,ccc_aserv_info_script,0,0,0:00:00,0,0:00:00,0,0
2016-10-09-ccc_bylaw_script,2016/10/09,ccc_bylaw_script,0,0,0:00:00,0,0:00:00,0,0
2016-10-09-ccc_city_script,2016/10/09,ccc_city_script,0,0,0:00:00,0,0:00:00,0,0
2016-10-09-ccc_cty_online_script,2016/10/09,ccc_cty_online_script,0,0,0:00:00,0,0:00:00,0,0
2016-10-09-ccc_feedback_script,2016/10/09,ccc_feedback_script,0,0,0:00:00,0,0:00:00,0,0
2016-10-09-ccc_fpb_script,2016/10/09,ccc_fpb_script,0,0,0:00:00,0,0:00:00,0,0
2016-10-09-ccc_help_script,2016/10/09,ccc_help_script,6,6,0:00:05,5,0:00:13,0,30
2016-10-09-ccc_link_script,2016/10/09,ccc_link_script,0,0,0:00:00,0,0:00:00,0,0
2016-10-09-ccc_media_line_script,2016/10/09,ccc_media_line_script,2,2,0:00:08,8,0:00:08,0,16
2016-10-09-ccc_priority_script,2016/10/09,ccc_priority_script,18,17,0:00:11,11,0:01:24,1,187
2016-10-09-ccc_tax_script,2016/10/09,ccc_tax_script,0,0,0:00:00,0,0:00:00,0,0
2016-10-09-ccc_waste_recycling_script,2016/10/09,ccc_waste_recycling_script,0,0,0:00:00,0,0:00:00,0,0
2016-10-10-ccc_311_calgary_script,2016/10/10,ccc_311_calgary_script,798,785,0:00:07,7,0:02:05,13,5495
2016-10-10-ccc_311_lobby_ph_script,2016/10/10,ccc_311_lobby_ph_script,0,0,0:00:00,0,0:00:00,0,0
2016-10-10-ccc_aserv_info_script,2016/10/10,ccc_aserv_info_script,0,0,0:00:00,0,0:00:00,0,0
2016-10-10-ccc_bylaw_script,2016/10/10,ccc_bylaw_script,0,0,0:00:00,0,0:00:00,0,0
2016-10-10-ccc_city_script,2016/10/10,ccc_city_script,0,0,0:00:00,0,0:00:00,0,0
2016-10-10-ccc_cty_online_script,2016/10/10,ccc_cty_online_script,0,0,0:00:00,0,0:00:00,0,0
2016-10-10-ccc_feedback_script,2016/10/10,ccc_feedback_script,0,0,0:00:00,0,0:00:00,0,0
2016-10-10-ccc_fpb_script,2016/10/10,ccc_fpb_script,0,0,0:00:00,0,0:00:00,0,0
2016-10-10-ccc_help_script,2016/10/10,ccc_help_script,7,7,0:00:06,6,0:00:14,0,42
2016-10-10-ccc_link_script,2016/10/10,ccc_link_script,0,0,0:00:00,0,0:00:00,0,0
2016-10-10-ccc_media_line_script,2016/10/10,ccc_media_line_script,2,2,0:00:05,5,0:00:05,0,10
2016-10-10-ccc_priority_script,2016/10/10,ccc_priority_script,13,13,0:00:05,5,0:00:09,0,65
2016-10-10-ccc_tax_script,2016/10/10,ccc_tax_script,0,0,0:00:00,0,0:00:00,0,0
2016-10-10-ccc_waste_recycling_script,2016/10/10,ccc_waste_recycling_script,0,0,0:00:00,0,0:00:00,0,0
2016-10-11-ccc_311_calgary_script,2016/10/11,ccc_311_calgary_script,2913,2880,0:00:09,9,0:04:16,33,25920
2016-10-11-ccc_311_lobby_ph_script,2016/10/11,ccc_311_lobby_ph_script,6,6,0:00:05,5,0:00:08,0,30
2016-10-11-ccc_aserv_info_script,2016/10/11,ccc_aserv_info_script,0,0,0:00:00,0,0:00:00,0,0
2016-10-11-ccc_bylaw_script,2016/10/11,ccc_bylaw_script,0,0,0:00:00,0,0:00:00,0,0
2016-10-11-ccc_city_script,2016/10/11,ccc_city_script,36,34,0:00:07,7,0:00:20,2,238
2016-10-11-ccc_cty_online_script,2016/10/11,ccc_cty_online_script,0,0,0:00:00,0,0:00:00,0,0
2016-10-11-ccc_feedback_script,2016/10/11,ccc_feedback_script,1,0,0:00:00,0,0:00:00,0,0
2016-10-11-ccc_fpb_script,2016/10/11,ccc_fpb_script,1,1,0:00:04,4,0:00:04,0,4
2016-10-11-ccc_help_script,2016/10/11,ccc_help_script,22,22,0:00:10,10,0:01:19,0,220
2016-10-11-ccc_link_script,2016/10/11,ccc_link_script,0,0,0:00:00,0,0:00:00,0,0
2016-10-11-ccc_media_line_script,2016/10/11,ccc_media_line_script,0,0,0:00:00,0,0:00:00,0,0
2016-10-11-ccc_priority_script,2016/10/11,ccc_priority_script,27,27,0:00:07,7,0:00:33,0,189
2016-10-11-ccc_tax_script,2016/10/11,ccc_tax_script,16,16,0:00:07,7,0:00:33,0,112
2016-10-11-ccc_waste_recycling_script,2016/10/11,ccc_waste_recycling_script,0,0,0:00:00,0,0:00:00,0,0
2016-10-12-ccc_311_calgary_script,2016/10/12,ccc_311_calgary_script,2855,2747,0:00:33,33,0:11:46,108,90651
2016-10-12-ccc_311_lobby_ph_script,2016/10/12,ccc_311_lobby_ph_script,2,2,0:00:10,10,0:00:15,0,20
2016-10-12-ccc_aserv_info_script,2016/10/12,ccc_aserv_info_script,0,0,0:00:00,0,0:00:00,0,0
2016-10-12-ccc_bylaw_script,2016/10/12,ccc_bylaw_script,0,0,0:00:00,0,0:00:00,0,0
2016-10-12-ccc_city_script,2016/10/12,ccc_city_script,32,30,0:00:10,10,0:01:16,2,300
2016-10-12-ccc_cty_online_script,2016/10/12,ccc_cty_online_script,0,0,0:00:00,0,0:00:00,0,0
2016-10-12-ccc_feedback_script,2016/10/12,ccc_feedback_script,0,0,0:00:00,0,0:00:00,0,0
2016-10-12-ccc_fpb_script,2016/10/12,ccc_fpb_script,1,1,0:00:05,5,0:00:05,0,5
2016-10-12-ccc_help_script,2016/10/12,ccc_help_script,23,22,0:00:09,9,0:01:04,1,198
2016-10-12-ccc_link_script,2016/10/12,ccc_link_script,0,0,0:00:00,0,0:00:00,0,0
2016-10-12-ccc_media_line_script,2016/10/12,ccc_media_line_script,0,0,0:00:00,0,0:00:00,0,0
2016-10-12-ccc_priority_script,2016/10/12,ccc_priority_script,22,21,0:00:05,5,0:00:17,1,105
2016-10-12-ccc_tax_script,2016/10/12,ccc_tax_script,14,14,0:00:22,22,0:02:13,0,308
2016-10-12-ccc_waste_recycling_script,2016/10/12,ccc_waste_recycling_script,0,0,0:00:00,0,0:00:00,0,0
2016-10-13-ccc_311_calgary_script,2016/10/13,ccc_311_calgary_script,2827,2596,0:01:05,65,0:10:53,231,168740
2016-10-13-ccc_311_lobby_ph_script,2016/10/13,ccc_311_lobby_ph_script,4,4,0:00:11,11,0:00:15,0,44
2016-10-13-ccc_aserv_info_script,2016/10/13,ccc_aserv_info_script,0,0,0:00:00,0,0:00:00,0,0
2016-10-13-ccc_bylaw_script,2016/10/13,ccc_bylaw_script,0,0,0:00:00,0,0:00:00,0,0
2016-10-13-ccc_city_script,2016/10/13,ccc_city_script,12,12,0:00:50,50,0:04:13,0,600
2016-10-13-ccc_cty_online_script,2016/10/13,ccc_cty_online_script,0,0,0:00:00,0,0:00:00,0,0
2016-10-13-ccc_feedback_script,2016/10/13,ccc_feedback_script,0,0,0:00:00,0,0:00:00,0,0
2016-10-13-ccc_fpb_script,2016/10/13,ccc_fpb_script,1,1,0:02:41,161,0:02:41,0,161
2016-10-13-ccc_help_script,2016/10/13,ccc_help_script,16,16,0:00:14,14,0:01:13,0,224
2016-10-13-ccc_link_script,2016/10/13,ccc_link_script,0,0,0:00:00,0,0:00:00,0,0
2016-10-13-ccc_media_line_script,2016/10/13,ccc_media_line_script,2,1,0:00:22,22,0:00:22,1,22
2016-10-13-ccc_priority_script,2016/10/13,ccc_priority_script,25,24,0:00:10,10,0:01:23,1,240
2016-10-13-ccc_tax_script,2016/10/13,ccc_tax_script,23,21,0:00:25,25,0:02:35,2,525
2016-10-13-ccc_waste_recycling_script,2016/10/13,ccc_waste_recycling_script,1,1,0:00:05,5,0:00:05,0,5
2016-10-14-ccc_311_calgary_script,2016/10/14,ccc_311_calgary_script,2656,2521,0:00:41,41,0:10:34,135,103361
2016-10-14-ccc_311_lobby_ph_script,2016/10/14,ccc_311_lobby_ph_script,0,0,0:00:00,0,0:00:00,0,0
2016-10-14-ccc_aserv_info_script,2016/10/14,ccc_aserv_info_script,0,0,0:00:00,0,0:00:00,0,0
2016-10-14-ccc_bylaw_script,2016/10/14,ccc_bylaw_script,0,0,0:00:00,0,0:00:00,0,0
2016-10-14-ccc_city_script,2016/10/14,ccc_city_script,31,31,0:00:07,7,0:00:21,0,217
2016-10-14-ccc_cty_online_script,2016/10/14,ccc_cty_online_script,0,0,0:00:00,0,0:00:00,0,0
2016-10-14-ccc_feedback_script,2016/10/14,ccc_feedback_script,0,0,0:00:00,0,0:00:00,0,0
2016-10-14-ccc_fpb_script,2016/10/14,ccc_fpb_script,1,1,0:00:04,4,0:00:04,0,4
2016-10-14-ccc_help_script,2016/10/14,ccc_help_script,26,25,0:00:09,9,0:00:30,1,225
2016-10-14-ccc_link_script,2016/10/14,ccc_link_script,0,0,0:00:00,0,0:00:00,0,0
2016-10-14-ccc_media_line_script,2016/10/14,ccc_media_line_script,1,1,0:00:05,5,0:00:05,0,5
2016-10-14-ccc_priority_script,2016/10/14,ccc_priority_script,16,16,0:00:16,16,0:02:25,0,256
2016-10-14-ccc_tax_script,2016/10/14,ccc_tax_script,11,11,0:00:27,27,0:02:31,0,297
2016-10-14-ccc_waste_recycling_script,2016/10/14,ccc_waste_recycling_script,0,0,0:00:00,0,0:00:00,0,0
2016-10-15-ccc_311_calgary_script,2016/10/15,ccc_311_calgary_script,1034,996,0:00:26,26,0:05:13,38,25896
2016-10-15-ccc_311_lobby_ph_script,2016/10/15,ccc_311_lobby_ph_script,0,0,0:00:00,0,0:00:00,0,0
2016-10-15-ccc_aserv_info_script,2016/10/15,ccc_aserv_info_script,0,0,0:00:00,0,0:00:00,0,0
2016-10-15-ccc_bylaw_script,2016/10/15,ccc_bylaw_script,0,0,0:00:00,0,0:00:00,0,0
2016-10-15-ccc_city_script,2016/10/15,ccc_city_script,0,0,0:00:00,0,0:00:00,0,0
2016-10-15-ccc_cty_online_script,2016/10/15,ccc_cty_online_script,0,0,0:00:00,0,0:00:00,0,0
2016-10-15-ccc_feedback_script,2016/10/15,ccc_feedback_script,0,0,0:00:00,0,0:00:00,0,0
2016-10-15-ccc_fpb_script,2016/10/15,ccc_fpb_script,0,0,0:00:00,0,0:00:00,0,0
2016-10-15-ccc_help_script,2016/10/15,ccc_help_script,6,5,0:00:10,10,0:00:22,1,50
2016-10-15-ccc_link_script,2016/10/15,ccc_link_script,0,0,0:00:00,0,0:00:00,0,0
2016-10-15-ccc_media_line_script,2016/10/15,ccc_media_line_script,2,2,0:00:42,42,0:01:16,0,84
2016-10-15-ccc_priority_script,2016/10/15,ccc_priority_script,24,24,0:00:08,8,0:00:33,0,192
2016-10-15-ccc_tax_script,2016/10/15,ccc_tax_script,5,5,0:00:23,23,0:01:22,0,115
2016-10-15-ccc_waste_recycling_script,2016/10/15,ccc_waste_recycling_script,0,0,0:00:00,0,0:00:00,0,0
2016-10-16-ccc_311_calgary_script,2016/10/16,ccc_311_calgary_script,831,823,0:00:10,10,0:03:29,8,8230
2016-10-16-ccc_311_lobby_ph_script,2016/10/16,ccc_311_lobby_ph_script,0,0,0:00:00,0,0:00:00,0,0
2016-10-16-ccc_aserv_info_script,2016/10/16,ccc_aserv_info_script,0,0,0:00:00,0,0:00:00,0,0
2016-10-16-ccc_bylaw_script,2016/10/16,ccc_bylaw_script,0,0,0:00:00,0,0:00:00,0,0
2016-10-16-ccc_city_script,2016/10/16,ccc_city_script,0,0,0:00:00,0,0:00:00,0,0
2016-10-16-ccc_cty_online_script,2016/10/16,ccc_cty_online_script,0,0,0:00:00,0,0:00:00,0,0
2016-10-16-ccc_feedback_script,2016/10/16,ccc_feedback_script,0,0,0:00:00,0,0:00:00,0,0
2016-10-16-ccc_fpb_script,2016/10/16,ccc_fpb_script,0,0,0:00:00,0,0:00:00,0,0
2016-10-16-ccc_help_script,2016/10/16,ccc_help_script,1,1,0:00:09,9,0:00:09,0,9
2016-10-16-ccc_link_script,2016/10/16,ccc_link_script,0,0,0:00:00,0,0:00:00,0,0
2016-10-16-ccc_media_line_script,2016/10/16,ccc_media_line_script,1,1,0:00:02,2,0:00:02,0,2
2016-10-16-ccc_priority_script,2016/10/16,ccc_priority_script,13,13,0:00:08,8,0:00:18,0,104
2016-10-16-ccc_tax_script,2016/10/16,ccc_tax_script,0,0,0:00:00,0,0:00:00,0,0
2016-10-16-ccc_waste_recycling_script,2016/10/16,ccc_waste_recycling_script,0,0,0:00:00,0,0:00:00,0,0
2016-10-17-ccc_311_calgary_script,2016/10/17,ccc_311_calgary_script,2955,2886,0:00:23,23,0:03:14,68,66378
2016-10-17-ccc_311_lobby_ph_script,2016/10/17,ccc_311_lobby_ph_script,0,0,0:00:00,0,0:00:00,0,0
2016-10-17-ccc_aserv_info_script,2016/10/17,ccc_aserv_info_script,0,0,0:00:00,0,0:00:00,0,0
2016-10-17-ccc_bylaw_script,2016/10/17,ccc_bylaw_script,0,0,0:00:00,0,0:00:00,0,0
2016-10-17-ccc_city_script,2016/10/17,ccc_city_script,31,31,0:00:10,10,0:00:50,0,310
2016-10-17-ccc_cty_online_script,2016/10/17,ccc_cty_online_script,0,0,0:00:00,0,0:00:00,0,0
2016-10-17-ccc_feedback_script,2016/10/17,ccc_feedback_script,0,0,0:00:00,0,0:00:00,0,0
2016-10-17-ccc_fpb_script,2016/10/17,ccc_fpb_script,0,0,0:00:00,0,0:00:00,0,0
2016-10-17-ccc_help_script,2016/10/17,ccc_help_script,6,6,0:00:05,5,0:00:09,0,30
2016-10-17-ccc_link_script,2016/10/17,ccc_link_script,0,0,0:00:00,0,0:00:00,0,0
2016-10-17-ccc_media_line_script,2016/10/17,ccc_media_line_script,1,1,0:00:02,2,0:00:02,0,2
2016-10-17-ccc_priority_script,2016/10/17,ccc_priority_script,24,24,0:00:07,7,0:00:17,0,168
2016-10-17-ccc_tax_script,2016/10/17,ccc_tax_script,14,14,0:00:18,18,0:02:11,0,252
2016-10-17-ccc_waste_recycling_script,2016/10/17,ccc_waste_recycling_script,0,0,0:00:00,0,0:00:00,0,0
2016-10-18-ccc_311_calgary_script,2016/10/18,ccc_311_calgary_script,2798,2580,0:01:10,70,0:06:52,219,180600
2016-10-18-ccc_311_lobby_ph_script,2016/10/18,ccc_311_lobby_ph_script,1,1,0:00:19,19,0:00:19,0,19
2016-10-18-ccc_aserv_info_script,2016/10/18,ccc_aserv_info_script,0,0,0:00:00,0,0:00:00,0,0
2016-10-18-ccc_bylaw_script,2016/10/18,ccc_bylaw_script,0,0,0:00:00,0,0:00:00,0,0
2016-10-18-ccc_city_script,2016/10/18,ccc_city_script,12,9,0:00:57,57,0:04:09,3,513
2016-10-18-ccc_cty_online_script,2016/10/18,ccc_cty_online_script,0,0,0:00:00,0,0:00:00,0,0
2016-10-18-ccc_feedback_script,2016/10/18,ccc_feedback_script,0,0,0:00:00,0,0:00:00,0,0
2016-10-18-ccc_fpb_script,2016/10/18,ccc_fpb_script,1,0,0:00:00,0,0:00:00,1,0
2016-10-18-ccc_help_script,2016/10/18,ccc_help_script,10,9,0:00:06,6,0:00:13,1,54
2016-10-18-ccc_link_script,2016/10/18,ccc_link_script,1,0,0:00:00,0,0:00:00,0,0
2016-10-18-ccc_media_line_script,2016/10/18,ccc_media_line_script,0,0,0:00:00,0,0:00:00,0,0
2016-10-18-ccc_priority_script,2016/10/18,ccc_priority_script,21,21,0:00:12,12,0:01:45,0,252
2016-10-18-ccc_tax_script,2016/10/18,ccc_tax_script,13,12,0:00:52,52,0:03:10,1,624
2016-10-18-ccc_waste_recycling_script,2016/10/18,ccc_waste_recycling_script,0,0,0:00:00,0,0:00:00,0,0
2016-10-19-ccc_311_calgary_script,2016/10/19,ccc_311_calgary_script,2741,2587,0:00:44,44,0:05:21,154,113828
2016-10-19-ccc_311_lobby_ph_script,2016/10/19,ccc_311_lobby_ph_script,1,1,0:00:05,5,0:00:05,0,5
2016-10-19-ccc_aserv_info_script,2016/10/19,ccc_aserv_info_script,0,0,0:00:00,0,0:00:00,0,0
2016-10-19-ccc_bylaw_script,2016/10/19,ccc_bylaw_script,0,0,0:00:00,0,0:00:00,0,0
2016-10-19-ccc_city_script,2016/10/19,ccc_city_script,14,13,0:00:08,8,0:00:48,1,104
2016-10-19-ccc_cty_online_script,2016/10/19,ccc_cty_online_script,0,0,0:00:00,0,0:00:00,0,0
2016-10-19-ccc_feedback_script,2016/10/19,ccc_feedback_script,0,0,0:00:00,0,0:00:00,0,0
2016-10-19-ccc_fpb_script,2016/10/19,ccc_fpb_script,0,0,0:00:00,0,0:00:00,0,0
2016-10-19-ccc_help_script,2016/10/19,ccc_help_script,14,14,0:00:05,5,0:00:12,0,70
2016-10-19-ccc_link_script,2016/10/19,ccc_link_script,0,0,0:00:00,0,0:00:00,0,0
2016-10-19-ccc_media_line_script,2016/10/19,ccc_media_line_script,0,0,0:00:00,0,0:00:00,0,0
2016-10-19-ccc_priority_script,2016/10/19,ccc_priority_script,27,26,0:00:07,7,0:00:36,1,182
2016-10-19-ccc_tax_script,2016/10/19,ccc_tax_script,15,15,0:01:07,67,0:03:23,0,1005
2016-10-19-ccc_waste_recycling_script,2016/10/19,ccc_waste_recycling_script,0,0,0:00:00,0,0:00:00,0,0
2016-10-20-ccc_311_calgary_script,2016/10/20,ccc_311_calgary_script,2825,2647,0:00:51,51,0:05:47,178,134997
2016-10-20-ccc_311_lobby_ph_script,2016/10/20,ccc_311_lobby_ph_script,3,2,0:00:08,8,0:00:12,1,16
2016-10-20-ccc_aserv_info_script,2016/10/20,ccc_aserv_info_script,0,0,0:00:00,0,0:00:00,0,0
2016-10-20-ccc_bylaw_script,2016/10/20,ccc_bylaw_script,0,0,0:00:00,0,0:00:00,0,0
2016-10-20-ccc_city_script,2016/10/20,ccc_city_script,10,10,0:00:07,7,0:00:18,0,70
2016-10-20-ccc_cty_online_script,2016/10/20,ccc_cty_online_script,0,0,0:00:00,0,0:00:00,0,0
2016-10-20-ccc_feedback_script,2016/10/20,ccc_feedback_script,1,0,0:00:00,0,0:00:00,0,0
2016-10-20-ccc_fpb_script,2016/10/20,ccc_fpb_script,0,0,0:00:00,0,0:00:00,0,0
2016-10-20-ccc_help_script,2016/10/20,ccc_help_script,10,7,0:00:07,7,0:00:18,3,49
2016-10-20-ccc_link_script,2016/10/20,ccc_link_script,0,0,0:00:00,0,0:00:00,0,0
2016-10-20-ccc_media_line_script,2016/10/20,ccc_media_line_script,0,0,0:00:00,0,0:00:00,0,0
2016-10-20-ccc_priority_script,2016/10/20,ccc_priority_script,25,25,0:00:07,7,0:00:30,0,175
2016-10-20-ccc_tax_script,2016/10/20,ccc_tax_script,26,25,0:01:24,84,0:05:00,1,2100
2016-10-20-ccc_waste_recycling_script,2016/10/20,ccc_waste_recycling_script,0,0,0:00:00,0,0:00:00,0,0
2016-10-21-ccc_311_calgary_script,2016/10/21,ccc_311_calgary_script,2730,2475,0:01:25,85,0:09:40,255,210375
2016-10-21-ccc_311_lobby_ph_script,2016/10/21,ccc_311_lobby_ph_script,0,0,0:00:00,0,0:00:00,0,0
2016-10-21-ccc_aserv_info_script,2016/10/21,ccc_aserv_info_script,0,0,0:00:00,0,0:00:00,0,0
2016-10-21-ccc_bylaw_script,2016/10/21,ccc_bylaw_script,0,0,0:00:00,0,0:00:00,0,0
2016-10-21-ccc_city_script,2016/10/21,ccc_city_script,19,18,0:00:28,28,0:04:21,1,504
2016-10-21-ccc_cty_online_script,2016/10/21,ccc_cty_online_script,0,0,0:00:00,0,0:00:00,0,0
2016-10-21-ccc_feedback_script,2016/10/21,ccc_feedback_script,0,0,0:00:00,0,0:00:00,0,0
2016-10-21-ccc_fpb_script,2016/10/21,ccc_fpb_script,1,1,0:00:05,5,0:00:05,0,5
2016-10-21-ccc_help_script,2016/10/21,ccc_help_script,11,10,0:00:10,10,0:00:40,1,100
2016-10-21-ccc_link_script,2016/10/21,ccc_link_script,0,0,0:00:00,0,0:00:00,0,0
2016-10-21-ccc_media_line_script,2016/10/21,ccc_media_line_script,2,2,0:00:07,7,0:00:07,0,14
2016-10-21-ccc_priority_script,2016/10/21,ccc_priority_script,21,19,0:00:07,7,0:00:24,1,133
2016-10-21-ccc_tax_script,2016/10/21,ccc_tax_script,17,16,0:01:49,109,0:05:04,1,1744
2016-10-21-ccc_waste_recycling_script,2016/10/21,ccc_waste_recycling_script,0,0,0:00:00,0,0:00:00,0,0
2016-10-22-ccc_311_calgary_script,2016/10/22,ccc_311_calgary_script,1154,1117,0:00:22,22,0:06:01,37,24574
2016-10-22-ccc_311_lobby_ph_script,2016/10/22,ccc_311_lobby_ph_script,0,0,0:00:00,0,0:00:00,0,0
2016-10-22-ccc_aserv_info_script,2016/10/22,ccc_aserv_info_script,0,0,0:00:00,0,0:00:00,0,0
2016-10-22-ccc_bylaw_script,2016/10/22,ccc_bylaw_script,0,0,0:00:00,0,0:00:00,0,0
2016-10-22-ccc_city_script,2016/10/22,ccc_city_script,0,0,0:00:00,0,0:00:00,0,0
2016-10-22-ccc_cty_online_script,2016/10/22,ccc_cty_online_script,0,0,0:00:00,0,0:00:00,0,0
2016-10-22-ccc_feedback_script,2016/10/22,ccc_feedback_script,0,0,0:00:00,0,0:00:00,0,0
2016-10-22-ccc_fpb_script,2016/10/22,ccc_fpb_script,0,0,0:00:00,0,0:00:00,0,0
2016-10-22-ccc_help_script,2016/10/22,ccc_help_script,6,6,0:00:12,12,0:00:33,0,72
2016-10-22-ccc_link_script,2016/10/22,ccc_link_script,0,0,0:00:00,0,0:00:00,0,0
2016-10-22-ccc_media_line_script,2016/10/22,ccc_media_line_script,2,2,0:00:09,9,0:00:13,0,18
2016-10-22-ccc_priority_script,2016/10/22,ccc_priority_script,15,15,0:00:08,8,0:00:24,0,120
2016-10-22-ccc_tax_script,2016/10/22,ccc_tax_script,1,1,0:00:03,3,0:00:03,0,3
2016-10-22-ccc_waste_recycling_script,2016/10/22,ccc_waste_recycling_script,0,0,0:00:00,0,0:00:00,0,0
2016-10-23-ccc_311_calgary_script,2016/10/23,ccc_311_calgary_script,855,836,0:00:16,16,0:06:38,19,13376
2016-10-23-ccc_311_lobby_ph_script,2016/10/23,ccc_311_lobby_ph_script,0,0,0:00:00,0,0:00:00,0,0
2016-10-23-ccc_aserv_info_script,2016/10/23,ccc_aserv_info_script,0,0,0:00:00,0,0:00:00,0,0
2016-10-23-ccc_bylaw_script,2016/10/23,ccc_bylaw_script,0,0,0:00:00,0,0:00:00,0,0
2016-10-23-ccc_city_script,2016/10/23,ccc_city_script,0,0,0:00:00,0,0:00:00,0,0
2016-10-23-ccc_cty_online_script,2016/10/23,ccc_cty_online_script,0,0,0:00:00,0,0:00:00,0,0
2016-10-23-ccc_feedback_script,2016/10/23,ccc_feedback_script,0,0,0:00:00,0,0:00:00,0,0
2016-10-23-ccc_fpb_script,2016/10/23,ccc_fpb_script,0,0,0:00:00,0,0:00:00,0,0
2016-10-23-ccc_help_script,2016/10/23,ccc_help_script,2,2,0:00:06,6,0:00:08,0,12
2016-10-23-ccc_link_script,2016/10/23,ccc_link_script,0,0,0:00:00,0,0:00:00,0,0
2016-10-23-ccc_media_line_script,2016/10/23,ccc_media_line_script,0,0,0:00:00,0,0:00:00,0,0
2016-10-23-ccc_priority_script,2016/10/23,ccc_priority_script,25,25,0:00:07,7,0:00:30,0,175
2016-10-23-ccc_tax_script,2016/10/23,ccc_tax_script,0,0,0:00:00,0,0:00:00,0,0
2016-10-23-ccc_waste_recycling_script,2016/10/23,ccc_waste_recycling_script,0,0,0:00:00,0,0:00:00,0,0
2016-10-24-ccc_311_calgary_script,2016/10/24,ccc_311_calgary_script,3135,2803,0:01:44,104,0:09:30,332,291512
2016-10-24-ccc_311_lobby_ph_script,2016/10/24,ccc_311_lobby_ph_script,2,2,0:00:23,23,0:00:23,0,46
2016-10-24-ccc_aserv_info_script,2016/10/24,ccc_aserv_info_script,0,0,0:00:00,0,0:00:00,0,0
2016-10-24-ccc_bylaw_script,2016/10/24,ccc_bylaw_script,0,0,0:00:00,0,0:00:00,0,0
2016-10-24-ccc_city_script,2016/10/24,ccc_city_script,30,30,0:00:43,43,0:06:07,0,1290
2016-10-24-ccc_cty_online_script,2016/10/24,ccc_cty_online_script,0,0,0:00:00,0,0:00:00,0,0
2016-10-24-ccc_feedback_script,2016/10/24,ccc_feedback_script,0,0,0:00:00,0,0:00:00,0,0
2016-10-24-ccc_fpb_script,2016/10/24,ccc_fpb_script,0,0,0:00:00,0,0:00:00,0,0
2016-10-24-ccc_help_script,2016/10/24,ccc_help_script,11,11,0:00:09,9,0:00:54,0,99
2016-10-24-ccc_link_script,2016/10/24,ccc_link_script,0,0,0:00:00,0,0:00:00,0,0
2016-10-24-ccc_media_line_script,2016/10/24,ccc_media_line_script,0,0,0:00:00,0,0:00:00,0,0
2016-10-24-ccc_priority_script,2016/10/24,ccc_priority_script,28,25,0:00:10,10,0:00:54,3,250
2016-10-24-ccc_tax_script,2016/10/24,ccc_tax_script,22,21,0:02:56,176,0:07:05,1,3696
2016-10-24-ccc_waste_recycling_script,2016/10/24,ccc_waste_recycling_script,0,0,0:00:00,0,0:00:00,0,0
2016-10-25-ccc_311_calgary_script,2016/10/25,ccc_311_calgary_script,2882,2612,0:01:20,80,0:11:13,270,208960
2016-10-25-ccc_311_lobby_ph_script,2016/10/25,ccc_311_lobby_ph_script,2,2,0:00:05,5,0:00:05,0,10
2016-10-25-ccc_aserv_info_script,2016/10/25,ccc_aserv_info_script,0,0,0:00:00,0,0:00:00,0,0
2016-10-25-ccc_bylaw_script,2016/10/25,ccc_bylaw_script,0,0,0:00:00,0,0:00:00,0,0
2016-10-25-ccc_city_script,2016/10/25,ccc_city_script,18,16,0:00:55,55,0:03:53,2,880
2016-10-25-ccc_cty_online_script,2016/10/25,ccc_cty_online_script,0,0,0:00:00,0,0:00:00,0,0
2016-10-25-ccc_feedback_script,2016/10/25,ccc_feedback_script,0,0,0:00:00,0,0:00:00,0,0
2016-10-25-ccc_fpb_script,2016/10/25,ccc_fpb_script,1,1,0:00:04,4,0:00:04,0,4
2016-10-25-ccc_help_script,2016/10/25,ccc_help_script,10,9,0:00:11,11,0:00:24,1,99
2016-10-25-ccc_link_script,2016/10/25,ccc_link_script,0,0,0:00:00,0,0:00:00,0,0
2016-10-25-ccc_media_line_script,2016/10/25,ccc_media_line_script,0,0,0:00:00,0,0:00:00,0,0
2016-10-25-ccc_priority_script,2016/10/25,ccc_priority_script,25,25,0:00:09,9,0:00:42,0,225
2016-10-25-ccc_tax_script,2016/10/25,ccc_tax_script,15,15,0:01:31,91,0:04:48,0,1365
2016-10-25-ccc_waste_recycling_script,2016/10/25,ccc_waste_recycling_script,0,0,0:00:00,0,0:00:00,0,0
2016-10-26-ccc_311_calgary_script,2016/10/26,ccc_311_calgary_script,2685,2548,0:00:43,43,0:08:13,137,109564
2016-10-26-ccc_311_lobby_ph_script,2016/10/26,ccc_311_lobby_ph_script,5,3,0:00:08,8,0:00:16,2,24
2016-10-26-ccc_aserv_info_script,2016/10/26,ccc_aserv_info_script,0,0,0:00:00,0,0:00:00,0,0
2016-10-26-ccc_bylaw_script,2016/10/26,ccc_bylaw_script,0,0,0:00:00,0,0:00:00,0,0
2016-10-26-ccc_city_script,2016/10/26,ccc_city_script,19,18,0:00:10,10,0:00:26,1,180
2016-10-26-ccc_cty_online_script,2016/10/26,ccc_cty_online_script,0,0,0:00:00,0,0:00:00,0,0
2016-10-26-ccc_feedback_script,2016/10/26,ccc_feedback_script,0,0,0:00:00,0,0:00:00,0,0
2016-10-26-ccc_fpb_script,2016/10/26,ccc_fpb_script,1,1,0:00:02,2,0:00:02,0,2
2016-10-26-ccc_help_script,2016/10/26,ccc_help_script,8,7,0:00:15,15,0:00:46,1,105
2016-10-26-ccc_link_script,2016/10/26,ccc_link_script,0,0,0:00:00,0,0:00:00,0,0
2016-10-26-ccc_media_line_script,2016/10/26,ccc_media_line_script,0,0,0:00:00,0,0:00:00,0,0
2016-10-26-ccc_priority_script,2016/10/26,ccc_priority_script,35,35,0:00:09,9,0:00:39,0,315
2016-10-26-ccc_tax_script,2016/10/26,ccc_tax_script,16,15,0:00:11,11,0:01:21,1,165
2016-10-26-ccc_waste_recycling_script,2016/10/26,ccc_waste_recycling_script,0,0,0:00:00,0,0:00:00,0,0
2016-10-27-ccc_311_calgary_script,2016/10/27,ccc_311_calgary_script,2810,2605,0:01:00,60,0:06:32,205,156300
2016-10-27-ccc_311_lobby_ph_script,2016/10/27,ccc_311_lobby_ph_script,3,3,0:00:05,5,0:00:08,0,15
2016-10-27-ccc_aserv_info_script,2016/10/27,ccc_aserv_info_script,0,0,0:00:00,0,0:00:00,0,0
2016-10-27-ccc_bylaw_script,2016/10/27,ccc_bylaw_script,0,0,0:00:00,0,0:00:00,0,0
2016-10-27-ccc_city_script,2016/10/27,ccc_city_script,30,29,0:00:16,16,0:01:38,1,464
2016-10-27-ccc_cty_online_script,2016/10/27,ccc_cty_online_script,0,0,0:00:00,0,0:00:00,0,0
2016-10-27-ccc_feedback_script,2016/10/27,ccc_feedback_script,0,0,0:00:00,0,0:00:00,0,0
2016-10-27-ccc_fpb_script,2016/10/27,ccc_fpb_script,5,5,0:00:48,48,0:03:30,0,240
2016-10-27-ccc_help_script,2016/10/27,ccc_help_script,27,24,0:00:17,17,0:01:21,3,408
2016-10-27-ccc_link_script,2016/10/27,ccc_link_script,0,0,0:00:00,0,0:00:00,0,0
2016-10-27-ccc_media_line_script,2016/10/27,ccc_media_line_script,2,1,0:00:19,19,0:00:19,1,19
2016-10-27-ccc_priority_script,2016/10/27,ccc_priority_script,16,16,0:00:17,17,0:01:17,0,272
2016-10-27-ccc_tax_script,2016/10/27,ccc_tax_script,30,30,0:01:07,67,0:04:33,0,2010
2016-10-27-ccc_waste_recycling_script,2016/10/27,ccc_waste_recycling_script,0,0,0:00:00,0,0:00:00,0,0
2016-10-28-ccc_311_calgary_script,2016/10/28,ccc_311_calgary_script,2435,2349,0:00:30,30,0:04:23,86,70470
2016-10-28-ccc_311_lobby_ph_script,2016/10/28,ccc_311_lobby_ph_script,0,0,0:00:00,0,0:00:00,0,0
2016-10-28-ccc_aserv_info_script,2016/10/28,ccc_aserv_info_script,0,0,0:00:00,0,0:00:00,0,0
2016-10-28-ccc_bylaw_script,2016/10/28,ccc_bylaw_script,0,0,0:00:00,0,0:00:00,0,0
2016-10-28-ccc_city_script,2016/10/28,ccc_city_script,24,24,0:00:12,12,0:00:48,0,288
2016-10-28-ccc_cty_online_script,2016/10/28,ccc_cty_online_script,0,0,0:00:00,0,0:00:00,0,0
2016-10-28-ccc_feedback_script,2016/10/28,ccc_feedback_script,1,0,0:00:00,0,0:00:00,0,0
2016-10-28-ccc_fpb_script,2016/10/28,ccc_fpb_script,1,1,0:00:17,17,0:00:17,0,17
2016-10-28-ccc_help_script,2016/10/28,ccc_help_script,24,23,0:00:06,6,0:00:15,1,138
2016-10-28-ccc_link_script,2016/10/28,ccc_link_script,0,0,0:00:00,0,0:00:00,0,0
2016-10-28-ccc_media_line_script,2016/10/28,ccc_media_line_script,0,0,0:00:00,0,0:00:00,0,0
2016-10-28-ccc_priority_script,2016/10/28,ccc_priority_script,26,25,0:00:11,11,0:00:34,1,275
2016-10-28-ccc_tax_script,2016/10/28,ccc_tax_script,14,12,0:00:40,40,0:01:58,2,480
2016-10-28-ccc_waste_recycling_script,2016/10/28,ccc_waste_recycling_script,0,0,0:00:00,0,0:00:00,0,0
2016-10-29-ccc_311_calgary_script,2016/10/29,ccc_311_calgary_script,925,898,0:00:25,25,0:06:22,27,22450
2016-10-29-ccc_311_lobby_ph_script,2016/10/29,ccc_311_lobby_ph_script,0,0,0:00:00,0,0:00:00,0,0
2016-10-29-ccc_aserv_info_script,2016/10/29,ccc_aserv_info_script,0,0,0:00:00,0,0:00:00,0,0
2016-10-29-ccc_bylaw_script,2016/10/29,ccc_bylaw_script,0,0,0:00:00,0,0:00:00,0,0
2016-10-29-ccc_city_script,2016/10/29,ccc_city_script,0,0,0:00:00,0,0:00:00,0,0
2016-10-29-ccc_cty_online_script,2016/10/29,ccc_cty_online_script,0,0,0:00:00,0,0:00:00,0,0
2016-10-29-ccc_feedback_script,2016/10/29,ccc_feedback_script,0,0,0:00:00,0,0:00:00,0,0
2016-10-29-ccc_fpb_script,2016/10/29,ccc_fpb_script,0,0,0:00:00,0,0:00:00,0,0
2016-10-29-ccc_help_script,2016/10/29,ccc_help_script,14,13,0:00:14,14,0:00:49,1,182
2016-10-29-ccc_link_script,2016/10/29,ccc_link_script,0,0,0:00:00,0,0:00:00,0,0
2016-10-29-ccc_media_line_script,2016/10/29,ccc_media_line_script,1,1,0:00:16,16,0:00:16,0,16
2016-10-29-ccc_priority_script,2016/10/29,ccc_priority_script,14,14,0:00:07,7,0:00:15,0,98
2016-10-29-ccc_tax_script,2016/10/29,ccc_tax_script,1,1,0:01:06,66,0:01:06,0,66
2016-10-29-ccc_waste_recycling_script,2016/10/29,ccc_waste_recycling_script,0,0,0:00:00,0,0:00:00,0,0
2016-10-30-ccc_311_calgary_script,2016/10/30,ccc_311_calgary_script,847,807,0:00:22,22,0:05:14,40,17754
2016-10-30-ccc_311_lobby_ph_script,2016/10/30,ccc_311_lobby_ph_script,0,0,0:00:00,0,0:00:00,0,0
2016-10-30-ccc_aserv_info_script,2016/10/30,ccc_aserv_info_script,0,0,0:00:00,0,0:00:00,0,0
2016-10-30-ccc_bylaw_script,2016/10/30,ccc_bylaw_script,0,0,0:00:00,0,0:00:00,0,0
2016-10-30-ccc_city_script,2016/10/30,ccc_city_script,0,0,0:00:00,0,0:00:00,0,0
2016-10-30-ccc_cty_online_script,2016/10/30,ccc_cty_online_script,0,0,0:00:00,0,0:00:00,0,0
2016-10-30-ccc_feedback_script,2016/10/30,ccc_feedback_script,0,0,0:00:00,0,0:00:00,0,0
2016-10-30-ccc_fpb_script,2016/10/30,ccc_fpb_script,0,0,0:00:00,0,0:00:00,0,0
2016-10-30-ccc_help_script,2016/10/30,ccc_help_script,3,3,0:00:12,12,0:00:18,0,36
2016-10-30-ccc_link_script,2016/10/30,ccc_link_script,0,0,0:00:00,0,0:00:00,0,0
2016-10-30-ccc_media_line_script,2016/10/30,ccc_media_line_script,2,2,0:00:04,4,0:00:04,0,8
2016-10-30-ccc_priority_script,2016/10/30,ccc_priority_script,25,23,0:00:08,8,0:00:20,2,184
2016-10-30-ccc_tax_script,2016/10/30,ccc_tax_script,0,0,0:00:00,0,0:00:00,0,0
2016-10-30-ccc_waste_recycling_script,2016/10/30,ccc_waste_recycling_script,0,0,0:00:00,0,0:00:00,0,0
2016-10-31-ccc_311_calgary_script,2016/10/31,ccc_311_calgary_script,3102,2809,0:01:35,95,0:11:03,293,266855
2016-10-31-ccc_311_lobby_ph_script,2016/10/31,ccc_311_lobby_ph_script,6,6,0:00:10,10,0:00:16,0,60
2016-10-31-ccc_aserv_info_script,2016/10/31,ccc_aserv_info_script,0,0,0:00:00,0,0:00:00,0,0
2016-10-31-ccc_bylaw_script,2016/10/31,ccc_bylaw_script,0,0,0:00:00,0,0:00:00,0,0
2016-10-31-ccc_city_script,2016/10/31,ccc_city_script,17,14,0:00:37,37,0:03:41,3,518
2016-10-31-ccc_cty_online_script,2016/10/31,ccc_cty_online_script,0,0,0:00:00,0,0:00:00,0,0
2016-10-31-ccc_feedback_script,2016/10/31,ccc_feedback_script,0,0,0:00:00,0,0:00:00,0,0
2016-10-31-ccc_fpb_script,2016/10/31,ccc_fpb_script,1,1,0:02:18,138,0:02:18,0,138
2016-10-31-ccc_help_script,2016/10/31,ccc_help_script,21,19,0:00:14,14,0:00:43,2,266
2016-10-31-ccc_link_script,2016/10/31,ccc_link_script,0,0,0:00:00,0,0:00:00,0,0
2016-10-31-ccc_media_line_script,2016/10/31,ccc_media_line_script,1,1,0:00:06,6,0:00:06,0,6
2016-10-31-ccc_priority_script,2016/10/31,ccc_priority_script,22,21,0:00:16,16,0:01:11,1,336
2016-10-31-ccc_tax_script,2016/10/31,ccc_tax_script,15,13,0:00:53,53,0:03:46,2,689
2016-10-31-ccc_waste_recycling_script,2016/10/31,ccc_waste_recycling_script,0,0,0:00:00,0,0:00:00,0,0
2016-11-01-ccc_311_calgary_script,2016/11/01,ccc_311_calgary_script,3076,2616,0:02:53,173,0:11:02,460,452568
2016-11-01-ccc_311_lobby_ph_script,2016/11/01,ccc_311_lobby_ph_script,0,0,0:00:00,0,0:00:00,0,0
2016-11-01-ccc_aserv_info_script,2016/11/01,ccc_aserv_info_script,0,0,0:00:00,0,0:00:00,0,0
2016-11-01-ccc_bylaw_script,2016/11/01,ccc_bylaw_script,1,1,0:06:00,360,0:06:00,0,360
2016-11-01-ccc_city_script,2016/11/01,ccc_city_script,8,7,0:01:27,87,0:04:50,1,609
2016-11-01-ccc_cty_online_script,2016/11/01,ccc_cty_online_script,0,0,0:00:00,0,0:00:00,0,0
2016-11-01-ccc_feedback_script,2016/11/01,ccc_feedback_script,0,0,0:00:00,0,0:00:00,0,0
2016-11-01-ccc_fpb_script,2016/11/01,ccc_fpb_script,0,0,0:00:00,0,0:00:00,0,0
2016-11-01-ccc_help_script,2016/11/01,ccc_help_script,33,26,0:00:16,16,0:01:07,7,416
2016-11-01-ccc_link_script,2016/11/01,ccc_link_script,0,0,0:00:00,0,0:00:00,0,0
2016-11-01-ccc_media_line_script,2016/11/01,ccc_media_line_script,0,0,0:00:00,0,0:00:00,0,0
2016-11-01-ccc_priority_script,2016/11/01,ccc_priority_script,30,28,0:00:17,17,0:00:46,2,476
2016-11-01-ccc_tax_script,2016/11/01,ccc_tax_script,22,19,0:03:57,237,0:09:04,3,4503
2016-11-01-ccc_waste_recycling_script,2016/11/01,ccc_waste_recycling_script,0,0,0:00:00,0,0:00:00,0,0
2016-11-02-ccc_311_calgary_script,2016/11/02,ccc_311_calgary_script,3107,2765,0:01:40,100,0:09:00,342,276500
2016-11-02-ccc_311_lobby_ph_script,2016/11/02,ccc_311_lobby_ph_script,2,1,0:00:28,28,0:00:28,1,28
2016-11-02-ccc_aserv_info_script,2016/11/02,ccc_aserv_info_script,0,0,0:00:00,0,0:00:00,0,0
2016-11-02-ccc_bylaw_script,2016/11/02,ccc_bylaw_script,0,0,0:00:00,0,0:00:00,0,0
2016-11-02-ccc_city_script,2016/11/02,ccc_city_script,17,15,0:00:08,8,0:00:26,2,120
2016-11-02-ccc_cty_online_script,2016/11/02,ccc_cty_online_script,0,0,0:00:00,0,0:00:00,0,0
2016-11-02-ccc_feedback_script,2016/11/02,ccc_feedback_script,0,0,0:00:00,0,0:00:00,0,0
2016-11-02-ccc_fpb_script,2016/11/02,ccc_fpb_script,0,0,0:00:00,0,0:00:00,0,0
2016-11-02-ccc_help_script,2016/11/02,ccc_help_script,10,10,0:00:24,24,0:02:56,0,240
2016-11-02-ccc_link_script,2016/11/02,ccc_link_script,0,0,0:00:00,0,0:00:00,0,0
2016-11-02-ccc_media_line_script,2016/11/02,ccc_media_line_script,1,1,0:00:05,5,0:00:05,0,5
2016-11-02-ccc_priority_script,2016/11/02,ccc_priority_script,27,27,0:00:09,9,0:00:38,0,243
2016-11-02-ccc_tax_script,2016/11/02,ccc_tax_script,26,22,0:01:50,110,0:05:24,4,2420
2016-11-02-ccc_waste_recycling_script,2016/11/02,ccc_waste_recycling_script,0,0,0:00:00,0,0:00:00,0,0
2016-11-03-ccc_311_calgary_script,2016/11/03,ccc_311_calgary_script,2974,2754,0:00:57,57,0:10:49,219,156978
2016-11-03-ccc_311_lobby_ph_script,2016/11/03,ccc_311_lobby_ph_script,3,2,0:00:14,14,0:00:16,1,28
2016-11-03-ccc_aserv_info_script,2016/11/03,ccc_aserv_info_script,0,0,0:00:00,0,0:00:00,0,0
2016-11-03-ccc_bylaw_script,2016/11/03,ccc_bylaw_script,0,0,0:00:00,0,0:00:00,0,0
2016-11-03-ccc_city_script,2016/11/03,ccc_city_script,16,16,0:00:07,7,0:00:31,0,112
2016-11-03-ccc_cty_online_script,2016/11/03,ccc_cty_online_script,0,0,0:00:00,0,0:00:00,0,0
2016-11-03-ccc_feedback_script,2016/11/03,ccc_feedback_script,0,0,0:00:00,0,0:00:00,0,0
2016-11-03-ccc_fpb_script,2016/11/03,ccc_fpb_script,1,0,0:00:00,0,0:00:00,1,0
2016-11-03-ccc_help_script,2016/11/03,ccc_help_script,24,23,0:00:11,11,0:00:46,1,253
2016-11-03-ccc_link_script,2016/11/03,ccc_link_script,0,0,0:00:00,0,0:00:00,0,0
2016-11-03-ccc_media_line_script,2016/11/03,ccc_media_line_script,0,0,0:00:00,0,0:00:00,0,0
2016-11-03-ccc_priority_script,2016/11/03,ccc_priority_script,39,39,0:00:12,12,0:01:09,0,468
2016-11-03-ccc_tax_script,2016/11/03,ccc_tax_script,16,15,0:00:52,52,0:03:36,1,780
2016-11-03-ccc_waste_recycling_script,2016/11/03,ccc_waste_recycling_script,0,0,0:00:00,0,0:00:00,0,0
2016-11-04-ccc_311_calgary_script,2016/11/04,ccc_311_calgary_script,2684,2510,0:01:04,64,0:06:46,175,160640
2016-11-04-ccc_311_lobby_ph_script,2016/11/04,ccc_311_lobby_ph_script,5,5,0:00:06,6,0:00:13,0,30
2016-11-04-ccc_aserv_info_script,2016/11/04,ccc_aserv_info_script,0,0,0:00:00,0,0:00:00,0,0
2016-11-04-ccc_bylaw_script,2016/11/04,ccc_bylaw_script,1,1,0:00:11,11,0:00:11,0,11
2016-11-04-ccc_city_script,2016/11/04,ccc_city_script,19,19,0:00:12,12,0:00:38,0,228
2016-11-04-ccc_cty_online_script,2016/11/04,ccc_cty_online_script,0,0,0:00:00,0,0:00:00,0,0
2016-11-04-ccc_feedback_script,2016/11/04,ccc_feedback_script,0,0,0:00:00,0,0:00:00,0,0
2016-11-04-ccc_fpb_script,2016/11/04,ccc_fpb_script,0,0,0:00:00,0,0:00:00,0,0
2016-11-04-ccc_help_script,2016/11/04,ccc_help_script,11,11,0:00:13,13,0:00:38,0,143
2016-11-04-ccc_link_script,2016/11/04,ccc_link_script,0,0,0:00:00,0,0:00:00,0,0
2016-11-04-ccc_media_line_script,2016/11/04,ccc_media_line_script,1,1,0:00:04,4,0:00:04,0,4
2016-11-04-ccc_priority_script,2016/11/04,ccc_priority_script,35,34,0:00:08,8,0:00:51,1,272
2016-11-04-ccc_tax_script,2016/11/04,ccc_tax_script,16,16,0:01:03,63,0:05:16,0,1008
2016-11-04-ccc_waste_recycling_script,2016/11/04,ccc_waste_recycling_script,0,0,0:00:00,0,0:00:00,0,0
2016-11-05-ccc_311_calgary_script,2016/11/05,ccc_311_calgary_script,1227,1103,0:01:21,81,0:08:27,124,89343
2016-11-05-ccc_311_lobby_ph_script,2016/11/05,ccc_311_lobby_ph_script,0,0,0:00:00,0,0:00:00,0,0
2016-11-05-ccc_aserv_info_script,2016/11/05,ccc_aserv_info_script,0,0,0:00:00,0,0:00:00,0,0
2016-11-05-ccc_bylaw_script,2016/11/05,ccc_bylaw_script,0,0,0:00:00,0,0:00:00,0,0
2016-11-05-ccc_city_script,2016/11/05,ccc_city_script,0,0,0:00:00,0,0:00:00,0,0
2016-11-05-ccc_cty_online_script,2016/11/05,ccc_cty_online_script,0,0,0:00:00,0,0:00:00,0,0
2016-11-05-ccc_feedback_script,2016/11/05,ccc_feedback_script,0,0,0:00:00,0,0:00:00,0,0
2016-11-05-ccc_fpb_script,2016/11/05,ccc_fpb_script,1,1,0:00:02,2,0:00:02,0,2
2016-11-05-ccc_help_script,2016/11/05,ccc_help_script,7,7,0:00:07,7,0:00:13,0,49
2016-11-05-ccc_link_script,2016/11/05,ccc_link_script,0,0,0:00:00,0,0:00:00,0,0
2016-11-05-ccc_media_line_script,2016/11/05,ccc_media_line_script,2,2,0:00:55,55,0:01:01,0,110
2016-11-05-ccc_priority_script,2016/11/05,ccc_priority_script,24,24,0:00:17,17,0:01:43,0,408
2016-11-05-ccc_tax_script,2016/11/05,ccc_tax_script,2,2,0:01:42,102,0:02:49,0,204
2016-11-05-ccc_waste_recycling_script,2016/11/05,ccc_waste_recycling_script,0,0,0:00:00,0,0:00:00,0,0
2016-11-06-ccc_311_calgary_script,2016/11/06,ccc_311_calgary_script,866,858,0:00:10,10,0:03:00,8,8580
2016-11-06-ccc_311_lobby_ph_script,2016/11/06,ccc_311_lobby_ph_script,0,0,0:00:00,0,0:00:00,0,0
2016-11-06-ccc_aserv_info_script,2016/11/06,ccc_aserv_info_script,0,0,0:00:00,0,0:00:00,0,0
2016-11-06-ccc_bylaw_script,2016/11/06,ccc_bylaw_script,0,0,0:00:00,0,0:00:00,0,0
2016-11-06-ccc_city_script,2016/11/06,ccc_city_script,0,0,0:00:00,0,0:00:00,0,0
2016-11-06-ccc_cty_online_script,2016/11/06,ccc_cty_online_script,0,0,0:00:00,0,0:00:00,0,0
2016-11-06-ccc_feedback_script,2016/11/06,ccc_feedback_script,0,0,0:00:00,0,0:00:00,0,0
2016-11-06-ccc_fpb_script,2016/11/06,ccc_fpb_script,0,0,0:00:00,0,0:00:00,0,0
2016-11-06-ccc_help_script,2016/11/06,ccc_help_script,4,3,0:00:03,3,0:00:04,1,9
2016-11-06-ccc_link_script,2016/11/06,ccc_link_script,0,0,0:00:00,0,0:00:00,0,0
2016-11-06-ccc_media_line_script,2016/11/06,ccc_media_line_script,0,0,0:00:00,0,0:00:00,0,0
2016-11-06-ccc_priority_script,2016/11/06,ccc_priority_script,17,17,0:00:07,7,0:00:34,0,119
2016-11-06-ccc_tax_script,2016/11/06,ccc_tax_script,1,1,0:00:02,2,0:00:02,0,2
2016-11-06-ccc_waste_recycling_script,2016/11/06,ccc_waste_recycling_script,0,0,0:00:00,0,0:00:00,0,0
2016-11-07-ccc_311_calgary_script,2016/11/07,ccc_311_calgary_script,3045,2837,0:01:04,64,0:08:05,208,181568
2016-11-07-ccc_311_lobby_ph_script,2016/11/07,ccc_311_lobby_ph_script,8,6,0:00:04,4,0:00:09,2,24
2016-11-07-ccc_aserv_info_script,2016/11/07,ccc_aserv_info_script,0,0,0:00:00,0,0:00:00,0,0
2016-11-07-ccc_bylaw_script,2016/11/07,ccc_bylaw_script,0,0,0:00:00,0,0:00:00,0,0
2016-11-07-ccc_city_script,2016/11/07,ccc_city_script,27,27,0:00:20,20,0:03:08,0,540
2016-11-07-ccc_cty_online_script,2016/11/07,ccc_cty_online_script,0,0,0:00:00,0,0:00:00,0,0
2016-11-07-ccc_feedback_script,2016/11/07,ccc_feedback_script,0,0,0:00:00,0,0:00:00,0,0
2016-11-07-ccc_fpb_script,2016/11/07,ccc_fpb_script,0,0,0:00:00,0,0:00:00,0,0
2016-11-07-ccc_help_script,2016/11/07,ccc_help_script,6,6,0:00:06,6,0:00:14,0,36
2016-11-07-ccc_link_script,2016/11/07,ccc_link_script,0,0,0:00:00,0,0:00:00,0,0
2016-11-07-ccc_media_line_script,2016/11/07,ccc_media_line_script,2,2,0:00:06,6,0:00:10,0,12
2016-11-07-ccc_priority_script,2016/11/07,ccc_priority_script,27,27,0:00:09,9,0:00:53,0,243
2016-11-07-ccc_tax_script,2016/11/07,ccc_tax_script,15,15,0:01:23,83,0:06:16,0,1245
2016-11-07-ccc_waste_recycling_script,2016/11/07,ccc_waste_recycling_script,0,0,0:00:00,0,0:00:00,0,0
2016-11-08-ccc_311_calgary_script,2016/11/08,ccc_311_calgary_script,2683,2550,0:00:47,47,0:09:04,133,119850
2016-11-08-ccc_311_lobby_ph_script,2016/11/08,ccc_311_lobby_ph_script,0,0,0:00:00,0,0:00:00,0,0
2016-11-08-ccc_aserv_info_script,2016/11/08,ccc_aserv_info_script,0,0,0:00:00,0,0:00:00,0,0
2016-11-08-ccc_bylaw_script,2016/11/08,ccc_bylaw_script,0,0,0:00:00,0,0:00:00,0,0
2016-11-08-ccc_city_script,2016/11/08,ccc_city_script,34,32,0:00:17,17,0:02:29,2,544
2016-11-08-ccc_cty_online_script,2016/11/08,ccc_cty_online_script,0,0,0:00:00,0,0:00:00,0,0
2016-11-08-ccc_feedback_script,2016/11/08,ccc_feedback_script,0,0,0:00:00,0,0:00:00,0,0
2016-11-08-ccc_fpb_script,2016/11/08,ccc_fpb_script,1,0,0:00:00,0,0:00:00,1,0
2016-11-08-ccc_help_script,2016/11/08,ccc_help_script,22,19,0:00:13,13,0:01:02,3,247
2016-11-08-ccc_link_script,2016/11/08,ccc_link_script,0,0,0:00:00,0,0:00:00,0,0
2016-11-08-ccc_media_line_script,2016/11/08,ccc_media_line_script,1,1,0:00:04,4,0:00:04,0,4
2016-11-08-ccc_priority_script,2016/11/08,ccc_priority_script,33,31,0:00:09,9,0:00:26,2,279
2016-11-08-ccc_tax_script,2016/11/08,ccc_tax_script,16,15,0:00:14,14,0:01:01,1,210
2016-11-08-ccc_waste_recycling_script,2016/11/08,ccc_waste_recycling_script,0,0,0:00:00,0,0:00:00,0,0
2016-11-09-ccc_311_calgary_script,2016/11/09,ccc_311_calgary_script,2589,2536,0:00:15,15,0:03:39,53,38040
2016-11-09-ccc_311_lobby_ph_script,2016/11/09,ccc_311_lobby_ph_script,4,3,0:00:05,5,0:00:08,1,15
2016-11-09-ccc_aserv_info_script,2016/11/09,ccc_aserv_info_script,0,0,0:00:00,0,0:00:00,0,0
2016-11-09-ccc_bylaw_script,2016/11/09,ccc_bylaw_script,0,0,0:00:00,0,0:00:00,0,0
2016-11-09-ccc_city_script,2016/11/09,ccc_city_script,21,21,0:00:09,9,0:00:33,0,189
2016-11-09-ccc_cty_online_script,2016/11/09,ccc_cty_online_script,0,0,0:00:00,0,0:00:00,0,0
2016-11-09-ccc_feedback_script,2016/11/09,ccc_feedback_script,0,0,0:00:00,0,0:00:00,0,0
2016-11-09-ccc_fpb_script,2016/11/09,ccc_fpb_script,1,1,0:00:06,6,0:00:06,0,6
2016-11-09-ccc_help_script,2016/11/09,ccc_help_script,13,12,0:00:08,8,0:00:26,1,96
2016-11-09-ccc_link_script,2016/11/09,ccc_link_script,0,0,0:00:00,0,0:00:00,0,0
2016-11-09-ccc_media_line_script,2016/11/09,ccc_media_line_script,1,1,0:00:09,9,0:00:09,0,9
2016-11-09-ccc_priority_script,2016/11/09,ccc_priority_script,35,35,0:00:07,7,0:00:51,0,245
2016-11-09-ccc_tax_script,2016/11/09,ccc_tax_script,14,14,0:00:09,9,0:00:38,0,126
2016-11-09-ccc_waste_recycling_script,2016/11/09,ccc_waste_recycling_script,0,0,0:00:00,0,0:00:00,0,0
2016-11-10-ccc_311_calgary_script,2016/11/10,ccc_311_calgary_script,2729,2672,0:00:18,18,0:04:24,57,48096
2016-11-10-ccc_311_lobby_ph_script,2016/11/10,ccc_311_lobby_ph_script,2,2,0:00:23,23,0:00:43,0,46
2016-11-10-ccc_aserv_info_script,2016/11/10,ccc_aserv_info_script,0,0,0:00:00,0,0:00:00,0,0
2016-11-10-ccc_bylaw_script,2016/11/10,ccc_bylaw_script,0,0,0:00:00,0,0:00:00,0,0
2016-11-10-ccc_city_script,2016/11/10,ccc_city_script,17,17,0:00:06,6,0:00:19,0,102
2016-11-10-ccc_cty_online_script,2016/11/10,ccc_cty_online_script,0,0,0:00:00,0,0:00:00,0,0
2016-11-10-ccc_feedback_script,2016/11/10,ccc_feedback_script,1,0,0:00:00,0,0:00:00,0,0
2016-11-10-ccc_fpb_script,2016/11/10,ccc_fpb_script,0,0,0:00:00,0,0:00:00,0,0
2016-11-10-ccc_help_script,2016/11/10,ccc_help_script,11,11,0:00:06,6,0:00:11,0,66
2016-11-10-ccc_link_script,2016/11/10,ccc_link_script,0,0,0:00:00,0,0:00:00,0,0
2016-11-10-ccc_media_line_script,2016/11/10,ccc_media_line_script,0,0,0:00:00,0,0:00:00,0,0
2016-11-10-ccc_priority_script,2016/11/10,ccc_priority_script,18,18,0:00:05,5,0:00:10,0,90
2016-11-10-ccc_tax_script,2016/11/10,ccc_tax_script,27,24,0:00:15,15,0:01:15,3,360
2016-11-10-ccc_waste_recycling_script,2016/11/10,ccc_waste_recycling_script,0,0,0:00:00,0,0:00:00,0,0
2016-11-11-ccc_311_calgary_script,2016/11/11,ccc_311_calgary_script,1384,1376,0:00:09,9,0:04:59,8,12384
2016-11-11-ccc_311_lobby_ph_script,2016/11/11,ccc_311_lobby_ph_script,1,1,0:00:02,2,0:00:02,0,2
2016-11-11-ccc_aserv_info_script,2016/11/11,ccc_aserv_info_script,0,0,0:00:00,0,0:00:00,0,0
2016-11-11-ccc_bylaw_script,2016/11/11,ccc_bylaw_script,0,0,0:00:00,0,0:00:00,0,0
2016-11-11-ccc_city_script,2016/11/11,ccc_city_script,0,0,0:00:00,0,0:00:00,0,0
2016-11-11-ccc_cty_online_script,2016/11/11,ccc_cty_online_script,0,0,0:00:00,0,0:00:00,0,0
2016-11-11-ccc_feedback_script,2016/11/11,ccc_feedback_script,0,0,0:00:00,0,0:00:00,0,0
2016-11-11-ccc_fpb_script,2016/11/11,ccc_fpb_script,0,0,0:00:00,0,0:00:00,0,0
2016-11-11-ccc_help_script,2016/11/11,ccc_help_script,6,6,0:00:06,6,0:00:07,0,36
2016-11-11-ccc_link_script,2016/11/11,ccc_link_script,0,0,0:00:00,0,0:00:00,0,0
2016-11-11-ccc_media_line_script,2016/11/11,ccc_media_line_script,2,2,0:00:07,7,0:00:09,0,14
2016-11-11-ccc_priority_script,2016/11/11,ccc_priority_script,16,16,0:00:07,7,0:00:35,0,112
2016-11-11-ccc_tax_script,2016/11/11,ccc_tax_script,1,1,0:00:02,2,0:00:02,0,2
2016-11-11-ccc_waste_recycling_script,2016/11/11,ccc_waste_recycling_script,0,0,0:00:00,0,0:00:00,0,0
2016-11-12-ccc_311_calgary_script,2016/11/12,ccc_311_calgary_script,988,963,0:00:16,16,0:05:19,25,15408
2016-11-12-ccc_311_lobby_ph_script,2016/11/12,ccc_311_lobby_ph_script,0,0,0:00:00,0,0:00:00,0,0
2016-11-12-ccc_aserv_info_script,2016/11/12,ccc_aserv_info_script,0,0,0:00:00,0,0:00:00,0,0
2016-11-12-ccc_bylaw_script,2016/11/12,ccc_bylaw_script,0,0,0:00:00,0,0:00:00,0,0
2016-11-12-ccc_city_script,2016/11/12,ccc_city_script,0,0,0:00:00,0,0:00:00,0,0
2016-11-12-ccc_cty_online_script,2016/11/12,ccc_cty_online_script,0,0,0:00:00,0,0:00:00,0,0
2016-11-12-ccc_feedback_script,2016/11/12,ccc_feedback_script,0,0,0:00:00,0,0:00:00,0,0
2016-11-12-ccc_fpb_script,2016/11/12,ccc_fpb_script,0,0,0:00:00,0,0:00:00,0,0
2016-11-12-ccc_help_script,2016/11/12,ccc_help_script,9,7,0:00:06,6,0:00:17,2,42
2016-11-12-ccc_link_script,2016/11/12,ccc_link_script,0,0,0:00:00,0,0:00:00,0,0
2016-11-12-ccc_media_line_script,2016/11/12,ccc_media_line_script,1,1,0:00:43,43,0:00:43,0,43
2016-11-12-ccc_priority_script,2016/11/12,ccc_priority_script,14,14,0:00:07,7,0:00:16,0,98
2016-11-12-ccc_tax_script,2016/11/12,ccc_tax_script,1,1,0:00:43,43,0:00:43,0,43
2016-11-12-ccc_waste_recycling_script,2016/11/12,ccc_waste_recycling_script,0,0,0:00:00,0,0:00:00,0,0
2016-11-13-ccc_311_calgary_script,2016/11/13,ccc_311_calgary_script,731,717,0:00:14,14,0:06:36,13,10038
2016-11-13-ccc_311_lobby_ph_script,2016/11/13,ccc_311_lobby_ph_script,0,0,0:00:00,0,0:00:00,0,0
2016-11-13-ccc_aserv_info_script,2016/11/13,ccc_aserv_info_script,0,0,0:00:00,0,0:00:00,0,0
2016-11-13-ccc_bylaw_script,2016/11/13,ccc_bylaw_script,0,0,0:00:00,0,0:00:00,0,0
2016-11-13-ccc_city_script,2016/11/13,ccc_city_script,0,0,0:00:00,0,0:00:00,0,0
2016-11-13-ccc_cty_online_script,2016/11/13,ccc_cty_online_script,0,0,0:00:00,0,0:00:00,0,0
2016-11-13-ccc_feedback_script,2016/11/13,ccc_feedback_script,0,0,0:00:00,0,0:00:00,0,0
2016-11-13-ccc_fpb_script,2016/11/13,ccc_fpb_script,1,1,0:00:04,4,0:00:04,0,4
2016-11-13-ccc_help_script,2016/11/13,ccc_help_script,3,3,0:00:06,6,0:00:08,0,18
2016-11-13-ccc_link_script,2016/11/13,ccc_link_script,0,0,0:00:00,0,0:00:00,0,0
2016-11-13-ccc_media_line_script,2016/11/13,ccc_media_line_script,2,2,0:00:13,13,0:00:19,0,26
2016-11-13-ccc_priority_script,2016/11/13,ccc_priority_script,17,17,0:00:19,19,0:03:27,0,323
2016-11-13-ccc_tax_script,2016/11/13,ccc_tax_script,0,0,0:00:00,0,0:00:00,0,0
2016-11-13-ccc_waste_recycling_script,2016/11/13,ccc_waste_recycling_script,0,0,0:00:00,0,0:00:00,0,0
2016-11-14-ccc_311_calgary_script,2016/11/14,ccc_311_calgary_script,3003,2936,0:00:26,26,0:05:33,67,76336
2016-11-14-ccc_311_lobby_ph_script,2016/11/14,ccc_311_lobby_ph_script,1,1,0:00:21,21,0:00:21,0,21
2016-11-14-ccc_aserv_info_script,2016/11/14,ccc_aserv_info_script,0,0,0:00:00,0,0:00:00,0,0
2016-11-14-ccc_bylaw_script,2016/11/14,ccc_bylaw_script,0,0,0:00:00,0,0:00:00,0,0
2016-11-14-ccc_city_script,2016/11/14,ccc_city_script,21,21,0:00:08,8,0:00:23,0,168
2016-11-14-ccc_cty_online_script,2016/11/14,ccc_cty_online_script,0,0,0:00:00,0,0:00:00,0,0
2016-11-14-ccc_feedback_script,2016/11/14,ccc_feedback_script,0,0,0:00:00,0,0:00:00,0,0
2016-11-14-ccc_fpb_script,2016/11/14,ccc_fpb_script,0,0,0:00:00,0,0:00:00,0,0
2016-11-14-ccc_help_script,2016/11/14,ccc_help_script,6,6,0:00:06,6,0:00:14,0,36
2016-11-14-ccc_link_script,2016/11/14,ccc_link_script,0,0,0:00:00,0,0:00:00,0,0
2016-11-14-ccc_media_line_script,2016/11/14,ccc_media_line_script,3,3,0:00:03,3,0:00:04,0,9
2016-11-14-ccc_priority_script,2016/11/14,ccc_priority_script,26,25,0:00:07,7,0:00:40,1,175
2016-11-14-ccc_tax_script,2016/11/14,ccc_tax_script,12,12,0:00:54,54,0:02:43,0,648
2016-11-14-ccc_waste_recycling_script,2016/11/14,ccc_waste_recycling_script,0,0,0:00:00,0,0:00:00,0,0
2016-11-15-ccc_311_calgary_script,2016/11/15,ccc_311_calgary_script,2561,2528,0:00:10,10,0:04:55,33,25280
2016-11-15-ccc_311_lobby_ph_script,2016/11/15,ccc_311_lobby_ph_script,1,1,0:00:05,5,0:00:05,0,5
2016-11-15-ccc_aserv_info_script,2016/11/15,ccc_aserv_info_script,0,0,0:00:00,0,0:00:00,0,0
2016-11-15-ccc_bylaw_script,2016/11/15,ccc_bylaw_script,0,0,0:00:00,0,0:00:00,0,0
2016-11-15-ccc_city_script,2016/11/15,ccc_city_script,14,14,0:00:06,6,0:00:20,0,84
2016-11-15-ccc_cty_online_script,2016/11/15,ccc_cty_online_script,0,0,0:00:00,0,0:00:00,0,0
2016-11-15-ccc_feedback_script,2016/11/15,ccc_feedback_script,0,0,0:00:00,0,0:00:00,0,0
2016-11-15-ccc_fpb_script,2016/11/15,ccc_fpb_script,0,0,0:00:00,0,0:00:00,0,0
2016-11-15-ccc_help_script,2016/11/15,ccc_help_script,11,11,0:00:08,8,0:00:18,0,88
2016-11-15-ccc_link_script,2016/11/15,ccc_link_script,0,0,0:00:00,0,0:00:00,0,0
2016-11-15-ccc_media_line_script,2016/11/15,ccc_media_line_script,0,0,0:00:00,0,0:00:00,0,0
2016-11-15-ccc_priority_script,2016/11/15,ccc_priority_script,18,17,0:00:09,9,0:00:36,1,153
2016-11-15-ccc_tax_script,2016/11/15,ccc_tax_script,14,14,0:00:14,14,0:01:35,0,196
2016-11-15-ccc_waste_recycling_script,2016/11/15,ccc_waste_recycling_script,0,0,0:00:00,0,0:00:00,0,0
2016-11-16-ccc_311_calgary_script,2016/11/16,ccc_311_calgary_script,2501,2450,0:00:13,13,0:04:10,51,31850
2016-11-16-ccc_311_lobby_ph_script,2016/11/16,ccc_311_lobby_ph_script,0,0,0:00:00,0,0:00:00,0,0
2016-11-16-ccc_aserv_info_script,2016/11/16,ccc_aserv_info_script,0,0,0:00:00,0,0:00:00,0,0
2016-11-16-ccc_bylaw_script,2016/11/16,ccc_bylaw_script,0,0,0:00:00,0,0:00:00,0,0
2016-11-16-ccc_city_script,2016/11/16,ccc_city_script,13,13,0:00:10,10,0:00:28,0,130
2016-11-16-ccc_cty_online_script,2016/11/16,ccc_cty_online_script,0,0,0:00:00,0,0:00:00,0,0
2016-11-16-ccc_feedback_script,2016/11/16,ccc_feedback_script,0,0,0:00:00,0,0:00:00,0,0
2016-11-16-ccc_fpb_script,2016/11/16,ccc_fpb_script,0,0,0:00:00,0,0:00:00,0,0
2016-11-16-ccc_help_script,2016/11/16,ccc_help_script,8,8,0:00:06,6,0:00:14,0,48
2016-11-16-ccc_link_script,2016/11/16,ccc_link_script,1,0,0:00:00,0,0:00:00,1,0
2016-11-16-ccc_media_line_script,2016/11/16,ccc_media_line_script,0,0,0:00:00,0,0:00:00,0,0
2016-11-16-ccc_priority_script,2016/11/16,ccc_priority_script,22,22,0:00:07,7,0:00:16,0,154
2016-11-16-ccc_tax_script,2016/11/16,ccc_tax_script,17,17,0:00:16,16,0:01:16,0,272
2016-11-16-ccc_waste_recycling_script,2016/11/16,ccc_waste_recycling_script,0,0,0:00:00,0,0:00:00,0,0
2016-11-17-ccc_311_calgary_script,2016/11/17,ccc_311_calgary_script,2407,2374,0:00:11,11,0:04:31,33,26114
2016-11-17-ccc_311_lobby_ph_script,2016/11/17,ccc_311_lobby_ph_script,3,3,0:00:05,5,0:00:10,0,15
2016-11-17-ccc_aserv_info_script,2016/11/17,ccc_aserv_info_script,0,0,0:00:00,0,0:00:00,0,0
2016-11-17-ccc_bylaw_script,2016/11/17,ccc_bylaw_script,0,0,0:00:00,0,0:00:00,0,0
2016-11-17-ccc_city_script,2016/11/17,ccc_city_script,22,22,0:00:12,12,0:00:42,0,264
2016-11-17-ccc_cty_online_script,2016/11/17,ccc_cty_online_script,0,0,0:00:00,0,0:00:00,0,0
2016-11-17-ccc_feedback_script,2016/11/17,ccc_feedback_script,0,0,0:00:00,0,0:00:00,0,0
2016-11-17-ccc_fpb_script,2016/11/17,ccc_fpb_script,0,0,0:00:00,0,0:00:00,0,0
2016-11-17-ccc_help_script,2016/11/17,ccc_help_script,8,8,0:00:12,12,0:00:48,0,96
2016-11-17-ccc_link_script,2016/11/17,ccc_link_script,0,0,0:00:00,0,0:00:00,0,0
2016-11-17-ccc_media_line_script,2016/11/17,ccc_media_line_script,0,0,0:00:00,0,0:00:00,0,0
2016-11-17-ccc_priority_script,2016/11/17,ccc_priority_script,53,53,0:00:09,9,0:00:47,0,477
2016-11-17-ccc_tax_script,2016/11/17,ccc_tax_script,16,16,0:00:13,13,0:00:43,0,208
2016-11-17-ccc_waste_recycling_script,2016/11/17,ccc_waste_recycling_script,0,0,0:00:00,0,0:00:00,0,0
2016-11-18-ccc_311_calgary_script,2016/11/18,ccc_311_calgary_script,2270,2221,0:00:18,18,0:04:02,49,39978
2016-11-18-ccc_311_lobby_ph_script,2016/11/18,ccc_311_lobby_ph_script,1,1,0:00:05,5,0:00:05,0,5
2016-11-18-ccc_aserv_info_script,2016/11/18,ccc_aserv_info_script,0,0,0:00:00,0,0:00:00,0,0
2016-11-18-ccc_bylaw_script,2016/11/18,ccc_bylaw_script,0,0,0:00:00,0,0:00:00,0,0
2016-11-18-ccc_city_script,2016/11/18,ccc_city_script,30,30,0:00:08,8,0:00:31,0,240
2016-11-18-ccc_cty_online_script,2016/11/18,ccc_cty_online_script,0,0,0:00:00,0,0:00:00,0,0
2016-11-18-ccc_feedback_script,2016/11/18,ccc_feedback_script,0,0,0:00:00,0,0:00:00,0,0
2016-11-18-ccc_fpb_script,2016/11/18,ccc_fpb_script,2,2,0:00:03,3,0:00:03,0,6
2016-11-18-ccc_help_script,2016/11/18,ccc_help_script,10,10,0:00:11,11,0:00:39,0,110
2016-11-18-ccc_link_script,2016/11/18,ccc_link_script,0,0,0:00:00,0,0:00:00,0,0
2016-11-18-ccc_media_line_script,2016/11/18,ccc_media_line_script,0,0,0:00:00,0,0:00:00,0,0
2016-11-18-ccc_priority_script,2016/11/18,ccc_priority_script,19,17,0:00:15,15,0:01:51,2,255
2016-11-18-ccc_tax_script,2016/11/18,ccc_tax_script,20,19,0:00:14,14,0:01:13,1,266
2016-11-18-ccc_waste_recycling_script,2016/11/18,ccc_waste_recycling_script,0,0,0:00:00,0,0:00:00,0,0
2016-11-19-ccc_311_calgary_script,2016/11/19,ccc_311_calgary_script,944,930,0:00:10,10,0:03:34,14,9300
2016-11-19-ccc_311_lobby_ph_script,2016/11/19,ccc_311_lobby_ph_script,0,0,0:00:00,0,0:00:00,0,0
2016-11-19-ccc_aserv_info_script,2016/11/19,ccc_aserv_info_script,0,0,0:00:00,0,0:00:00,0,0
2016-11-19-ccc_bylaw_script,2016/11/19,ccc_bylaw_script,0,0,0:00:00,0,0:00:00,0,0
2016-11-19-ccc_city_script,2016/11/19,ccc_city_script,0,0,0:00:00,0,0:00:00,0,0
2016-11-19-ccc_cty_online_script,2016/11/19,ccc_cty_online_script,0,0,0:00:00,0,0:00:00,0,0
2016-11-19-ccc_feedback_script,2016/11/19,ccc_feedback_script,0,0,0:00:00,0,0:00:00,0,0
2016-11-19-ccc_fpb_script,2016/11/19,ccc_fpb_script,0,0,0:00:00,0,0:00:00,0,0
2016-11-19-ccc_help_script,2016/11/19,ccc_help_script,5,5,0:00:05,5,0:00:09,0,25
2016-11-19-ccc_link_script,2016/11/19,ccc_link_script,0,0,0:00:00,0,0:00:00,0,0
2016-11-19-ccc_media_line_script,2016/11/19,ccc_media_line_script,2,2,0:00:12,12,0:00:16,0,24
2016-11-19-ccc_priority_script,2016/11/19,ccc_priority_script,15,15,0:00:12,12,0:01:41,0,180
2016-11-19-ccc_tax_script,2016/11/19,ccc_tax_script,1,1,0:00:04,4,0:00:04,0,4
2016-11-19-ccc_waste_recycling_script,2016/11/19,ccc_waste_recycling_script,0,0,0:00:00,0,0:00:00,0,0
2016-11-20-ccc_311_calgary_script,2016/11/20,ccc_311_calgary_script,695,688,0:00:09,9,0:04:14,7,6192
2016-11-20-ccc_311_lobby_ph_script,2016/11/20,ccc_311_lobby_ph_script,0,0,0:00:00,0,0:00:00,0,0
2016-11-20-ccc_aserv_info_script,2016/11/20,ccc_aserv_info_script,0,0,0:00:00,0,0:00:00,0,0
2016-11-20-ccc_bylaw_script,2016/11/20,ccc_bylaw_script,0,0,0:00:00,0,0:00:00,0,0
2016-11-20-ccc_city_script,2016/11/20,ccc_city_script,0,0,0:00:00,0,0:00:00,0,0
2016-11-20-ccc_cty_online_script,2016/11/20,ccc_cty_online_script,0,0,0:00:00,0,0:00:00,0,0
2016-11-20-ccc_feedback_script,2016/11/20,ccc_feedback_script,0,0,0:00:00,0,0:00:00,0,0
2016-11-20-ccc_fpb_script,2016/11/20,ccc_fpb_script,0,0,0:00:00,0,0:00:00,0,0
2016-11-20-ccc_help_script,2016/11/20,ccc_help_script,0,0,0:00:00,0,0:00:00,0,0
2016-11-20-ccc_link_script,2016/11/20,ccc_link_script,0,0,0:00:00,0,0:00:00,0,0
2016-11-20-ccc_media_line_script,2016/11/20,ccc_media_line_script,1,1,0:00:06,6,0:00:06,0,6
2016-11-20-ccc_priority_script,2016/11/20,ccc_priority_script,9,9,0:00:05,5,0:00:09,0,45
2016-11-20-ccc_tax_script,2016/11/20,ccc_tax_script,0,0,0:00:00,0,0:00:00,0,0
2016-11-20-ccc_waste_recycling_script,2016/11/20,ccc_waste_recycling_script,0,0,0:00:00,0,0:00:00,0,0
2016-11-21-ccc_311_calgary_script,2016/11/21,ccc_311_calgary_script,3002,2830,0:00:44,44,0:05:22,172,124520
2016-11-21-ccc_311_lobby_ph_script,2016/11/21,ccc_311_lobby_ph_script,2,2,0:00:09,9,0:00:09,0,18
2016-11-21-ccc_aserv_info_script,2016/11/21,ccc_aserv_info_script,0,0,0:00:00,0,0:00:00,0,0
2016-11-21-ccc_bylaw_script,2016/11/21,ccc_bylaw_script,0,0,0:00:00,0,0:00:00,0,0
2016-11-21-ccc_city_script,2016/11/21,ccc_city_script,19,19,0:00:14,14,0:01:41,0,266
2016-11-21-ccc_cty_online_script,2016/11/21,ccc_cty_online_script,0,0,0:00:00,0,0:00:00,0,0
2016-11-21-ccc_feedback_script,2016/11/21,ccc_feedback_script,0,0,0:00:00,0,0:00:00,0,0
2016-11-21-ccc_fpb_script,2016/11/21,ccc_fpb_script,1,1,0:00:59,59,0:00:59,0,59
2016-11-21-ccc_help_script,2016/11/21,ccc_help_script,12,12,0:00:11,11,0:00:29,0,132
2016-11-21-ccc_link_script,2016/11/21,ccc_link_script,0,0,0:00:00,0,0:00:00,0,0
2016-11-21-ccc_media_line_script,2016/11/21,ccc_media_line_script,1,1,0:00:08,8,0:00:08,0,8
2016-11-21-ccc_priority_script,2016/11/21,ccc_priority_script,21,21,0:00:11,11,0:00:57,0,231
2016-11-21-ccc_tax_script,2016/11/21,ccc_tax_script,11,10,0:00:34,34,0:02:33,1,340
2016-11-21-ccc_waste_recycling_script,2016/11/21,ccc_waste_recycling_script,0,0,0:00:00,0,0:00:00,0,0
2016-11-23-ccc_311_calgary_script,2016/11/23,ccc_311_calgary_script,2682,2443,00:01:29,89,00:07:26,239,217427
2016-11-23-ccc_311_lobby_ph_script,2016/11/23,ccc_311_lobby_ph_script,1,1,00:00:10,10,00:00:10,0,10
2016-11-23-ccc_aserv_info_script,2016/11/23,ccc_aserv_info_script,0,0,00:00:00,0,00:00:00,0,0
2016-11-23-ccc_bylaw_script,2016/11/23,ccc_bylaw_script,0,0,00:00:00,0,00:00:00,0,0
2016-11-23-ccc_city_script,2016/11/23,ccc_city_script,21,20,00:00:15,15,00:01:06,1,300
2016-11-23-ccc_cty_online_script,2016/11/23,ccc_cty_online_script,0,0,00:00:00,0,00:00:00,0,0
2016-11-23-ccc_feedback_script,2016/11/23,ccc_feedback_script,0,0,00:00:00,0,00:00:00,0,0
2016-11-23-ccc_fpb_script,2016/11/23,ccc_fpb_script,1,0,00:00:00,0,00:00:00,1,0
2016-11-23-ccc_help_script,2016/11/23,ccc_help_script,5,4,00:00:24,24,00:00:50,1,96
2016-11-23-ccc_link_script,2016/11/23,ccc_link_script,0,0,00:00:00,0,00:00:00,0,0
2016-11-23-ccc_media_line_script,2016/11/23,ccc_media_line_script,1,0,00:00:00,0,00:00:00,1,0
2016-11-23-ccc_priority_script,2016/11/23,ccc_priority_script,37,37,00:00:10,10,00:00:58,0,370
2016-11-23-ccc_tax_script,2016/11/23,ccc_tax_script,22,17,00:02:02,122,00:06:23,5,2074
2016-11-23-ccc_waste_recycling_script,2016/11/23,ccc_waste_recycling_script,0,0,00:00:00,0,00:00:00,0,0
2016-11-24-ccc_311_calgary_script,2016/11/24,ccc_311_calgary_script,2534,2409,00:00:39,39,00:05:56,125,93951
2016-11-24-ccc_311_lobby_ph_script,2016/11/24,ccc_311_lobby_ph_script,3,3,00:00:16,16,00:00:34,0,48
2016-11-24-ccc_aserv_info_script,2016/11/24,ccc_aserv_info_script,0,0,00:00:00,0,00:00:00,0,0
2016-11-24-ccc_bylaw_script,2016/11/24,ccc_bylaw_script,0,0,00:00:00,0,00:00:00,0,0
2016-11-24-ccc_city_script,2016/11/24,ccc_city_script,20,20,00:00:08,8,00:00:23,0,160
2016-11-24-ccc_cty_online_script,2016/11/24,ccc_cty_online_script,0,0,00:00:00,0,00:00:00,0,0
2016-11-24-ccc_feedback_script,2016/11/24,ccc_feedback_script,0,0,00:00:00,0,00:00:00,0,0
2016-11-24-ccc_fpb_script,2016/11/24,ccc_fpb_script,2,1,00:05:35,335,00:05:35,1,335
2016-11-24-ccc_help_script,2016/11/24,ccc_help_script,11,11,00:00:09,9,00:00:19,0,99
2016-11-24-ccc_link_script,2016/11/24,ccc_link_script,0,0,00:00:00,0,00:00:00,0,0
2016-11-24-ccc_media_line_script,2016/11/24,ccc_media_line_script,0,0,00:00:00,0,00:00:00,0,0
2016-11-24-ccc_priority_script,2016/11/24,ccc_priority_script,22,22,00:00:08,8,00:01:01,0,176
2016-11-24-ccc_tax_script,2016/11/24,ccc_tax_script,24,24,00:00:46,46,00:02:17,0,1104
2016-11-24-ccc_waste_recycling_script,2016/11/24,ccc_waste_recycling_script,0,0,00:00:00,0,00:00:00,0,0
2016-11-25-ccc_311_calgary_script,2016/11/25,ccc_311_calgary_script,2301,2209,00:00:30,30,00:04:03,92,66270
2016-11-25-ccc_311_lobby_ph_script,2016/11/25,ccc_311_lobby_ph_script,3,2,00:00:16,16,00:00:18,1,32
2016-11-25-ccc_aserv_info_script,2016/11/25,ccc_aserv_info_script,0,0,00:00:00,0,00:00:00,0,0
2016-11-25-ccc_bylaw_script,2016/11/25,ccc_bylaw_script,0,0,00:00:00,0,00:00:00,0,0
2016-11-25-ccc_city_script,2016/11/25,ccc_city_script,20,20,00:00:20,20,00:01:22,0,400
2016-11-25-ccc_cty_online_script,2016/11/25,ccc_cty_online_script,0,0,00:00:00,0,00:00:00,0,0
2016-11-25-ccc_feedback_script,2016/11/25,ccc_feedback_script,0,0,00:00:00,0,00:00:00,0,0
2016-11-25-ccc_fpb_script,2016/11/25,ccc_fpb_script,4,4,00:00:05,5,00:00:09,0,20
2016-11-25-ccc_help_script,2016/11/25,ccc_help_script,3,3,00:00:06,6,00:00:12,0,18
2016-11-25-ccc_link_script,2016/11/25,ccc_link_script,0,0,00:00:00,0,00:00:00,0,0
2016-11-25-ccc_media_line_script,2016/11/25,ccc_media_line_script,2,2,00:00:06,6,00:00:07,0,12
2016-11-25-ccc_priority_script,2016/11/25,ccc_priority_script,28,27,00:00:11,11,00:00:46,1,297
2016-11-25-ccc_tax_script,2016/11/25,ccc_tax_script,25,22,00:01:02,62,00:03:11,3,1364
2016-11-25-ccc_waste_recycling_script,2016/11/25,ccc_waste_recycling_script,0,0,00:00:00,0,00:00:00,0,0
2016-11-26-ccc_311_calgary_script,2016/11/26,ccc_311_calgary_script,899,873,00:00:15,15,00:03:46,26,13095
2016-11-26-ccc_311_lobby_ph_script,2016/11/26,ccc_311_lobby_ph_script,0,0,00:00:00,0,00:00:00,0,0
2016-11-26-ccc_aserv_info_script,2016/11/26,ccc_aserv_info_script,0,0,00:00:00,0,00:00:00,0,0
2016-11-26-ccc_bylaw_script,2016/11/26,ccc_bylaw_script,0,0,00:00:00,0,00:00:00,0,0
2016-11-26-ccc_city_script,2016/11/26,ccc_city_script,0,0,00:00:00,0,00:00:00,0,0
2016-11-26-ccc_cty_online_script,2016/11/26,ccc_cty_online_script,0,0,00:00:00,0,00:00:00,0,0
2016-11-26-ccc_feedback_script,2016/11/26,ccc_feedback_script,0,0,00:00:00,0,00:00:00,0,0
2016-11-26-ccc_fpb_script,2016/11/26,ccc_fpb_script,0,0,00:00:00,0,00:00:00,0,0
2016-11-26-ccc_help_script,2016/11/26,ccc_help_script,5,5,00:00:13,13,00:00:37,0,65
2016-11-26-ccc_link_script,2016/11/26,ccc_link_script,0,0,00:00:00,0,00:00:00,0,0
2016-11-26-ccc_media_line_script,2016/11/26,ccc_media_line_script,0,0,00:00:00,0,00:00:00,0,0
2016-11-26-ccc_priority_script,2016/11/26,ccc_priority_script,26,26,00:00:07,7,00:00:16,0,182
2016-11-26-ccc_tax_script,2016/11/26,ccc_tax_script,0,0,00:00:00,0,00:00:00,0,0
2016-11-26-ccc_waste_recycling_script,2016/11/26,ccc_waste_recycling_script,0,0,00:00:00,0,00:00:00,0,0
2016-11-27-ccc_311_calgary_script,2016/11/27,ccc_311_calgary_script,651,639,00:00:11,11,00:05:21,12,7029
2016-11-27-ccc_311_lobby_ph_script,2016/11/27,ccc_311_lobby_ph_script,0,0,00:00:00,0,00:00:00,0,0
2016-11-27-ccc_aserv_info_script,2016/11/27,ccc_aserv_info_script,0,0,00:00:00,0,00:00:00,0,0
2016-11-27-ccc_bylaw_script,2016/11/27,ccc_bylaw_script,0,0,00:00:00,0,00:00:00,0,0
2016-11-27-ccc_city_script,2016/11/27,ccc_city_script,0,0,00:00:00,0,00:00:00,0,0
2016-11-27-ccc_cty_online_script,2016/11/27,ccc_cty_online_script,0,0,00:00:00,0,00:00:00,0,0
2016-11-27-ccc_feedback_script,2016/11/27,ccc_feedback_script,0,0,00:00:00,0,00:00:00,0,0
2016-11-27-ccc_fpb_script,2016/11/27,ccc_fpb_script,1,1,00:00:03,3,00:00:03,0,3
2016-11-27-ccc_help_script,2016/11/27,ccc_help_script,2,2,00:00:03,3,00:00:04,0,6
2016-11-27-ccc_link_script,2016/11/27,ccc_link_script,0,0,00:00:00,0,00:00:00,0,0
2016-11-27-ccc_media_line_script,2016/11/27,ccc_media_line_script,4,4,00:00:11,11,00:00:19,0,44
2016-11-27-ccc_priority_script,2016/11/27,ccc_priority_script,22,20,00:00:10,10,00:01:14,2,200
2016-11-27-ccc_tax_script,2016/11/27,ccc_tax_script,0,0,00:00:00,0,00:00:00,0,0
2016-11-27-ccc_waste_recycling_script,2016/11/27,ccc_waste_recycling_script,0,0,00:00:00,0,00:00:00,0,0
2016-11-28-ccc_311_calgary_script,2016/11/28,ccc_311_calgary_script,2964,2887,00:00:16,16,00:04:17,77,46192
2016-11-28-ccc_311_lobby_ph_script,2016/11/28,ccc_311_lobby_ph_script,0,0,00:00:00,0,00:00:00,0,0
2016-11-28-ccc_aserv_info_script,2016/11/28,ccc_aserv_info_script,0,0,00:00:00,0,00:00:00,0,0
2016-11-28-ccc_bylaw_script,2016/11/28,ccc_bylaw_script,0,0,00:00:00,0,00:00:00,0,0
2016-11-28-ccc_city_script,2016/11/28,ccc_city_script,19,18,00:00:09,9,00:00:28,1,162
2016-11-28-ccc_cty_online_script,2016/11/28,ccc_cty_online_script,0,0,00:00:00,0,00:00:00,0,0
2016-11-28-ccc_feedback_script,2016/11/28,ccc_feedback_script,0,0,00:00:00,0,00:00:00,0,0
2016-11-28-ccc_fpb_script,2016/11/28,ccc_fpb_script,1,1,00:00:52,52,00:00:52,0,52
2016-11-28-ccc_help_script,2016/11/28,ccc_help_script,6,6,00:00:16,16,00:01:04,0,96
2016-11-28-ccc_link_script,2016/11/28,ccc_link_script,0,0,00:00:00,0,00:00:00,0,0
2016-11-28-ccc_media_line_script,2016/11/28,ccc_media_line_script,0,0,00:00:00,0,00:00:00,0,0
2016-11-28-ccc_priority_script,2016/11/28,ccc_priority_script,35,35,00:00:11,11,00:00:54,0,385
2016-11-28-ccc_tax_script,2016/11/28,ccc_tax_script,17,17,00:00:08,8,00:00:22,0,136
2016-11-28-ccc_waste_recycling_script,2016/11/28,ccc_waste_recycling_script,0,0,00:00:00,0,00:00:00,0,0
2016-11-29-ccc_311_calgary_script,2016/11/29,ccc_311_calgary_script,2714,2562,00:00:56,56,00:06:02,152,143472
2016-11-29-ccc_311_lobby_ph_script,2016/11/29,ccc_311_lobby_ph_script,2,2,00:00:40,40,00:00:42,0,80
2016-11-29-ccc_aserv_info_script,2016/11/29,ccc_aserv_info_script,0,0,00:00:00,0,00:00:00,0,0
2016-11-29-ccc_bylaw_script,2016/11/29,ccc_bylaw_script,0,0,00:00:00,0,00:00:00,0,0
2016-11-29-ccc_city_script,2016/11/29,ccc_city_script,15,14,00:00:16,16,00:00:58,1,224
2016-11-29-ccc_cty_online_script,2016/11/29,ccc_cty_online_script,0,0,00:00:00,0,00:00:00,0,0
2016-11-29-ccc_feedback_script,2016/11/29,ccc_feedback_script,0,0,00:00:00,0,00:00:00,0,0
2016-11-29-ccc_fpb_script,2016/11/29,ccc_fpb_script,0,0,00:00:00,0,00:00:00,0,0
2016-11-29-ccc_help_script,2016/11/29,ccc_help_script,7,7,00:00:06,6,00:00:17,0,42
2016-11-29-ccc_link_script,2016/11/29,ccc_link_script,0,0,00:00:00,0,00:00:00,0,0
2016-11-29-ccc_media_line_script,2016/11/29,ccc_media_line_script,0,0,00:00:00,0,00:00:00,0,0
2016-11-29-ccc_priority_script,2016/11/29,ccc_priority_script,21,20,00:00:07,7,00:00:16,1,140
2016-11-29-ccc_tax_script,2016/11/29,ccc_tax_script,37,35,00:01:14,74,00:04:37,2,2590
2016-11-29-ccc_waste_recycling_script,2016/11/29,ccc_waste_recycling_script,0,0,00:00:00,0,00:00:00,0,0
2016-11-30-ccc_311_calgary_script,2016/11/30,ccc_311_calgary_script,2573,2496,00:00:25,25,00:11:23,77,62400
2016-11-30-ccc_311_lobby_ph_script,2016/11/30,ccc_311_lobby_ph_script,2,2,00:00:05,5,00:00:05,0,10
2016-11-30-ccc_aserv_info_script,2016/11/30,ccc_aserv_info_script,0,0,00:00:00,0,00:00:00,0,0
2016-11-30-ccc_bylaw_script,2016/11/30,ccc_bylaw_script,0,0,00:00:00,0,00:00:00,0,0
2016-11-30-ccc_city_script,2016/11/30,ccc_city_script,13,12,00:00:08,8,00:00:42,1,96
2016-11-30-ccc_cty_online_script,2016/11/30,ccc_cty_online_script,0,0,00:00:00,0,00:00:00,0,0
2016-11-30-ccc_feedback_script,2016/11/30,ccc_feedback_script,0,0,00:00:00,0,00:00:00,0,0
2016-11-30-ccc_fpb_script,2016/11/30,ccc_fpb_script,1,1,00:00:09,9,00:00:09,0,9
2016-11-30-ccc_help_script,2016/11/30,ccc_help_script,9,9,00:00:06,6,00:00:12,0,54
2016-11-30-ccc_link_script,2016/11/30,ccc_link_script,0,0,00:00:00,0,00:00:00,0,0
2016-11-30-ccc_media_line_script,2016/11/30,ccc_media_line_script,5,5,00:00:17,17,00:01:06,0,85
2016-11-30-ccc_priority_script,2016/11/30,ccc_priority_script,29,29,00:00:11,11,00:01:37,0,319
2016-11-30-ccc_tax_script,2016/11/30,ccc_tax_script,20,20,00:00:29,29,00:02:14,0,580
2016-11-30-ccc_waste_recycling_script,2016/11/30,ccc_waste_recycling_script,0,0,00:00:00,0,00:00:00,0,0
2016-12-01-ccc_311_calgary_script,2016/12/01,ccc_311_calgary_script,2692,2553,00:00:41,41,00:12:12,139,104673
2016-12-01-ccc_311_lobby_ph_script,2016/12/01,ccc_311_lobby_ph_script,5,4,00:00:03,3,00:00:06,1,12
2016-12-01-ccc_aserv_info_script,2016/12/01,ccc_aserv_info_script,0,0,00:00:00,0,00:00:00,0,0
2016-12-01-ccc_bylaw_script,2016/12/01,ccc_bylaw_script,0,0,00:00:00,0,00:00:00,0,0
2016-12-01-ccc_city_script,2016/12/01,ccc_city_script,8,8,00:00:11,11,00:00:26,0,88
2016-12-01-ccc_cty_online_script,2016/12/01,ccc_cty_online_script,0,0,00:00:00,0,00:00:00,0,0
2016-12-01-ccc_feedback_script,2016/12/01,ccc_feedback_script,0,0,00:00:00,0,00:00:00,0,0
2016-12-01-ccc_fpb_script,2016/12/01,ccc_fpb_script,0,0,00:00:00,0,00:00:00,0,0
2016-12-01-ccc_help_script,2016/12/01,ccc_help_script,9,9,00:00:11,11,00:00:21,0,99
2016-12-01-ccc_link_script,2016/12/01,ccc_link_script,0,0,00:00:00,0,00:00:00,0,0
2016-12-01-ccc_media_line_script,2016/12/01,ccc_media_line_script,1,1,00:00:08,8,00:00:08,0,8
2016-12-01-ccc_priority_script,2016/12/01,ccc_priority_script,24,24,00:00:10,10,00:00:34,0,240
2016-12-01-ccc_tax_script,2016/12/01,ccc_tax_script,22,21,00:00:31,31,00:03:12,1,651
2016-12-01-ccc_waste_recycling_script,2016/12/01,ccc_waste_recycling_script,0,0,00:00:00,0,00:00:00,0,0
2016-12-02-ccc_311_calgary_script,2016/12/02,ccc_311_calgary_script,2514,2394,00:00:37,37,00:06:00,120,88578
2016-12-02-ccc_311_lobby_ph_script,2016/12/02,ccc_311_lobby_ph_script,1,1,00:00:02,2,00:00:02,0,2
2016-12-02-ccc_aserv_info_script,2016/12/02,ccc_aserv_info_script,0,0,00:00:00,0,00:00:00,0,0
2016-12-02-ccc_bylaw_script,2016/12/02,ccc_bylaw_script,0,0,00:00:00,0,00:00:00,0,0
2016-12-02-ccc_city_script,2016/12/02,ccc_city_script,4,4,00:00:32,32,00:01:55,0,128
2016-12-02-ccc_cty_online_script,2016/12/02,ccc_cty_online_script,0,0,00:00:00,0,00:00:00,0,0
2016-12-02-ccc_feedback_script,2016/12/02,ccc_feedback_script,0,0,00:00:00,0,00:00:00,0,0
2016-12-02-ccc_fpb_script,2016/12/02,ccc_fpb_script,0,0,00:00:00,0,00:00:00,0,0
2016-12-02-ccc_help_script,2016/12/02,ccc_help_script,12,11,00:00:12,12,00:00:51,1,132
2016-12-02-ccc_link_script,2016/12/02,ccc_link_script,0,0,00:00:00,0,00:00:00,0,0
2016-12-02-ccc_media_line_script,2016/12/02,ccc_media_line_script,0,0,00:00:00,0,00:00:00,0,0
2016-12-02-ccc_priority_script,2016/12/02,ccc_priority_script,32,30,00:00:08,8,00:00:40,2,240
2016-12-02-ccc_tax_script,2016/12/02,ccc_tax_script,22,22,00:00:40,40,00:01:46,0,880
2016-12-02-ccc_waste_recycling_script,2016/12/02,ccc_waste_recycling_script,0,0,00:00:00,0,00:00:00,0,0
2016-12-03-ccc_311_calgary_script,2016/12/03,ccc_311_calgary_script,915,891,00:00:15,15,00:04:40,24,13365
2016-12-03-ccc_311_lobby_ph_script,2016/12/03,ccc_311_lobby_ph_script,0,0,00:00:00,0,00:00:00,0,0
2016-12-03-ccc_aserv_info_script,2016/12/03,ccc_aserv_info_script,0,0,00:00:00,0,00:00:00,0,0
2016-12-03-ccc_bylaw_script,2016/12/03,ccc_bylaw_script,0,0,00:00:00,0,00:00:00,0,0
2016-12-03-ccc_city_script,2016/12/03,ccc_city_script,0,0,00:00:00,0,00:00:00,0,0
2016-12-03-ccc_cty_online_script,2016/12/03,ccc_cty_online_script,0,0,00:00:00,0,00:00:00,0,0
2016-12-03-ccc_feedback_script,2016/12/03,ccc_feedback_script,0,0,00:00:00,0,00:00:00,0,0
2016-12-03-ccc_fpb_script,2016/12/03,ccc_fpb_script,0,0,00:00:00,0,00:00:00,0,0
2016-12-03-ccc_help_script,2016/12/03,ccc_help_script,13,13,00:00:08,8,00:00:25,0,104
2016-12-03-ccc_link_script,2016/12/03,ccc_link_script,0,0,00:00:00,0,00:00:00,0,0
2016-12-03-ccc_media_line_script,2016/12/03,ccc_media_line_script,2,2,00:00:08,8,00:00:10,0,16
2016-12-03-ccc_priority_script,2016/12/03,ccc_priority_script,20,20,00:00:09,9,00:01:10,0,180
2016-12-03-ccc_tax_script,2016/12/03,ccc_tax_script,0,0,00:00:00,0,00:00:00,0,0
2016-12-03-ccc_waste_recycling_script,2016/12/03,ccc_waste_recycling_script,0,0,00:00:00,0,00:00:00,0,0
2016-12-04-ccc_311_calgary_script,2016/12/04,ccc_311_calgary_script,697,693,00:00:09,9,00:02:49,4,6237
2016-12-04-ccc_311_lobby_ph_script,2016/12/04,ccc_311_lobby_ph_script,0,0,00:00:00,0,00:00:00,0,0
2016-12-04-ccc_aserv_info_script,2016/12/04,ccc_aserv_info_script,0,0,00:00:00,0,00:00:00,0,0
2016-12-04-ccc_bylaw_script,2016/12/04,ccc_bylaw_script,0,0,00:00:00,0,00:00:00,0,0
2016-12-04-ccc_city_script,2016/12/04,ccc_city_script,0,0,00:00:00,0,00:00:00,0,0
2016-12-04-ccc_cty_online_script,2016/12/04,ccc_cty_online_script,0,0,00:00:00,0,00:00:00,0,0
2016-12-04-ccc_feedback_script,2016/12/04,ccc_feedback_script,0,0,00:00:00,0,00:00:00,0,0
2016-12-04-ccc_fpb_script,2016/12/04,ccc_fpb_script,0,0,00:00:00,0,00:00:00,0,0
2016-12-04-ccc_help_script,2016/12/04,ccc_help_script,1,1,00:00:05,5,00:00:05,0,5
2016-12-04-ccc_link_script,2016/12/04,ccc_link_script,0,0,00:00:00,0,00:00:00,0,0
2016-12-04-ccc_media_line_script,2016/12/04,ccc_media_line_script,2,2,00:00:03,3,00:00:03,0,6
2016-12-04-ccc_priority_script,2016/12/04,ccc_priority_script,27,26,00:00:06,6,00:00:17,1,156
2016-12-04-ccc_tax_script,2016/12/04,ccc_tax_script,0,0,00:00:00,0,00:00:00,0,0
2016-12-04-ccc_waste_recycling_script,2016/12/04,ccc_waste_recycling_script,0,0,00:00:00,0,00:00:00,0,0
2016-12-05-ccc_311_calgary_script,2016/12/05,ccc_311_calgary_script,2675,2619,00:00:18,18,00:03:34,56,47142
2016-12-05-ccc_311_lobby_ph_script,2016/12/05,ccc_311_lobby_ph_script,2,2,00:00:08,8,00:00:09,0,16
2016-12-05-ccc_aserv_info_script,2016/12/05,ccc_aserv_info_script,0,0,00:00:00,0,00:00:00,0,0
2016-12-05-ccc_bylaw_script,2016/12/05,ccc_bylaw_script,0,0,00:00:00,0,00:00:00,0,0
2016-12-05-ccc_city_script,2016/12/05,ccc_city_script,13,13,00:00:10,10,00:00:35,0,130
2016-12-05-ccc_cty_online_script,2016/12/05,ccc_cty_online_script,0,0,00:00:00,0,00:00:00,0,0
2016-12-05-ccc_feedback_script,2016/12/05,ccc_feedback_script,0,0,00:00:00,0,00:00:00,0,0
2016-12-05-ccc_fpb_script,2016/12/05,ccc_fpb_script,0,0,00:00:00,0,00:00:00,0,0
2016-12-05-ccc_help_script,2016/12/05,ccc_help_script,16,15,00:00:07,7,00:00:12,1,105
2016-12-05-ccc_link_script,2016/12/05,ccc_link_script,0,0,00:00:00,0,00:00:00,0,0
2016-12-05-ccc_media_line_script,2016/12/05,ccc_media_line_script,1,1,00:00:07,7,00:00:07,0,7
2016-12-05-ccc_priority_script,2016/12/05,ccc_priority_script,25,25,00:00:09,9,00:00:35,0,225
2016-12-05-ccc_tax_script,2016/12/05,ccc_tax_script,16,16,00:00:14,14,00:01:23,0,224
2016-12-05-ccc_waste_recycling_script,2016/12/05,ccc_waste_recycling_script,0,0,00:00:00,0,00:00:00,0,0
2016-12-06-ccc_311_calgary_script,2016/12/06,ccc_311_calgary_script,2473,2403,00:00:19,19,00:07:13,70,45657
2016-12-06-ccc_311_lobby_ph_script,2016/12/06,ccc_311_lobby_ph_script,3,3,00:00:10,10,00:00:15,0,30
2016-12-06-ccc_aserv_info_script,2016/12/06,ccc_aserv_info_script,0,0,00:00:00,0,00:00:00,0,0
2016-12-06-ccc_bylaw_script,2016/12/06,ccc_bylaw_script,0,0,00:00:00,0,00:00:00,0,0
2016-12-06-ccc_city_script,2016/12/06,ccc_city_script,22,22,00:00:08,8,00:00:20,0,176
2016-12-06-ccc_cty_online_script,2016/12/06,ccc_cty_online_script,0,0,00:00:00,0,00:00:00,0,0
2016-12-06-ccc_feedback_script,2016/12/06,ccc_feedback_script,0,0,00:00:00,0,00:00:00,0,0
2016-12-06-ccc_fpb_script,2016/12/06,ccc_fpb_script,0,0,00:00:00,0,00:00:00,0,0
2016-12-06-ccc_help_script,2016/12/06,ccc_help_script,18,17,00:00:09,9,00:00:34,1,153
2016-12-06-ccc_link_script,2016/12/06,ccc_link_script,0,0,00:00:00,0,00:00:00,0,0
2016-12-06-ccc_media_line_script,2016/12/06,ccc_media_line_script,2,2,00:00:19,19,00:00:35,0,38
2016-12-06-ccc_priority_script,2016/12/06,ccc_priority_script,32,32,00:00:11,11,00:00:47,0,352
2016-12-06-ccc_tax_script,2016/12/06,ccc_tax_script,22,21,00:00:26,26,00:01:29,1,546
2016-12-06-ccc_waste_recycling_script,2016/12/06,ccc_waste_recycling_script,0,0,00:00:00,0,00:00:00,0,0
2016-12-07-ccc_311_calgary_script,2016/12/07,ccc_311_calgary_script,2511,2465,00:00:19,19,00:04:42,46,46835
2016-12-07-ccc_311_lobby_ph_script,2016/12/07,ccc_311_lobby_ph_script,2,1,00:00:03,3,00:00:03,1,3
2016-12-07-ccc_aserv_info_script,2016/12/07,ccc_aserv_info_script,0,0,00:00:00,0,00:00:00,0,0
2016-12-07-ccc_bylaw_script,2016/12/07,ccc_bylaw_script,0,0,00:00:00,0,00:00:00,0,0
2016-12-07-ccc_city_script,2016/12/07,ccc_city_script,25,23,00:00:09,9,00:00:44,2,207
2016-12-07-ccc_cty_online_script,2016/12/07,ccc_cty_online_script,0,0,00:00:00,0,00:00:00,0,0
2016-12-07-ccc_feedback_script,2016/12/07,ccc_feedback_script,0,0,00:00:00,0,00:00:00,0,0
2016-12-07-ccc_fpb_script,2016/12/07,ccc_fpb_script,3,2,00:00:40,40,00:01:08,1,80
2016-12-07-ccc_help_script,2016/12/07,ccc_help_script,28,28,00:00:07,7,00:00:19,0,196
2016-12-07-ccc_link_script,2016/12/07,ccc_link_script,0,0,00:00:00,0,00:00:00,0,0
2016-12-07-ccc_media_line_script,2016/12/07,ccc_media_line_script,1,1,00:00:06,6,00:00:06,0,6
2016-12-07-ccc_priority_script,2016/12/07,ccc_priority_script,43,43,00:00:08,8,00:00:40,0,344
2016-12-07-ccc_tax_script,2016/12/07,ccc_tax_script,21,21,00:00:20,20,00:03:18,0,420
2016-12-07-ccc_waste_recycling_script,2016/12/07,ccc_waste_recycling_script,0,0,00:00:00,0,00:00:00,0,0
2016-12-08-ccc_311_calgary_script,2016/12/08,ccc_311_calgary_script,2345,2286,00:00:20,20,00:05:59,59,45720
2016-12-08-ccc_311_lobby_ph_script,2016/12/08,ccc_311_lobby_ph_script,1,1,00:00:07,7,00:00:07,0,7
2016-12-08-ccc_aserv_info_script,2016/12/08,ccc_aserv_info_script,0,0,00:00:00,0,00:00:00,0,0
2016-12-08-ccc_bylaw_script,2016/12/08,ccc_bylaw_script,0,0,00:00:00,0,00:00:00,0,0
2016-12-08-ccc_city_script,2016/12/08,ccc_city_script,20,20,00:00:08,8,00:00:31,0,160
2016-12-08-ccc_cty_online_script,2016/12/08,ccc_cty_online_script,0,0,00:00:00,0,00:00:00,0,0
2016-12-08-ccc_feedback_script,2016/12/08,ccc_feedback_script,0,0,00:00:00,0,00:00:00,0,0
2016-12-08-ccc_fpb_script,2016/12/08,ccc_fpb_script,0,0,00:00:00,0,00:00:00,0,0
2016-12-08-ccc_help_script,2016/12/08,ccc_help_script,34,33,00:00:07,7,00:00:36,1,231
2016-12-08-ccc_link_script,2016/12/08,ccc_link_script,0,0,00:00:00,0,00:00:00,0,0
2016-12-08-ccc_media_line_script,2016/12/08,ccc_media_line_script,0,0,00:00:00,0,00:00:00,0,0
2016-12-08-ccc_priority_script,2016/12/08,ccc_priority_script,37,37,00:00:07,7,00:00:38,0,259
2016-12-08-ccc_tax_script,2016/12/08,ccc_tax_script,17,17,00:00:32,32,00:02:38,0,544
2016-12-08-ccc_waste_recycling_script,2016/12/08,ccc_waste_recycling_script,0,0,00:00:00,0,00:00:00,0,0
2016-12-09-ccc_311_calgary_script,2016/12/09,ccc_311_calgary_script,2109,2075,00:00:12,12,00:06:08,34,24900
2016-12-09-ccc_311_lobby_ph_script,2016/12/09,ccc_311_lobby_ph_script,1,1,00:00:14,14,00:00:14,0,14
2016-12-09-ccc_aserv_info_script,2016/12/09,ccc_aserv_info_script,0,0,00:00:00,0,00:00:00,0,0
2016-12-09-ccc_bylaw_script,2016/12/09,ccc_bylaw_script,0,0,00:00:00,0,00:00:00,0,0
2016-12-09-ccc_city_script,2016/12/09,ccc_city_script,14,14,00:00:05,5,00:00:12,0,70
2016-12-09-ccc_cty_online_script,2016/12/09,ccc_cty_online_script,0,0,00:00:00,0,00:00:00,0,0
2016-12-09-ccc_feedback_script,2016/12/09,ccc_feedback_script,0,0,00:00:00,0,00:00:00,0,0
2016-12-09-ccc_fpb_script,2016/12/09,ccc_fpb_script,1,1,00:00:21,21,00:00:21,0,21
2016-12-09-ccc_help_script,2016/12/09,ccc_help_script,23,22,00:00:08,8,00:00:37,1,176
2016-12-09-ccc_link_script,2016/12/09,ccc_link_script,0,0,00:00:00,0,00:00:00,0,0
2016-12-09-ccc_media_line_script,2016/12/09,ccc_media_line_script,1,1,00:00:09,9,00:00:09,0,9
2016-12-09-ccc_priority_script,2016/12/09,ccc_priority_script,42,42,00:00:08,8,00:00:17,0,336
2016-12-09-ccc_tax_script,2016/12/09,ccc_tax_script,15,14,00:00:06,6,00:00:09,1,84
2016-12-09-ccc_waste_recycling_script,2016/12/09,ccc_waste_recycling_script,0,0,00:00:00,0,00:00:00,0,0
2016-12-10-ccc_311_calgary_script,2016/12/10,ccc_311_calgary_script,927,912,00:00:13,13,00:08:03,11,11856
2016-12-10-ccc_311_lobby_ph_script,2016/12/10,ccc_311_lobby_ph_script,0,0,00:00:00,0,00:00:00,0,0
2016-12-10-ccc_aserv_info_script,2016/12/10,ccc_aserv_info_script,0,0,00:00:00,0,00:00:00,0,0
2016-12-10-ccc_bylaw_script,2016/12/10,ccc_bylaw_script,0,0,00:00:00,0,00:00:00,0,0
2016-12-10-ccc_city_script,2016/12/10,ccc_city_script,0,0,00:00:00,0,00:00:00,0,0
2016-12-10-ccc_cty_online_script,2016/12/10,ccc_cty_online_script,0,0,00:00:00,0,00:00:00,0,0
2016-12-10-ccc_feedback_script,2016/12/10,ccc_feedback_script,0,0,00:00:00,0,00:00:00,0,0
2016-12-10-ccc_fpb_script,2016/12/10,ccc_fpb_script,0,0,00:00:00,0,00:00:00,0,0
2016-12-10-ccc_help_script,2016/12/10,ccc_help_script,11,11,00:00:05,5,00:00:08,0,55
2016-12-10-ccc_link_script,2016/12/10,ccc_link_script,0,0,00:00:00,0,00:00:00,0,0
2016-12-10-ccc_media_line_script,2016/12/10,ccc_media_line_script,2,2,00:00:26,26,00:00:47,0,52
2016-12-10-ccc_priority_script,2016/12/10,ccc_priority_script,39,37,00:00:25,25,00:03:24,2,925
2016-12-10-ccc_tax_script,2016/12/10,ccc_tax_script,2,2,00:00:15,15,00:00:20,0,30
2016-12-10-ccc_waste_recycling_script,2016/12/10,ccc_waste_recycling_script,0,0,00:00:00,0,00:00:00,0,0
2016-12-11-ccc_311_calgary_script,2016/12/11,ccc_311_calgary_script,708,697,00:00:12,12,00:06:00,15,8364
2016-12-11-ccc_311_lobby_ph_script,2016/12/11,ccc_311_lobby_ph_script,0,0,00:00:00,0,00:00:00,0,0
2016-12-11-ccc_aserv_info_script,2016/12/11,ccc_aserv_info_script,0,0,00:00:00,0,00:00:00,0,0
2016-12-11-ccc_bylaw_script,2016/12/11,ccc_bylaw_script,0,0,00:00:00,0,00:00:00,0,0
2016-12-11-ccc_city_script,2016/12/11,ccc_city_script,0,0,00:00:00,0,00:00:00,0,0
2016-12-11-ccc_cty_online_script,2016/12/11,ccc_cty_online_script,0,0,00:00:00,0,00:00:00,0,0
2016-12-11-ccc_feedback_script,2016/12/11,ccc_feedback_script,0,0,00:00:00,0,00:00:00,0,0
2016-12-11-ccc_fpb_script,2016/12/11,ccc_fpb_script,0,0,00:00:00,0,00:00:00,0,0
2016-12-11-ccc_help_script,2016/12/11,ccc_help_script,6,6,00:00:47,47,00:04:14,0,282
2016-12-11-ccc_link_script,2016/12/11,ccc_link_script,0,0,00:00:00,0,00:00:00,0,0
2016-12-11-ccc_media_line_script,2016/12/11,ccc_media_line_script,1,1,00:00:06,6,00:00:06,0,6
2016-12-11-ccc_priority_script,2016/12/11,ccc_priority_script,16,16,00:00:06,6,00:00:15,0,96
2016-12-11-ccc_tax_script,2016/12/11,ccc_tax_script,2,2,00:00:07,7,00:00:07,0,14
2016-12-11-ccc_waste_recycling_script,2016/12/11,ccc_waste_recycling_script,0,0,00:00:00,0,00:00:00,0,0
2016-12-12-ccc_311_calgary_script,2016/12/12,ccc_311_calgary_script,2506,2446,00:00:19,19,00:04:27,59,46474
2016-12-12-ccc_311_lobby_ph_script,2016/12/12,ccc_311_lobby_ph_script,1,1,00:00:07,7,00:00:07,0,7
2016-12-12-ccc_aserv_info_script,2016/12/12,ccc_aserv_info_script,0,0,00:00:00,0,00:00:00,0,0
2016-12-12-ccc_bylaw_script,2016/12/12,ccc_bylaw_script,0,0,00:00:00,0,00:00:00,0,0
2016-12-12-ccc_city_script,2016/12/12,ccc_city_script,7,7,00:00:11,11,00:00:57,0,77
2016-12-12-ccc_cty_online_script,2016/12/12,ccc_cty_online_script,0,0,00:00:00,0,00:00:00,0,0
2016-12-12-ccc_feedback_script,2016/12/12,ccc_feedback_script,0,0,00:00:00,0,00:00:00,0,0
2016-12-12-ccc_fpb_script,2016/12/12,ccc_fpb_script,0,0,00:00:00,0,00:00:00,0,0
2016-12-12-ccc_help_script,2016/12/12,ccc_help_script,13,13,00:00:07,7,00:00:33,0,91
2016-12-12-ccc_link_script,2016/12/12,ccc_link_script,0,0,00:00:00,0,00:00:00,0,0
2016-12-12-ccc_media_line_script,2016/12/12,ccc_media_line_script,0,0,00:00:00,0,00:00:00,0,0
2016-12-12-ccc_priority_script,2016/12/12,ccc_priority_script,28,28,00:00:10,10,00:00:35,0,280
2016-12-12-ccc_tax_script,2016/12/12,ccc_tax_script,20,19,00:00:15,15,00:02:58,1,285
2016-12-12-ccc_waste_recycling_script,2016/12/12,ccc_waste_recycling_script,0,0,00:00:00,0,00:00:00,0,0
2016-12-13-ccc_311_calgary_script,2016/12/13,ccc_311_calgary_script,2311,2240,00:00:20,20,00:06:25,72,44800
2016-12-13-ccc_311_lobby_ph_script,2016/12/13,ccc_311_lobby_ph_script,3,3,00:00:13,13,00:00:19,0,39
2016-12-13-ccc_aserv_info_script,2016/12/13,ccc_aserv_info_script,0,0,00:00:00,0,00:00:00,0,0
2016-12-13-ccc_bylaw_script,2016/12/13,ccc_bylaw_script,0,0,00:00:00,0,00:00:00,0,0
2016-12-13-ccc_city_script,2016/12/13,ccc_city_script,11,11,00:00:07,7,00:00:23,0,77
2016-12-13-ccc_cty_online_script,2016/12/13,ccc_cty_online_script,0,0,00:00:00,0,00:00:00,0,0
2016-12-13-ccc_feedback_script,2016/12/13,ccc_feedback_script,1,0,00:00:00,0,00:00:00,0,0
2016-12-13-ccc_fpb_script,2016/12/13,ccc_fpb_script,0,0,00:00:00,0,00:00:00,0,0
2016-12-13-ccc_help_script,2016/12/13,ccc_help_script,10,10,00:00:12,12,00:00:44,0,120
2016-12-13-ccc_link_script,2016/12/13,ccc_link_script,0,0,00:00:00,0,00:00:00,0,0
2016-12-13-ccc_media_line_script,2016/12/13,ccc_media_line_script,0,0,00:00:00,0,00:00:00,0,0
2016-12-13-ccc_priority_script,2016/12/13,ccc_priority_script,26,26,00:00:11,11,00:01:59,0,286
2016-12-13-ccc_tax_script,2016/12/13,ccc_tax_script,13,13,00:00:19,19,00:02:42,0,247
2016-12-13-ccc_waste_recycling_script,2016/12/13,ccc_waste_recycling_script,0,0,00:00:00,0,00:00:00,0,0
2016-12-14-ccc_311_calgary_script,2016/12/14,ccc_311_calgary_script,2328,2226,00:00:34,34,00:03:34,102,75684
2016-12-14-ccc_311_lobby_ph_script,2016/12/14,ccc_311_lobby_ph_script,4,2,00:00:08,8,00:00:13,2,16
2016-12-14-ccc_aserv_info_script,2016/12/14,ccc_aserv_info_script,0,0,00:00:00,0,00:00:00,0,0
2016-12-14-ccc_bylaw_script,2016/12/14,ccc_bylaw_script,0,0,00:00:00,0,00:00:00,0,0
2016-12-14-ccc_city_script,2016/12/14,ccc_city_script,8,7,00:00:07,7,00:00:17,1,49
2016-12-14-ccc_cty_online_script,2016/12/14,ccc_cty_online_script,0,0,00:00:00,0,00:00:00,0,0
2016-12-14-ccc_feedback_script,2016/12/14,ccc_feedback_script,0,0,00:00:00,0,00:00:00,0,0
2016-12-14-ccc_fpb_script,2016/12/14,ccc_fpb_script,0,0,00:00:00,0,00:00:00,0,0
2016-12-14-ccc_help_script,2016/12/14,ccc_help_script,12,12,00:00:10,10,00:00:35,0,120
2016-12-14-ccc_link_script,2016/12/14,ccc_link_script,0,0,00:00:00,0,00:00:00,0,0
2016-12-14-ccc_media_line_script,2016/12/14,ccc_media_line_script,1,1,00:00:03,3,00:00:03,0,3
2016-12-14-ccc_priority_script,2016/12/14,ccc_priority_script,27,26,00:00:07,7,00:00:17,1,182
2016-12-14-ccc_tax_script,2016/12/14,ccc_tax_script,25,25,00:00:43,43,00:02:53,0,1075
2016-12-14-ccc_waste_recycling_script,2016/12/14,ccc_waste_recycling_script,0,0,00:00:00,0,00:00:00,0,0
2016-12-15-ccc_311_calgary_script,2016/12/15,ccc_311_calgary_script,2271,2104,00:00:58,58,00:07:24,167,122032
2016-12-15-ccc_311_lobby_ph_script,2016/12/15,ccc_311_lobby_ph_script,4,4,00:00:21,21,00:01:02,0,84
2016-12-15-ccc_aserv_info_script,2016/12/15,ccc_aserv_info_script,0,0,00:00:00,0,00:00:00,0,0
2016-12-15-ccc_bylaw_script,2016/12/15,ccc_bylaw_script,0,0,00:00:00,0,00:00:00,0,0
2016-12-15-ccc_city_script,2016/12/15,ccc_city_script,18,18,00:00:23,23,00:02:25,0,414
2016-12-15-ccc_cty_online_script,2016/12/15,ccc_cty_online_script,0,0,00:00:00,0,00:00:00,0,0
2016-12-15-ccc_feedback_script,2016/12/15,ccc_feedback_script,0,0,00:00:00,0,00:00:00,0,0
2016-12-15-ccc_fpb_script,2016/12/15,ccc_fpb_script,0,0,00:00:00,0,00:00:00,0,0
2016-12-15-ccc_help_script,2016/12/15,ccc_help_script,13,13,00:00:13,13,00:00:40,0,169
2016-12-15-ccc_link_script,2016/12/15,ccc_link_script,0,0,00:00:00,0,00:00:00,0,0
2016-12-15-ccc_media_line_script,2016/12/15,ccc_media_line_script,0,0,00:00:00,0,00:00:00,0,0
2016-12-15-ccc_priority_script,2016/12/15,ccc_priority_script,31,30,00:00:13,13,00:01:33,1,390
2016-12-15-ccc_tax_script,2016/12/15,ccc_tax_script,21,20,00:01:20,80,00:04:55,1,1600
2016-12-15-ccc_waste_recycling_script,2016/12/15,ccc_waste_recycling_script,0,0,00:00:00,0,00:00:00,0,0
2016-12-16-ccc_311_calgary_script,2016/12/16,ccc_311_calgary_script,2001,1937,00:00:27,27,00:05:28,64,52299
2016-12-16-ccc_311_lobby_ph_script,2016/12/16,ccc_311_lobby_ph_script,2,1,00:00:02,2,00:00:02,1,2
2016-12-16-ccc_aserv_info_script,2016/12/16,ccc_aserv_info_script,0,0,00:00:00,0,00:00:00,0,0
2016-12-16-ccc_bylaw_script,2016/12/16,ccc_bylaw_script,0,0,00:00:00,0,00:00:00,0,0
2016-12-16-ccc_city_script,2016/12/16,ccc_city_script,5,4,00:00:09,9,00:00:12,1,36
2016-12-16-ccc_cty_online_script,2016/12/16,ccc_cty_online_script,0,0,00:00:00,0,00:00:00,0,0
2016-12-16-ccc_feedback_script,2016/12/16,ccc_feedback_script,0,0,00:00:00,0,00:00:00,0,0
2016-12-16-ccc_fpb_script,2016/12/16,ccc_fpb_script,1,1,00:00:02,2,00:00:02,0,2
2016-12-16-ccc_help_script,2016/12/16,ccc_help_script,11,11,00:00:07,7,00:00:10,0,77
2016-12-16-ccc_link_script,2016/12/16,ccc_link_script,0,0,00:00:00,0,00:00:00,0,0
2016-12-16-ccc_media_line_script,2016/12/16,ccc_media_line_script,1,1,00:00:04,4,00:00:04,0,4
2016-12-16-ccc_priority_script,2016/12/16,ccc_priority_script,41,39,00:00:10,10,00:01:12,2,390
2016-12-16-ccc_tax_script,2016/12/16,ccc_tax_script,35,29,00:00:45,45,00:04:44,6,1305
2016-12-16-ccc_waste_recycling_script,2016/12/16,ccc_waste_recycling_script,0,0,00:00:00,0,00:00:00,0,0
2016-12-17-ccc_311_calgary_script,2016/12/17,ccc_311_calgary_script,781,766,00:00:14,14,00:11:47,15,10724
2016-12-17-ccc_311_lobby_ph_script,2016/12/17,ccc_311_lobby_ph_script,0,0,00:00:00,0,00:00:00,0,0
2016-12-17-ccc_aserv_info_script,2016/12/17,ccc_aserv_info_script,0,0,00:00:00,0,00:00:00,0,0
2016-12-17-ccc_bylaw_script,2016/12/17,ccc_bylaw_script,0,0,00:00:00,0,00:00:00,0,0
2016-12-17-ccc_city_script,2016/12/17,ccc_city_script,0,0,00:00:00,0,00:00:00,0,0
2016-12-17-ccc_cty_online_script,2016/12/17,ccc_cty_online_script,0,0,00:00:00,0,00:00:00,0,0
2016-12-17-ccc_feedback_script,2016/12/17,ccc_feedback_script,0,0,00:00:00,0,00:00:00,0,0
2016-12-17-ccc_fpb_script,2016/12/17,ccc_fpb_script,0,0,00:00:00,0,00:00:00,0,0
2016-12-17-ccc_help_script,2016/12/17,ccc_help_script,9,9,00:00:10,10,00:00:20,0,90
2016-12-17-ccc_link_script,2016/12/17,ccc_link_script,0,0,00:00:00,0,00:00:00,0,0
2016-12-17-ccc_media_line_script,2016/12/17,ccc_media_line_script,0,0,00:00:00,0,00:00:00,0,0
2016-12-17-ccc_priority_script,2016/12/17,ccc_priority_script,9,9,00:00:09,9,00:00:40,0,81
2016-12-17-ccc_tax_script,2016/12/17,ccc_tax_script,0,0,00:00:00,0,00:00:00,0,0
2016-12-17-ccc_waste_recycling_script,2016/12/17,ccc_waste_recycling_script,0,0,00:00:00,0,00:00:00,0,0
2016-12-18-ccc_311_calgary_script,2016/12/18,ccc_311_calgary_script,721,704,00:00:18,18,00:05:12,16,12672
2016-12-18-ccc_311_lobby_ph_script,2016/12/18,ccc_311_lobby_ph_script,0,0,00:00:00,0,00:00:00,0,0
2016-12-18-ccc_aserv_info_script,2016/12/18,ccc_aserv_info_script,0,0,00:00:00,0,00:00:00,0,0
2016-12-18-ccc_bylaw_script,2016/12/18,ccc_bylaw_script,0,0,00:00:00,0,00:00:00,0,0
2016-12-18-ccc_city_script,2016/12/18,ccc_city_script,0,0,00:00:00,0,00:00:00,0,0
2016-12-18-ccc_cty_online_script,2016/12/18,ccc_cty_online_script,0,0,00:00:00,0,00:00:00,0,0
2016-12-18-ccc_feedback_script,2016/12/18,ccc_feedback_script,0,0,00:00:00,0,00:00:00,0,0
2016-12-18-ccc_fpb_script,2016/12/18,ccc_fpb_script,0,0,00:00:00,0,00:00:00,0,0
2016-12-18-ccc_help_script,2016/12/18,ccc_help_script,7,7,00:00:14,14,00:00:59,0,98
2016-12-18-ccc_link_script,2016/12/18,ccc_link_script,0,0,00:00:00,0,00:00:00,0,0
2016-12-18-ccc_media_line_script,2016/12/18,ccc_media_line_script,0,0,00:00:00,0,00:00:00,0,0
2016-12-18-ccc_priority_script,2016/12/18,ccc_priority_script,19,19,00:00:08,8,00:00:43,0,152
2016-12-18-ccc_tax_script,2016/12/18,ccc_tax_script,2,2,00:00:07,7,00:00:07,0,14
2016-12-18-ccc_waste_recycling_script,2016/12/18,ccc_waste_recycling_script,0,0,00:00:00,0,00:00:00,0,0
2016-12-19-ccc_311_calgary_script,2016/12/19,ccc_311_calgary_script,2402,2372,00:00:11,11,00:03:57,30,26092
2016-12-19-ccc_311_lobby_ph_script,2016/12/19,ccc_311_lobby_ph_script,1,1,00:00:02,2,00:00:02,0,2
2016-12-19-ccc_aserv_info_script,2016/12/19,ccc_aserv_info_script,0,0,00:00:00,0,00:00:00,0,0
2016-12-19-ccc_bylaw_script,2016/12/19,ccc_bylaw_script,0,0,00:00:00,0,00:00:00,0,0
2016-12-19-ccc_city_script,2016/12/19,ccc_city_script,37,37,00:00:08,8,00:00:27,0,296
2016-12-19-ccc_cty_online_script,2016/12/19,ccc_cty_online_script,0,0,00:00:00,0,00:00:00,0,0
2016-12-19-ccc_feedback_script,2016/12/19,ccc_feedback_script,0,0,00:00:00,0,00:00:00,0,0
2016-12-19-ccc_fpb_script,2016/12/19,ccc_fpb_script,1,1,00:00:02,2,00:00:02,0,2
2016-12-19-ccc_help_script,2016/12/19,ccc_help_script,9,9,00:00:06,6,00:00:14,0,54
2016-12-19-ccc_link_script,2016/12/19,ccc_link_script,0,0,00:00:00,0,00:00:00,0,0
2016-12-19-ccc_media_line_script,2016/12/19,ccc_media_line_script,0,0,00:00:00,0,00:00:00,0,0
2016-12-19-ccc_priority_script,2016/12/19,ccc_priority_script,25,25,00:00:06,6,00:00:19,0,150
2016-12-19-ccc_tax_script,2016/12/19,ccc_tax_script,10,10,00:00:05,5,00:00:14,0,50
2016-12-19-ccc_waste_recycling_script,2016/12/19,ccc_waste_recycling_script,0,0,00:00:00,0,00:00:00,0,0
2016-12-20-ccc_311_calgary_script,2016/12/20,ccc_311_calgary_script,2410,2282,00:00:40,40,00:04:57,128,91280
2016-12-20-ccc_311_lobby_ph_script,2016/12/20,ccc_311_lobby_ph_script,4,3,00:00:07,7,00:00:10,1,21
2016-12-20-ccc_aserv_info_script,2016/12/20,ccc_aserv_info_script,0,0,00:00:00,0,00:00:00,0,0
2016-12-20-ccc_bylaw_script,2016/12/20,ccc_bylaw_script,0,0,00:00:00,0,00:00:00,0,0
2016-12-20-ccc_city_script,2016/12/20,ccc_city_script,22,22,00:00:22,22,00:01:37,0,484
2016-12-20-ccc_cty_online_script,2016/12/20,ccc_cty_online_script,0,0,00:00:00,0,00:00:00,0,0
2016-12-20-ccc_feedback_script,2016/12/20,ccc_feedback_script,0,0,00:00:00,0,00:00:00,0,0
2016-12-20-ccc_fpb_script,2016/12/20,ccc_fpb_script,0,0,00:00:00,0,00:00:00,0,0
2016-12-20-ccc_help_script,2016/12/20,ccc_help_script,16,14,00:00:10,10,00:00:17,2,140
2016-12-20-ccc_link_script,2016/12/20,ccc_link_script,0,0,00:00:00,0,00:00:00,0,0
2016-12-20-ccc_media_line_script,2016/12/20,ccc_media_line_script,2,2,00:00:42,42,00:01:06,0,84
2016-12-20-ccc_priority_script,2016/12/20,ccc_priority_script,29,29,00:00:13,13,00:00:49,0,377
2016-12-20-ccc_tax_script,2016/12/20,ccc_tax_script,23,23,00:00:36,36,00:02:41,0,828
2016-12-20-ccc_waste_recycling_script,2016/12/20,ccc_waste_recycling_script,0,0,00:00:00,0,00:00:00,0,0
2016-12-21-ccc_311_calgary_script,2016/12/21,ccc_311_calgary_script,2153,2043,00:00:44,44,00:06:45,110,89892
2016-12-21-ccc_311_lobby_ph_script,2016/12/21,ccc_311_lobby_ph_script,4,4,00:00:04,4,00:00:05,0,16
2016-12-21-ccc_aserv_info_script,2016/12/21,ccc_aserv_info_script,0,0,00:00:00,0,00:00:00,0,0
2016-12-21-ccc_bylaw_script,2016/12/21,ccc_bylaw_script,0,0,00:00:00,0,00:00:00,0,0
2016-12-21-ccc_city_script,2016/12/21,ccc_city_script,19,19,00:00:22,22,00:03:29,0,418
2016-12-21-ccc_cty_online_script,2016/12/21,ccc_cty_online_script,0,0,00:00:00,0,00:00:00,0,0
2016-12-21-ccc_feedback_script,2016/12/21,ccc_feedback_script,0,0,00:00:00,0,00:00:00,0,0
2016-12-21-ccc_fpb_script,2016/12/21,ccc_fpb_script,0,0,00:00:00,0,00:00:00,0,0
2016-12-21-ccc_help_script,2016/12/21,ccc_help_script,11,10,00:00:06,6,00:00:11,1,60
2016-12-21-ccc_link_script,2016/12/21,ccc_link_script,0,0,00:00:00,0,00:00:00,0,0
2016-12-21-ccc_media_line_script,2016/12/21,ccc_media_line_script,0,0,00:00:00,0,00:00:00,0,0
2016-12-21-ccc_priority_script,2016/12/21,ccc_priority_script,15,14,00:00:08,8,00:00:18,1,112
2016-12-21-ccc_tax_script,2016/12/21,ccc_tax_script,27,25,00:00:30,30,00:04:25,2,750
2016-12-21-ccc_waste_recycling_script,2016/12/21,ccc_waste_recycling_script,0,0,00:00:00,0,00:00:00,0,0
2016-12-22-ccc_311_calgary_script,2016/12/22,ccc_311_calgary_script,2018,1981,00:00:17,17,00:05:47,37,33677
2016-12-22-ccc_311_lobby_ph_script,2016/12/22,ccc_311_lobby_ph_script,1,1,00:00:04,4,00:00:04,0,4
2016-12-22-ccc_aserv_info_script,2016/12/22,ccc_aserv_info_script,0,0,00:00:00,0,00:00:00,0,0
2016-12-22-ccc_bylaw_script,2016/12/22,ccc_bylaw_script,0,0,00:00:00,0,00:00:00,0,0
2016-12-22-ccc_city_script,2016/12/22,ccc_city_script,16,16,00:00:10,10,00:00:38,0,160
2016-12-22-ccc_cty_online_script,2016/12/22,ccc_cty_online_script,0,0,00:00:00,0,00:00:00,0,0
2016-12-22-ccc_feedback_script,2016/12/22,ccc_feedback_script,0,0,00:00:00,0,00:00:00,0,0
2016-12-22-ccc_fpb_script,2016/12/22,ccc_fpb_script,0,0,00:00:00,0,00:00:00,0,0
2016-12-22-ccc_help_script,2016/12/22,ccc_help_script,5,5,00:00:27,27,00:01:51,0,135
2016-12-22-ccc_link_script,2016/12/22,ccc_link_script,0,0,00:00:00,0,00:00:00,0,0
2016-12-22-ccc_media_line_script,2016/12/22,ccc_media_line_script,0,0,00:00:00,0,00:00:00,0,0
2016-12-22-ccc_priority_script,2016/12/22,ccc_priority_script,16,16,00:00:09,9,00:00:36,0,144
2016-12-22-ccc_tax_script,2016/12/22,ccc_tax_script,16,15,00:00:10,10,00:00:32,1,150
2016-12-22-ccc_waste_recycling_script,2016/12/22,ccc_waste_recycling_script,0,0,00:00:00,0,00:00:00,0,0
2016-12-23-ccc_311_calgary_script,2016/12/23,ccc_311_calgary_script,1612,1568,00:00:16,16,00:04:41,44,25088
2016-12-23-ccc_311_lobby_ph_script,2016/12/23,ccc_311_lobby_ph_script,1,1,00:00:08,8,00:00:08,0,8
2016-12-23-ccc_aserv_info_script,2016/12/23,ccc_aserv_info_script,0,0,00:00:00,0,00:00:00,0,0
2016-12-23-ccc_bylaw_script,2016/12/23,ccc_bylaw_script,0,0,00:00:00,0,00:00:00,0,0
2016-12-23-ccc_city_script,2016/12/23,ccc_city_script,6,6,00:00:06,6,00:00:20,0,36
2016-12-23-ccc_cty_online_script,2016/12/23,ccc_cty_online_script,0,0,00:00:00,0,00:00:00,0,0
2016-12-23-ccc_feedback_script,2016/12/23,ccc_feedback_script,0,0,00:00:00,0,00:00:00,0,0
2016-12-23-ccc_fpb_script,2016/12/23,ccc_fpb_script,0,0,00:00:00,0,00:00:00,0,0
2016-12-23-ccc_help_script,2016/12/23,ccc_help_script,27,26,00:00:13,13,00:01:21,1,338
2016-12-23-ccc_link_script,2016/12/23,ccc_link_script,0,0,00:00:00,0,00:00:00,0,0
2016-12-23-ccc_media_line_script,2016/12/23,ccc_media_line_script,0,0,00:00:00,0,00:00:00,0,0
2016-12-23-ccc_priority_script,2016/12/23,ccc_priority_script,36,36,00:00:06,6,00:00:15,0,216
2016-12-23-ccc_tax_script,2016/12/23,ccc_tax_script,20,20,00:00:23,23,00:03:48,0,460
2016-12-23-ccc_waste_recycling_script,2016/12/23,ccc_waste_recycling_script,0,0,00:00:00,0,00:00:00,0,0
2016-12-24-ccc_311_calgary_script,2016/12/24,ccc_311_calgary_script,1016,950,00:00:36,36,00:12:46,66,34200
2016-12-24-ccc_311_lobby_ph_script,2016/12/24,ccc_311_lobby_ph_script,0,0,00:00:00,0,00:00:00,0,0
2016-12-24-ccc_aserv_info_script,2016/12/24,ccc_aserv_info_script,0,0,00:00:00,0,00:00:00,0,0
2016-12-24-ccc_bylaw_script,2016/12/24,ccc_bylaw_script,0,0,00:00:00,0,00:00:00,0,0
2016-12-24-ccc_city_script,2016/12/24,ccc_city_script,0,0,00:00:00,0,00:00:00,0,0
2016-12-24-ccc_cty_online_script,2016/12/24,ccc_cty_online_script,0,0,00:00:00,0,00:00:00,0,0
2016-12-24-ccc_feedback_script,2016/12/24,ccc_feedback_script,0,0,00:00:00,0,00:00:00,0,0
2016-12-24-ccc_fpb_script,2016/12/24,ccc_fpb_script,0,0,00:00:00,0,00:00:00,0,0
2016-12-24-ccc_help_script,2016/12/24,ccc_help_script,15,12,00:00:23,23,00:01:06,3,276
2016-12-24-ccc_link_script,2016/12/24,ccc_link_script,0,0,00:00:00,0,00:00:00,0,0
2016-12-24-ccc_media_line_script,2016/12/24,ccc_media_line_script,4,4,00:00:16,16,00:00:36,0,64
2016-12-24-ccc_priority_script,2016/12/24,ccc_priority_script,32,30,00:00:10,10,00:01:02,2,300
2016-12-24-ccc_tax_script,2016/12/24,ccc_tax_script,0,0,00:00:00,0,00:00:00,0,0
2016-12-24-ccc_waste_recycling_script,2016/12/24,ccc_waste_recycling_script,0,0,00:00:00,0,00:00:00,0,0
2016-12-25-ccc_311_calgary_script,2016/12/25,ccc_311_calgary_script,478,460,00:00:17,17,00:04:55,18,7820
2016-12-25-ccc_311_lobby_ph_script,2016/12/25,ccc_311_lobby_ph_script,0,0,00:00:00,0,00:00:00,0,0
2016-12-25-ccc_aserv_info_script,2016/12/25,ccc_aserv_info_script,0,0,00:00:00,0,00:00:00,0,0
2016-12-25-ccc_bylaw_script,2016/12/25,ccc_bylaw_script,0,0,00:00:00,0,00:00:00,0,0
2016-12-25-ccc_city_script,2016/12/25,ccc_city_script,0,0,00:00:00,0,00:00:00,0,0
2016-12-25-ccc_cty_online_script,2016/12/25,ccc_cty_online_script,0,0,00:00:00,0,00:00:00,0,0
2016-12-25-ccc_feedback_script,2016/12/25,ccc_feedback_script,0,0,00:00:00,0,00:00:00,0,0
2016-12-25-ccc_fpb_script,2016/12/25,ccc_fpb_script,0,0,00:00:00,0,00:00:00,0,0
2016-12-25-ccc_help_script,2016/12/25,ccc_help_script,2,0,00:00:00,0,00:00:00,2,0
2016-12-25-ccc_link_script,2016/12/25,ccc_link_script,0,0,00:00:00,0,00:00:00,0,0
2016-12-25-ccc_media_line_script,2016/12/25,ccc_media_line_script,1,1,00:00:22,22,00:00:22,0,22
2016-12-25-ccc_priority_script,2016/12/25,ccc_priority_script,18,17,00:00:15,15,00:01:51,1,255
2016-12-25-ccc_tax_script,2016/12/25,ccc_tax_script,0,0,00:00:00,0,00:00:00,0,0
2016-12-25-ccc_waste_recycling_script,2016/12/25,ccc_waste_recycling_script,0,0,00:00:00,0,00:00:00,0,0
2016-12-26-ccc_311_calgary_script,2016/12/26,ccc_311_calgary_script,962,954,00:00:08,8,00:05:12,8,7632
2016-12-26-ccc_311_lobby_ph_script,2016/12/26,ccc_311_lobby_ph_script,0,0,00:00:00,0,00:00:00,0,0
2016-12-26-ccc_aserv_info_script,2016/12/26,ccc_aserv_info_script,0,0,00:00:00,0,00:00:00,0,0
2016-12-26-ccc_bylaw_script,2016/12/26,ccc_bylaw_script,0,0,00:00:00,0,00:00:00,0,0
2016-12-26-ccc_city_script,2016/12/26,ccc_city_script,0,0,00:00:00,0,00:00:00,0,0
2016-12-26-ccc_cty_online_script,2016/12/26,ccc_cty_online_script,0,0,00:00:00,0,00:00:00,0,0
2016-12-26-ccc_feedback_script,2016/12/26,ccc_feedback_script,0,0,00:00:00,0,00:00:00,0,0
2016-12-26-ccc_fpb_script,2016/12/26,ccc_fpb_script,0,0,00:00:00,0,00:00:00,0,0
2016-12-26-ccc_help_script,2016/12/26,ccc_help_script,1,1,00:00:03,3,00:00:03,0,3
2016-12-26-ccc_link_script,2016/12/26,ccc_link_script,0,0,00:00:00,0,00:00:00,0,0
2016-12-26-ccc_media_line_script,2016/12/26,ccc_media_line_script,1,1,00:00:07,7,00:00:07,0,7
2016-12-26-ccc_priority_script,2016/12/26,ccc_priority_script,30,29,00:00:06,6,00:00:12,1,174
2016-12-26-ccc_tax_script,2016/12/26,ccc_tax_script,0,0,00:00:00,0,00:00:00,0,0
2016-12-26-ccc_waste_recycling_script,2016/12/26,ccc_waste_recycling_script,0,0,00:00:00,0,00:00:00,0,0
2016-12-27-ccc_311_calgary_script,2016/12/27,ccc_311_calgary_script,1887,1855,00:00:11,11,00:02:59,32,20405
2016-12-27-ccc_311_lobby_ph_script,2016/12/27,ccc_311_lobby_ph_script,2,1,00:00:02,2,00:00:02,1,2
2016-12-27-ccc_aserv_info_script,2016/12/27,ccc_aserv_info_script,0,0,00:00:00,0,00:00:00,0,0
2016-12-27-ccc_bylaw_script,2016/12/27,ccc_bylaw_script,0,0,00:00:00,0,00:00:00,0,0
2016-12-27-ccc_city_script,2016/12/27,ccc_city_script,9,9,00:00:05,5,00:00:09,0,45
2016-12-27-ccc_cty_online_script,2016/12/27,ccc_cty_online_script,0,0,00:00:00,0,00:00:00,0,0
2016-12-27-ccc_feedback_script,2016/12/27,ccc_feedback_script,0,0,00:00:00,0,00:00:00,0,0
2016-12-27-ccc_fpb_script,2016/12/27,ccc_fpb_script,0,0,00:00:00,0,00:00:00,0,0
2016-12-27-ccc_help_script,2016/12/27,ccc_help_script,6,6,00:00:12,12,00:00:41,0,72
2016-12-27-ccc_link_script,2016/12/27,ccc_link_script,0,0,00:00:00,0,00:00:00,0,0
2016-12-27-ccc_media_line_script,2016/12/27,ccc_media_line_script,0,0,00:00:00,0,00:00:00,0,0
2016-12-27-ccc_priority_script,2016/12/27,ccc_priority_script,47,47,00:00:07,7,00:00:33,0,329
2016-12-27-ccc_tax_script,2016/12/27,ccc_tax_script,1,0,00:00:00,0,00:00:00,1,0
2016-12-27-ccc_waste_recycling_script,2016/12/27,ccc_waste_recycling_script,0,0,00:00:00,0,00:00:00,0,0
2016-12-28-ccc_311_calgary_script,2016/12/28,ccc_311_calgary_script,2482,2079,00:02:20,140,00:11:03,403,291060
2016-12-28-ccc_311_lobby_ph_script,2016/12/28,ccc_311_lobby_ph_script,1,1,00:00:01,1,00:00:01,0,1
2016-12-28-ccc_aserv_info_script,2016/12/28,ccc_aserv_info_script,0,0,00:00:00,0,00:00:00,0,0
2016-12-28-ccc_bylaw_script,2016/12/28,ccc_bylaw_script,1,0,00:00:00,0,00:00:00,1,0
2016-12-28-ccc_city_script,2016/12/28,ccc_city_script,3,3,00:03:12,192,00:09:05,0,576
2016-12-28-ccc_cty_online_script,2016/12/28,ccc_cty_online_script,0,0,00:00:00,0,00:00:00,0,0
2016-12-28-ccc_feedback_script,2016/12/28,ccc_feedback_script,0,0,00:00:00,0,00:00:00,0,0
2016-12-28-ccc_fpb_script,2016/12/28,ccc_fpb_script,0,0,00:00:00,0,00:00:00,0,0
2016-12-28-ccc_help_script,2016/12/28,ccc_help_script,17,16,00:00:13,13,00:01:04,1,208
2016-12-28-ccc_link_script,2016/12/28,ccc_link_script,0,0,00:00:00,0,00:00:00,0,0
2016-12-28-ccc_media_line_script,2016/12/28,ccc_media_line_script,1,1,00:00:06,6,00:00:06,0,6
2016-12-28-ccc_priority_script,2016/12/28,ccc_priority_script,34,31,00:00:21,21,00:03:03,3,651
2016-12-28-ccc_tax_script,2016/12/28,ccc_tax_script,5,5,00:04:04,244,00:08:43,0,1220
2016-12-28-ccc_waste_recycling_script,2016/12/28,ccc_waste_recycling_script,0,0,00:00:00,0,00:00:00,0,0
2016-12-29-ccc_311_calgary_script,2016/12/29,ccc_311_calgary_script,2377,2273,00:00:36,36,00:06:27,104,81828
2016-12-29-ccc_311_lobby_ph_script,2016/12/29,ccc_311_lobby_ph_script,1,1,00:00:19,19,00:00:19,0,19
2016-12-29-ccc_aserv_info_script,2016/12/29,ccc_aserv_info_script,0,0,00:00:00,0,00:00:00,0,0
2016-12-29-ccc_bylaw_script,2016/12/29,ccc_bylaw_script,0,0,00:00:00,0,00:00:00,0,0
2016-12-29-ccc_city_script,2016/12/29,ccc_city_script,3,3,00:00:16,16,00:00:34,0,48
2016-12-29-ccc_cty_online_script,2016/12/29,ccc_cty_online_script,0,0,00:00:00,0,00:00:00,0,0
2016-12-29-ccc_feedback_script,2016/12/29,ccc_feedback_script,0,0,00:00:00,0,00:00:00,0,0
2016-12-29-ccc_fpb_script,2016/12/29,ccc_fpb_script,0,0,00:00:00,0,00:00:00,0,0
2016-12-29-ccc_help_script,2016/12/29,ccc_help_script,32,32,00:00:06,6,00:00:23,0,192
2016-12-29-ccc_link_script,2016/12/29,ccc_link_script,0,0,00:00:00,0,00:00:00,0,0
2016-12-29-ccc_media_line_script,2016/12/29,ccc_media_line_script,0,0,00:00:00,0,00:00:00,0,0
2016-12-29-ccc_priority_script,2016/12/29,ccc_priority_script,27,27,00:00:06,6,00:00:29,0,162
2016-12-29-ccc_tax_script,2016/12/29,ccc_tax_script,1,1,00:00:10,10,00:00:10,0,10
2016-12-29-ccc_waste_recycling_script,2016/12/29,ccc_waste_recycling_script,0,0,00:00:00,0,00:00:00,0,0
2016-12-30-ccc_311_calgary_script,2016/12/30,ccc_311_calgary_script,2297,2203,00:00:33,33,00:06:46,94,72699
2016-12-30-ccc_311_lobby_ph_script,2016/12/30,ccc_311_lobby_ph_script,0,0,00:00:00,0,00:00:00,0,0
2016-12-30-ccc_aserv_info_script,2016/12/30,ccc_aserv_info_script,0,0,00:00:00,0,00:00:00,0,0
2016-12-30-ccc_bylaw_script,2016/12/30,ccc_bylaw_script,0,0,00:00:00,0,00:00:00,0,0
2016-12-30-ccc_city_script,2016/12/30,ccc_city_script,9,9,00:00:13,13,00:00:36,0,117
2016-12-30-ccc_cty_online_script,2016/12/30,ccc_cty_online_script,0,0,00:00:00,0,00:00:00,0,0
2016-12-30-ccc_feedback_script,2016/12/30,ccc_feedback_script,0,0,00:00:00,0,00:00:00,0,0
2016-12-30-ccc_fpb_script,2016/12/30,ccc_fpb_script,0,0,00:00:00,0,00:00:00,0,0
2016-12-30-ccc_help_script,2016/12/30,ccc_help_script,11,11,00:00:14,14,00:00:30,0,154
2016-12-30-ccc_link_script,2016/12/30,ccc_link_script,0,0,00:00:00,0,00:00:00,0,0
2016-12-30-ccc_media_line_script,2016/12/30,ccc_media_line_script,1,1,00:00:04,4,00:00:04,0,4
2016-12-30-ccc_priority_script,2016/12/30,ccc_priority_script,12,12,00:00:15,15,00:01:29,0,180
2016-12-30-ccc_tax_script,2016/12/30,ccc_tax_script,6,6,00:00:36,36,00:01:56,0,216
2016-12-30-ccc_waste_recycling_script,2016/12/30,ccc_waste_recycling_script,0,0,00:00:00,0,00:00:00,0,0
2016-12-31-ccc_311_calgary_script,2016/12/31,ccc_311_calgary_script,1287,1151,00:01:08,68,00:14:36,136,78268
2016-12-31-ccc_311_lobby_ph_script,2016/12/31,ccc_311_lobby_ph_script,0,0,00:00:00,0,00:00:00,0,0
2016-12-31-ccc_aserv_info_script,2016/12/31,ccc_aserv_info_script,0,0,00:00:00,0,00:00:00,0,0
2016-12-31-ccc_bylaw_script,2016/12/31,ccc_bylaw_script,0,0,00:00:00,0,00:00:00,0,0
2016-12-31-ccc_city_script,2016/12/31,ccc_city_script,0,0,00:00:00,0,00:00:00,0,0
2016-12-31-ccc_cty_online_script,2016/12/31,ccc_cty_online_script,0,0,00:00:00,0,00:00:00,0,0
2016-12-31-ccc_feedback_script,2016/12/31,ccc_feedback_script,0,0,00:00:00,0,00:00:00,0,0
2016-12-31-ccc_fpb_script,2016/12/31,ccc_fpb_script,0,0,00:00:00,0,00:00:00,0,0
2016-12-31-ccc_help_script,2016/12/31,ccc_help_script,5,5,00:00:29,29,00:01:37,0,145
2016-12-31-ccc_link_script,2016/12/31,ccc_link_script,0,0,00:00:00,0,00:00:00,0,0
2016-12-31-ccc_media_line_script,2016/12/31,ccc_media_line_script,3,3,00:00:14,14,00:00:34,0,42
2016-12-31-ccc_priority_script,2016/12/31,ccc_priority_script,11,10,00:00:10,10,00:00:51,1,100
2016-12-31-ccc_tax_script,2016/12/31,ccc_tax_script,0,0,00:00:00,0,00:00:00,0,0
2016-12-31-ccc_waste_recycling_script,2016/12/31,ccc_waste_recycling_script,0,0,00:00:00,0,00:00:00,0,0
2017-01-01-ccc_311_calgary_script,2017/01/01,ccc_311_calgary_script,776,758,00:00:23,23,00:05:17,18,17434
2017-01-01-ccc_311_lobby_ph_script,2017/01/01,ccc_311_lobby_ph_script,0,0,00:00:00,0,00:00:00,0,0
2017-01-01-ccc_aserv_info_script,2017/01/01,ccc_aserv_info_script,0,0,00:00:00,0,00:00:00,0,0
2017-01-01-ccc_bylaw_script,2017/01/01,ccc_bylaw_script,1,1,00:00:12,12,00:00:12,0,12
2017-01-01-ccc_city_script,2017/01/01,ccc_city_script,0,0,00:00:00,0,00:00:00,0,0
2017-01-01-ccc_cty_online_script,2017/01/01,ccc_cty_online_script,0,0,00:00:00,0,00:00:00,0,0
2017-01-01-ccc_feedback_script,2017/01/01,ccc_feedback_script,0,0,00:00:00,0,00:00:00,0,0
2017-01-01-ccc_fpb_script,2017/01/01,ccc_fpb_script,0,0,00:00:00,0,00:00:00,0,0
2017-01-01-ccc_help_script,2017/01/01,ccc_help_script,8,8,00:00:12,12,00:00:33,0,96
2017-01-01-ccc_link_script,2017/01/01,ccc_link_script,0,0,00:00:00,0,00:00:00,0,0
2017-01-01-ccc_media_line_script,2017/01/01,ccc_media_line_script,4,3,00:00:13,13,00:00:22,1,39
2017-01-01-ccc_priority_script,2017/01/01,ccc_priority_script,18,17,00:00:08,8,00:00:33,1,136
2017-01-01-ccc_tax_script,2017/01/01,ccc_tax_script,0,0,00:00:00,0,00:00:00,0,0
2017-01-01-ccc_waste_recycling_script,2017/01/01,ccc_waste_recycling_script,0,0,00:00:00,0,00:00:00,0,0
2017-01-02-ccc_311_calgary_script,2017/01/02,ccc_311_calgary_script,2117,2100,00:00:09,9,00:03:33,17,18900
2017-01-02-ccc_311_lobby_ph_script,2017/01/02,ccc_311_lobby_ph_script,1,1,00:00:08,8,00:00:08,0,8
2017-01-02-ccc_aserv_info_script,2017/01/02,ccc_aserv_info_script,0,0,00:00:00,0,00:00:00,0,0
2017-01-02-ccc_bylaw_script,2017/01/02,ccc_bylaw_script,0,0,00:00:00,0,00:00:00,0,0
2017-01-02-ccc_city_script,2017/01/02,ccc_city_script,11,11,00:00:07,7,00:00:13,0,77
2017-01-02-ccc_cty_online_script,2017/01/02,ccc_cty_online_script,0,0,00:00:00,0,00:00:00,0,0
2017-01-02-ccc_feedback_script,2017/01/02,ccc_feedback_script,0,0,00:00:00,0,00:00:00,0,0
2017-01-02-ccc_fpb_script,2017/01/02,ccc_fpb_script,0,0,00:00:00,0,00:00:00,0,0
2017-01-02-ccc_help_script,2017/01/02,ccc_help_script,6,6,00:00:13,13,00:00:34,0,78
2017-01-02-ccc_link_script,2017/01/02,ccc_link_script,0,0,00:00:00,0,00:00:00,0,0
2017-01-02-ccc_media_line_script,2017/01/02,ccc_media_line_script,0,0,00:00:00,0,00:00:00,0,0
2017-01-02-ccc_priority_script,2017/01/02,ccc_priority_script,29,28,00:00:07,7,00:00:19,1,196
2017-01-02-ccc_tax_script,2017/01/02,ccc_tax_script,1,1,00:00:05,5,00:00:05,0,5
2017-01-02-ccc_waste_recycling_script,2017/01/02,ccc_waste_recycling_script,0,0,00:00:00,0,00:00:00,0,0
2017-01-03-ccc_311_calgary_script,2017/01/03,ccc_311_calgary_script,3346,3089,00:01:06,66,00:17:45,257,203874
2017-01-03-ccc_311_lobby_ph_script,2017/01/03,ccc_311_lobby_ph_script,5,4,00:00:06,6,00:00:15,1,24
2017-01-03-ccc_aserv_info_script,2017/01/03,ccc_aserv_info_script,0,0,00:00:00,0,00:00:00,0,0
2017-01-03-ccc_bylaw_script,2017/01/03,ccc_bylaw_script,0,0,00:00:00,0,00:00:00,0,0
2017-01-03-ccc_city_script,2017/01/03,ccc_city_script,39,36,00:00:24,24,00:02:20,3,864
2017-01-03-ccc_cty_online_script,2017/01/03,ccc_cty_online_script,0,0,00:00:00,0,00:00:00,0,0
2017-01-03-ccc_feedback_script,2017/01/03,ccc_feedback_script,0,0,00:00:00,0,00:00:00,0,0
2017-01-03-ccc_fpb_script,2017/01/03,ccc_fpb_script,1,1,00:00:08,8,00:00:08,0,8
2017-01-03-ccc_help_script,2017/01/03,ccc_help_script,30,28,00:00:10,10,00:00:27,2,280
2017-01-03-ccc_link_script,2017/01/03,ccc_link_script,0,0,00:00:00,0,00:00:00,0,0
2017-01-03-ccc_media_line_script,2017/01/03,ccc_media_line_script,4,4,00:00:13,13,00:00:18,0,52
2017-01-03-ccc_priority_script,2017/01/03,ccc_priority_script,51,50,00:00:12,12,00:01:13,1,600
2017-01-03-ccc_tax_script,2017/01/03,ccc_tax_script,25,21,00:01:37,97,00:04:15,4,2037
2017-01-03-ccc_waste_recycling_script,2017/01/03,ccc_waste_recycling_script,0,0,00:00:00,0,00:00:00,0,0
2017-01-04-ccc_311_calgary_script,2017/01/04,ccc_311_calgary_script,3214,2798,00:02:02,122,00:07:10,413,341356
2017-01-04-ccc_311_lobby_ph_script,2017/01/04,ccc_311_lobby_ph_script,2,2,00:00:06,6,00:00:07,0,12
2017-01-04-ccc_aserv_info_script,2017/01/04,ccc_aserv_info_script,0,0,00:00:00,0,00:00:00,0,0
2017-01-04-ccc_bylaw_script,2017/01/04,ccc_bylaw_script,0,0,00:00:00,0,00:00:00,0,0
2017-01-04-ccc_city_script,2017/01/04,ccc_city_script,35,33,00:00:44,44,00:03:54,2,1452
2017-01-04-ccc_cty_online_script,2017/01/04,ccc_cty_online_script,0,0,00:00:00,0,00:00:00,0,0
2017-01-04-ccc_feedback_script,2017/01/04,ccc_feedback_script,0,0,00:00:00,0,00:00:00,0,0
2017-01-04-ccc_fpb_script,2017/01/04,ccc_fpb_script,0,0,00:00:00,0,00:00:00,0,0
2017-01-04-ccc_help_script,2017/01/04,ccc_help_script,42,36,00:00:12,12,00:00:43,6,432
2017-01-04-ccc_link_script,2017/01/04,ccc_link_script,0,0,00:00:00,0,00:00:00,0,0
2017-01-04-ccc_media_line_script,2017/01/04,ccc_media_line_script,4,3,00:00:11,11,00:00:15,1,33
2017-01-04-ccc_priority_script,2017/01/04,ccc_priority_script,53,53,00:00:09,9,00:00:39,0,477
2017-01-04-ccc_tax_script,2017/01/04,ccc_tax_script,23,18,00:02:17,137,00:05:51,5,2466
2017-01-04-ccc_waste_recycling_script,2017/01/04,ccc_waste_recycling_script,0,0,00:00:00,0,00:00:00,0,0
2017-01-05-ccc_311_calgary_script,2017/01/05,ccc_311_calgary_script,2861,2699,00:00:48,48,00:04:39,162,129552
2017-01-05-ccc_311_lobby_ph_script,2017/01/05,ccc_311_lobby_ph_script,1,1,00:00:03,3,00:00:03,0,3
2017-01-05-ccc_aserv_info_script,2017/01/05,ccc_aserv_info_script,0,0,00:00:00,0,00:00:00,0,0
2017-01-05-ccc_bylaw_script,2017/01/05,ccc_bylaw_script,0,0,00:00:00,0,00:00:00,0,0
2017-01-05-ccc_city_script,2017/01/05,ccc_city_script,23,23,00:00:18,18,00:00:55,0,414
2017-01-05-ccc_cty_online_script,2017/01/05,ccc_cty_online_script,0,0,00:00:00,0,00:00:00,0,0
2017-01-05-ccc_feedback_script,2017/01/05,ccc_feedback_script,1,0,00:00:00,0,00:00:00,0,0
2017-01-05-ccc_fpb_script,2017/01/05,ccc_fpb_script,1,0,00:00:00,0,00:00:00,1,0
2017-01-05-ccc_help_script,2017/01/05,ccc_help_script,26,22,00:00:10,10,00:00:31,4,220
2017-01-05-ccc_link_script,2017/01/05,ccc_link_script,0,0,00:00:00,0,00:00:00,0,0
2017-01-05-ccc_media_line_script,2017/01/05,ccc_media_line_script,0,0,00:00:00,0,00:00:00,0,0
2017-01-05-ccc_priority_script,2017/01/05,ccc_priority_script,35,30,00:00:07,7,00:00:16,0,210
2017-01-05-ccc_tax_script,2017/01/05,ccc_tax_script,19,17,00:01:21,81,00:03:46,2,1377
2017-01-05-ccc_waste_recycling_script,2017/01/05,ccc_waste_recycling_script,0,0,00:00:00,0,00:00:00,0,0
2017-01-06-ccc_311_calgary_script,2017/01/06,ccc_311_calgary_script,2789,2541,00:01:20,80,00:05:34,248,203280
2017-01-06-ccc_311_lobby_ph_script,2017/01/06,ccc_311_lobby_ph_script,1,1,00:00:28,28,00:00:28,0,28
2017-01-06-ccc_aserv_info_script,2017/01/06,ccc_aserv_info_script,0,0,00:00:00,0,00:00:00,0,0
2017-01-06-ccc_bylaw_script,2017/01/06,ccc_bylaw_script,0,0,00:00:00,0,00:00:00,0,0
2017-01-06-ccc_city_script,2017/01/06,ccc_city_script,24,22,00:00:27,27,00:02:48,2,594
2017-01-06-ccc_cty_online_script,2017/01/06,ccc_cty_online_script,0,0,00:00:00,0,00:00:00,0,0
2017-01-06-ccc_feedback_script,2017/01/06,ccc_feedback_script,0,0,00:00:00,0,00:00:00,0,0
2017-01-06-ccc_fpb_script,2017/01/06,ccc_fpb_script,0,0,00:00:00,0,00:00:00,0,0
2017-01-06-ccc_help_script,2017/01/06,ccc_help_script,35,34,00:00:11,11,00:00:53,1,374
2017-01-06-ccc_link_script,2017/01/06,ccc_link_script,0,0,00:00:00,0,00:00:00,0,0
2017-01-06-ccc_media_line_script,2017/01/06,ccc_media_line_script,1,1,00:00:03,3,00:00:03,0,3
2017-01-06-ccc_priority_script,2017/01/06,ccc_priority_script,25,23,00:00:08,8,00:00:32,2,184
2017-01-06-ccc_tax_script,2017/01/06,ccc_tax_script,21,19,00:01:40,100,00:03:13,2,1900
2017-01-06-ccc_waste_recycling_script,2017/01/06,ccc_waste_recycling_script,0,0,00:00:00,0,00:00:00,0,0
2017-01-07-ccc_311_calgary_script,2017/01/07,ccc_311_calgary_script,1063,1051,00:00:09,9,00:03:29,12,9459
2017-01-07-ccc_311_lobby_ph_script,2017/01/07,ccc_311_lobby_ph_script,0,0,00:00:00,0,00:00:00,0,0
2017-01-07-ccc_aserv_info_script,2017/01/07,ccc_aserv_info_script,0,0,00:00:00,0,00:00:00,0,0
2017-01-07-ccc_bylaw_script,2017/01/07,ccc_bylaw_script,0,0,00:00:00,0,00:00:00,0,0
2017-01-07-ccc_city_script,2017/01/07,ccc_city_script,0,0,00:00:00,0,00:00:00,0,0
2017-01-07-ccc_cty_online_script,2017/01/07,ccc_cty_online_script,0,0,00:00:00,0,00:00:00,0,0
2017-01-07-ccc_feedback_script,2017/01/07,ccc_feedback_script,0,0,00:00:00,0,00:00:00,0,0
2017-01-07-ccc_fpb_script,2017/01/07,ccc_fpb_script,0,0,00:00:00,0,00:00:00,0,0
2017-01-07-ccc_help_script,2017/01/07,ccc_help_script,9,8,00:00:13,13,00:01:07,1,104
2017-01-07-ccc_link_script,2017/01/07,ccc_link_script,0,0,00:00:00,0,00:00:00,0,0
2017-01-07-ccc_media_line_script,2017/01/07,ccc_media_line_script,0,0,00:00:00,0,00:00:00,0,0
2017-01-07-ccc_priority_script,2017/01/07,ccc_priority_script,30,30,00:00:08,8,00:00:30,0,240
2017-01-07-ccc_tax_script,2017/01/07,ccc_tax_script,0,0,00:00:00,0,00:00:00,0,0
2017-01-07-ccc_waste_recycling_script,2017/01/07,ccc_waste_recycling_script,0,0,00:00:00,0,00:00:00,0,0
2017-01-08-ccc_311_calgary_script,2017/01/08,ccc_311_calgary_script,836,821,00:00:12,12,00:03:50,15,9852
2017-01-08-ccc_311_lobby_ph_script,2017/01/08,ccc_311_lobby_ph_script,0,0,00:00:00,0,00:00:00,0,0
2017-01-08-ccc_aserv_info_script,2017/01/08,ccc_aserv_info_script,0,0,00:00:00,0,00:00:00,0,0
2017-01-08-ccc_bylaw_script,2017/01/08,ccc_bylaw_script,0,0,00:00:00,0,00:00:00,0,0
2017-01-08-ccc_city_script,2017/01/08,ccc_city_script,0,0,00:00:00,0,00:00:00,0,0
2017-01-08-ccc_cty_online_script,2017/01/08,ccc_cty_online_script,0,0,00:00:00,0,00:00:00,0,0
2017-01-08-ccc_feedback_script,2017/01/08,ccc_feedback_script,0,0,00:00:00,0,00:00:00,0,0
2017-01-08-ccc_fpb_script,2017/01/08,ccc_fpb_script,0,0,00:00:00,0,00:00:00,0,0
2017-01-08-ccc_help_script,2017/01/08,ccc_help_script,1,1,00:00:03,3,00:00:03,0,3
2017-01-08-ccc_link_script,2017/01/08,ccc_link_script,0,0,00:00:00,0,00:00:00,0,0
2017-01-08-ccc_media_line_script,2017/01/08,ccc_media_line_script,0,0,00:00:00,0,00:00:00,0,0
2017-01-08-ccc_priority_script,2017/01/08,ccc_priority_script,22,22,00:00:18,18,00:01:23,0,396
2017-01-08-ccc_tax_script,2017/01/08,ccc_tax_script,0,0,00:00:00,0,00:00:00,0,0
2017-01-08-ccc_waste_recycling_script,2017/01/08,ccc_waste_recycling_script,0,0,00:00:00,0,00:00:00,0,0
2017-01-09-ccc_311_calgary_script,2017/01/09,ccc_311_calgary_script,3314,3208,00:00:23,23,00:05:43,106,73784
2017-01-09-ccc_311_lobby_ph_script,2017/01/09,ccc_311_lobby_ph_script,1,1,00:00:05,5,00:00:05,0,5
2017-01-09-ccc_aserv_info_script,2017/01/09,ccc_aserv_info_script,0,0,00:00:00,0,00:00:00,0,0
2017-01-09-ccc_bylaw_script,2017/01/09,ccc_bylaw_script,0,0,00:00:00,0,00:00:00,0,0
2017-01-09-ccc_city_script,2017/01/09,ccc_city_script,16,14,00:00:17,17,00:01:27,2,238
2017-01-09-ccc_cty_online_script,2017/01/09,ccc_cty_online_script,0,0,00:00:00,0,00:00:00,0,0
2017-01-09-ccc_feedback_script,2017/01/09,ccc_feedback_script,0,0,00:00:00,0,00:00:00,0,0
2017-01-09-ccc_fpb_script,2017/01/09,ccc_fpb_script,0,0,00:00:00,0,00:00:00,0,0
2017-01-09-ccc_help_script,2017/01/09,ccc_help_script,25,25,00:00:09,9,00:00:25,0,225
2017-01-09-ccc_link_script,2017/01/09,ccc_link_script,0,0,00:00:00,0,00:00:00,0,0
2017-01-09-ccc_media_line_script,2017/01/09,ccc_media_line_script,2,2,00:00:04,4,00:00:04,0,8
2017-01-09-ccc_priority_script,2017/01/09,ccc_priority_script,31,30,00:00:07,7,00:00:28,1,210
2017-01-09-ccc_tax_script,2017/01/09,ccc_tax_script,21,20,00:00:19,19,00:02:30,1,380
2017-01-09-ccc_waste_recycling_script,2017/01/09,ccc_waste_recycling_script,0,0,00:00:00,0,00:00:00,0,0
2017-01-10-ccc_311_calgary_script,2017/01/10,ccc_311_calgary_script,3033,2988,00:00:11,11,00:04:47,45,32868
2017-01-10-ccc_311_lobby_ph_script,2017/01/10,ccc_311_lobby_ph_script,1,1,00:00:03,3,00:00:03,0,3
2017-01-10-ccc_aserv_info_script,2017/01/10,ccc_aserv_info_script,0,0,00:00:00,0,00:00:00,0,0
2017-01-10-ccc_bylaw_script,2017/01/10,ccc_bylaw_script,0,0,00:00:00,0,00:00:00,0,0
2017-01-10-ccc_city_script,2017/01/10,ccc_city_script,12,12,00:00:05,5,00:00:09,0,60
2017-01-10-ccc_cty_online_script,2017/01/10,ccc_cty_online_script,0,0,00:00:00,0,00:00:00,0,0
2017-01-10-ccc_feedback_script,2017/01/10,ccc_feedback_script,0,0,00:00:00,0,00:00:00,0,0
2017-01-10-ccc_fpb_script,2017/01/10,ccc_fpb_script,2,2,00:00:08,8,00:00:08,0,16
2017-01-10-ccc_help_script,2017/01/10,ccc_help_script,22,22,00:00:06,6,00:00:15,0,132
2017-01-10-ccc_link_script,2017/01/10,ccc_link_script,0,0,00:00:00,0,00:00:00,0,0
2017-01-10-ccc_media_line_script,2017/01/10,ccc_media_line_script,1,1,00:00:13,13,00:00:13,0,13
2017-01-10-ccc_priority_script,2017/01/10,ccc_priority_script,44,43,00:00:06,6,00:00:16,1,258
2017-01-10-ccc_tax_script,2017/01/10,ccc_tax_script,24,23,00:00:09,9,00:00:27,1,207
2017-01-10-ccc_waste_recycling_script,2017/01/10,ccc_waste_recycling_script,0,0,00:00:00,0,00:00:00,0,0
2017-01-11-ccc_311_calgary_script,2017/01/11,ccc_311_calgary_script,2931,2851,00:00:17,17,00:06:55,80,48467
2017-01-11-ccc_311_lobby_ph_script,2017/01/11,ccc_311_lobby_ph_script,3,3,00:00:04,4,00:00:08,0,12
2017-01-11-ccc_aserv_info_script,2017/01/11,ccc_aserv_info_script,0,0,00:00:00,0,00:00:00,0,0
2017-01-11-ccc_bylaw_script,2017/01/11,ccc_bylaw_script,0,0,00:00:00,0,00:00:00,0,0
2017-01-11-ccc_city_script,2017/01/11,ccc_city_script,11,11,00:00:10,10,00:00:36,0,110
2017-01-11-ccc_cty_online_script,2017/01/11,ccc_cty_online_script,0,0,00:00:00,0,00:00:00,0,0
2017-01-11-ccc_feedback_script,2017/01/11,ccc_feedback_script,0,0,00:00:00,0,00:00:00,0,0
2017-01-11-ccc_fpb_script,2017/01/11,ccc_fpb_script,0,0,00:00:00,0,00:00:00,0,0
2017-01-11-ccc_help_script,2017/01/11,ccc_help_script,28,28,00:00:10,10,00:00:37,0,280
2017-01-11-ccc_link_script,2017/01/11,ccc_link_script,0,0,00:00:00,0,00:00:00,0,0
2017-01-11-ccc_media_line_script,2017/01/11,ccc_media_line_script,0,0,00:00:00,0,00:00:00,0,0
2017-01-11-ccc_priority_script,2017/01/11,ccc_priority_script,33,32,00:00:09,9,00:00:53,1,288
2017-01-11-ccc_tax_script,2017/01/11,ccc_tax_script,13,13,00:00:17,17,00:01:00,0,221
2017-01-11-ccc_waste_recycling_script,2017/01/11,ccc_waste_recycling_script,0,0,00:00:00,0,00:00:00,0,0
2017-01-12-ccc_311_calgary_script,2017/01/12,ccc_311_calgary_script,2960,2807,00:00:31,31,00:06:30,153,87017
2017-01-12-ccc_311_lobby_ph_script,2017/01/12,ccc_311_lobby_ph_script,1,1,00:00:12,12,00:00:12,0,12
2017-01-12-ccc_aserv_info_script,2017/01/12,ccc_aserv_info_script,0,0,00:00:00,0,00:00:00,0,0
2017-01-12-ccc_bylaw_script,2017/01/12,ccc_bylaw_script,0,0,00:00:00,0,00:00:00,0,0
2017-01-12-ccc_city_script,2017/01/12,ccc_city_script,15,15,00:00:07,7,00:00:37,0,105
2017-01-12-ccc_cty_online_script,2017/01/12,ccc_cty_online_script,0,0,00:00:00,0,00:00:00,0,0
2017-01-12-ccc_feedback_script,2017/01/12,ccc_feedback_script,0,0,00:00:00,0,00:00:00,0,0
2017-01-12-ccc_fpb_script,2017/01/12,ccc_fpb_script,1,1,00:00:11,11,00:00:11,0,11
2017-01-12-ccc_help_script,2017/01/12,ccc_help_script,24,22,00:00:09,9,00:00:45,2,198
2017-01-12-ccc_link_script,2017/01/12,ccc_link_script,0,0,00:00:00,0,00:00:00,0,0
2017-01-12-ccc_media_line_script,2017/01/12,ccc_media_line_script,2,2,00:00:06,6,00:00:06,0,12
2017-01-12-ccc_priority_script,2017/01/12,ccc_priority_script,34,32,00:00:08,8,00:00:26,2,256
2017-01-12-ccc_tax_script,2017/01/12,ccc_tax_script,11,10,00:01:20,80,00:03:27,1,800
2017-01-12-ccc_waste_recycling_script,2017/01/12,ccc_waste_recycling_script,0,0,00:00:00,0,00:00:00,0,0
2017-01-13-ccc_311_calgary_script,2017/01/13,ccc_311_calgary_script,2773,2649,00:00:26,26,00:03:58,124,68874
2017-01-13-ccc_311_lobby_ph_script,2017/01/13,ccc_311_lobby_ph_script,3,3,00:00:04,4,00:00:05,0,12
2017-01-13-ccc_aserv_info_script,2017/01/13,ccc_aserv_info_script,0,0,00:00:00,0,00:00:00,0,0
2017-01-13-ccc_bylaw_script,2017/01/13,ccc_bylaw_script,0,0,00:00:00,0,00:00:00,0,0
2017-01-13-ccc_city_script,2017/01/13,ccc_city_script,10,10,00:00:08,8,00:00:20,0,80
2017-01-13-ccc_cty_online_script,2017/01/13,ccc_cty_online_script,0,0,00:00:00,0,00:00:00,0,0
2017-01-13-ccc_feedback_script,2017/01/13,ccc_feedback_script,0,0,00:00:00,0,00:00:00,0,0
2017-01-13-ccc_fpb_script,2017/01/13,ccc_fpb_script,0,0,00:00:00,0,00:00:00,0,0
2017-01-13-ccc_help_script,2017/01/13,ccc_help_script,21,21,00:00:24,24,00:01:20,0,504
2017-01-13-ccc_link_script,2017/01/13,ccc_link_script,0,0,00:00:00,0,00:00:00,0,0
2017-01-13-ccc_media_line_script,2017/01/13,ccc_media_line_script,0,0,00:00:00,0,00:00:00,0,0
2017-01-13-ccc_priority_script,2017/01/13,ccc_priority_script,38,36,00:00:10,10,00:01:39,2,360
2017-01-13-ccc_tax_script,2017/01/13,ccc_tax_script,31,29,00:00:19,19,00:02:06,2,551
2017-01-13-ccc_waste_recycling_script,2017/01/13,ccc_waste_recycling_script,0,0,00:00:00,0,00:00:00,0,0
2017-01-14-ccc_311_calgary_script,2017/01/14,ccc_311_calgary_script,1075,1057,00:00:12,12,00:04:11,18,12684
2017-01-14-ccc_311_lobby_ph_script,2017/01/14,ccc_311_lobby_ph_script,0,0,00:00:00,0,00:00:00,0,0
2017-01-14-ccc_aserv_info_script,2017/01/14,ccc_aserv_info_script,0,0,00:00:00,0,00:00:00,0,0
2017-01-14-ccc_bylaw_script,2017/01/14,ccc_bylaw_script,0,0,00:00:00,0,00:00:00,0,0
2017-01-14-ccc_city_script,2017/01/14,ccc_city_script,0,0,00:00:00,0,00:00:00,0,0
2017-01-14-ccc_cty_online_script,2017/01/14,ccc_cty_online_script,0,0,00:00:00,0,00:00:00,0,0
2017-01-14-ccc_feedback_script,2017/01/14,ccc_feedback_script,0,0,00:00:00,0,00:00:00,0,0
2017-01-14-ccc_fpb_script,2017/01/14,ccc_fpb_script,0,0,00:00:00,0,00:00:00,0,0
2017-01-14-ccc_help_script,2017/01/14,ccc_help_script,9,8,00:00:06,6,00:00:10,1,48
2017-01-14-ccc_link_script,2017/01/14,ccc_link_script,0,0,00:00:00,0,00:00:00,0,0
2017-01-14-ccc_media_line_script,2017/01/14,ccc_media_line_script,3,3,00:00:04,4,00:00:06,0,12
2017-01-14-ccc_priority_script,2017/01/14,ccc_priority_script,22,20,00:00:07,7,00:01:02,2,140
2017-01-14-ccc_tax_script,2017/01/14,ccc_tax_script,0,0,00:00:00,0,00:00:00,0,0
2017-01-14-ccc_waste_recycling_script,2017/01/14,ccc_waste_recycling_script,0,0,00:00:00,0,00:00:00,0,0
2017-01-15-ccc_311_calgary_script,2017/01/15,ccc_311_calgary_script,997,949,00:00:15,15,00:05:54,48,14235
2017-01-15-ccc_311_lobby_ph_script,2017/01/15,ccc_311_lobby_ph_script,0,0,00:00:00,0,00:00:00,0,0
2017-01-15-ccc_aserv_info_script,2017/01/15,ccc_aserv_info_script,0,0,00:00:00,0,00:00:00,0,0
2017-01-15-ccc_bylaw_script,2017/01/15,ccc_bylaw_script,0,0,00:00:00,0,00:00:00,0,0
2017-01-15-ccc_city_script,2017/01/15,ccc_city_script,0,0,00:00:00,0,00:00:00,0,0
2017-01-15-ccc_cty_online_script,2017/01/15,ccc_cty_online_script,0,0,00:00:00,0,00:00:00,0,0
2017-01-15-ccc_feedback_script,2017/01/15,ccc_feedback_script,0,0,00:00:00,0,00:00:00,0,0
2017-01-15-ccc_fpb_script,2017/01/15,ccc_fpb_script,0,0,00:00:00,0,00:00:00,0,0
2017-01-15-ccc_help_script,2017/01/15,ccc_help_script,5,5,00:00:03,3,00:00:07,0,15
2017-01-15-ccc_link_script,2017/01/15,ccc_link_script,0,0,00:00:00,0,00:00:00,0,0
2017-01-15-ccc_media_line_script,2017/01/15,ccc_media_line_script,2,2,00:00:06,6,00:00:09,0,12
2017-01-15-ccc_priority_script,2017/01/15,ccc_priority_script,20,20,00:00:09,9,00:01:11,0,180
2017-01-15-ccc_tax_script,2017/01/15,ccc_tax_script,0,0,00:00:00,0,00:00:00,0,0
2017-01-15-ccc_waste_recycling_script,2017/01/15,ccc_waste_recycling_script,0,0,00:00:00,0,00:00:00,0,0
2017-01-16-ccc_311_calgary_script,2017/01/16,ccc_311_calgary_script,3152,3049,00:00:29,29,00:06:28,103,88421
2017-01-16-ccc_311_lobby_ph_script,2017/01/16,ccc_311_lobby_ph_script,1,1,00:00:09,9,00:00:09,0,9
2017-01-16-ccc_aserv_info_script,2017/01/16,ccc_aserv_info_script,0,0,00:00:00,0,00:00:00,0,0
2017-01-16-ccc_bylaw_script,2017/01/16,ccc_bylaw_script,0,0,00:00:00,0,00:00:00,0,0
2017-01-16-ccc_city_script,2017/01/16,ccc_city_script,23,23,00:00:10,10,00:00:34,0,230
2017-01-16-ccc_cty_online_script,2017/01/16,ccc_cty_online_script,0,0,00:00:00,0,00:00:00,0,0
2017-01-16-ccc_feedback_script,2017/01/16,ccc_feedback_script,0,0,00:00:00,0,00:00:00,0,0
2017-01-16-ccc_fpb_script,2017/01/16,ccc_fpb_script,0,0,00:00:00,0,00:00:00,0,0
2017-01-16-ccc_help_script,2017/01/16,ccc_help_script,15,15,00:00:10,10,00:00:36,0,150
2017-01-16-ccc_link_script,2017/01/16,ccc_link_script,0,0,00:00:00,0,00:00:00,0,0
2017-01-16-ccc_media_line_script,2017/01/16,ccc_media_line_script,1,1,00:00:02,2,00:00:02,0,2
2017-01-16-ccc_priority_script,2017/01/16,ccc_priority_script,25,24,00:00:08,8,00:00:18,1,192
2017-01-16-ccc_tax_script,2017/01/16,ccc_tax_script,25,25,00:00:28,28,00:02:49,0,700
2017-01-16-ccc_waste_recycling_script,2017/01/16,ccc_waste_recycling_script,0,0,00:00:00,0,00:00:00,0,0
2017-01-17-ccc_311_calgary_script,2017/01/17,ccc_311_calgary_script,3434,2993,00:01:49,109,00:06:51,441,326237
2017-01-17-ccc_311_lobby_ph_script,2017/01/17,ccc_311_lobby_ph_script,0,0,00:00:00,0,00:00:00,0,0
2017-01-17-ccc_aserv_info_script,2017/01/17,ccc_aserv_info_script,0,0,00:00:00,0,00:00:00,0,0
2017-01-17-ccc_bylaw_script,2017/01/17,ccc_bylaw_script,0,0,00:00:00,0,00:00:00,0,0
2017-01-17-ccc_city_script,2017/01/17,ccc_city_script,23,20,00:00:16,16,00:01:07,3,320
2017-01-17-ccc_cty_online_script,2017/01/17,ccc_cty_online_script,0,0,00:00:00,0,00:00:00,0,0
2017-01-17-ccc_feedback_script,2017/01/17,ccc_feedback_script,0,0,00:00:00,0,00:00:00,0,0
2017-01-17-ccc_fpb_script,2017/01/17,ccc_fpb_script,2,2,00:00:11,11,00:00:17,0,22
2017-01-17-ccc_help_script,2017/01/17,ccc_help_script,24,24,00:00:19,19,00:03:26,0,456
2017-01-17-ccc_link_script,2017/01/17,ccc_link_script,0,0,00:00:00,0,00:00:00,0,0
2017-01-17-ccc_media_line_script,2017/01/17,ccc_media_line_script,0,0,00:00:00,0,00:00:00,0,0
2017-01-17-ccc_priority_script,2017/01/17,ccc_priority_script,23,22,00:00:06,6,00:00:27,1,132
2017-01-17-ccc_tax_script,2017/01/17,ccc_tax_script,24,21,00:01:27,87,00:04:52,3,1827
2017-01-17-ccc_waste_recycling_script,2017/01/17,ccc_waste_recycling_script,0,0,00:00:00,0,00:00:00,0,0
2017-01-18-ccc_311_calgary_script,2017/01/18,ccc_311_calgary_script,3483,3118,00:01:25,85,00:08:37,365,265030
2017-01-18-ccc_311_lobby_ph_script,2017/01/18,ccc_311_lobby_ph_script,6,6,00:00:14,14,00:00:30,0,84
2017-01-18-ccc_aserv_info_script,2017/01/18,ccc_aserv_info_script,0,0,00:00:00,0,00:00:00,0,0
2017-01-18-ccc_bylaw_script,2017/01/18,ccc_bylaw_script,0,0,00:00:00,0,00:00:00,0,0
2017-01-18-ccc_city_script,2017/01/18,ccc_city_script,22,21,00:00:20,20,00:02:22,1,420
2017-01-18-ccc_cty_online_script,2017/01/18,ccc_cty_online_script,0,0,00:00:00,0,00:00:00,0,0
2017-01-18-ccc_feedback_script,2017/01/18,ccc_feedback_script,0,0,00:00:00,0,00:00:00,0,0
2017-01-18-ccc_fpb_script,2017/01/18,ccc_fpb_script,0,0,00:00:00,0,00:00:00,0,0
2017-01-18-ccc_help_script,2017/01/18,ccc_help_script,29,26,00:00:12,12,00:01:07,3,312
2017-01-18-ccc_link_script,2017/01/18,ccc_link_script,0,0,00:00:00,0,00:00:00,0,0
2017-01-18-ccc_media_line_script,2017/01/18,ccc_media_line_script,6,3,00:00:14,14,00:00:19,3,42
2017-01-18-ccc_priority_script,2017/01/18,ccc_priority_script,31,30,00:00:11,11,00:01:19,1,330
2017-01-18-ccc_tax_script,2017/01/18,ccc_tax_script,11,10,00:01:07,67,00:04:29,1,670
2017-01-18-ccc_waste_recycling_script,2017/01/18,ccc_waste_recycling_script,0,0,00:00:00,0,00:00:00,0,0
2017-01-19-ccc_311_calgary_script,2017/01/19,ccc_311_calgary_script,3666,2981,00:02:49,169,00:11:18,685,503789
2017-01-19-ccc_311_lobby_ph_script,2017/01/19,ccc_311_lobby_ph_script,1,1,00:00:23,23,00:00:23,0,23
2017-01-19-ccc_aserv_info_script,2017/01/19,ccc_aserv_info_script,0,0,00:00:00,0,00:00:00,0,0
2017-01-19-ccc_bylaw_script,2017/01/19,ccc_bylaw_script,0,0,00:00:00,0,00:00:00,0,0
2017-01-19-ccc_city_script,2017/01/19,ccc_city_script,23,22,00:01:03,63,00:04:27,1,1386
2017-01-19-ccc_cty_online_script,2017/01/19,ccc_cty_online_script,0,0,00:00:00,0,00:00:00,0,0
2017-01-19-ccc_feedback_script,2017/01/19,ccc_feedback_script,0,0,00:00:00,0,00:00:00,0,0
2017-01-19-ccc_fpb_script,2017/01/19,ccc_fpb_script,0,0,00:00:00,0,00:00:00,0,0
2017-01-19-ccc_help_script,2017/01/19,ccc_help_script,30,24,00:00:16,16,00:01:26,6,384
2017-01-19-ccc_link_script,2017/01/19,ccc_link_script,0,0,00:00:00,0,00:00:00,0,0
2017-01-19-ccc_media_line_script,2017/01/19,ccc_media_line_script,2,2,00:00:44,44,00:00:51,0,88
2017-01-19-ccc_priority_script,2017/01/19,ccc_priority_script,26,26,00:00:18,18,00:01:53,0,468
2017-01-19-ccc_tax_script,2017/01/19,ccc_tax_script,27,19,00:03:02,182,00:07:07,8,3458
2017-01-19-ccc_waste_recycling_script,2017/01/19,ccc_waste_recycling_script,0,0,00:00:00,0,00:00:00,0,0
2017-01-20-ccc_311_calgary_script,2017/01/20,ccc_311_calgary_script,2889,2781,00:00:29,29,00:04:51,108,80649
2017-01-20-ccc_311_lobby_ph_script,2017/01/20,ccc_311_lobby_ph_script,2,2,00:00:09,9,00:00:15,0,18
2017-01-20-ccc_aserv_info_script,2017/01/20,ccc_aserv_info_script,0,0,00:00:00,0,00:00:00,0,0
2017-01-20-ccc_bylaw_script,2017/01/20,ccc_bylaw_script,0,0,00:00:00,0,00:00:00,0,0
2017-01-20-ccc_city_script,2017/01/20,ccc_city_script,23,23,00:00:13,13,00:00:37,0,299
2017-01-20-ccc_cty_online_script,2017/01/20,ccc_cty_online_script,0,0,00:00:00,0,00:00:00,0,0
2017-01-20-ccc_feedback_script,2017/01/20,ccc_feedback_script,1,0,00:00:00,0,00:00:00,0,0
2017-01-20-ccc_fpb_script,2017/01/20,ccc_fpb_script,0,0,00:00:00,0,00:00:00,0,0
2017-01-20-ccc_help_script,2017/01/20,ccc_help_script,13,13,00:00:07,7,00:00:28,0,91
2017-01-20-ccc_link_script,2017/01/20,ccc_link_script,0,0,00:00:00,0,00:00:00,0,0
2017-01-20-ccc_media_line_script,2017/01/20,ccc_media_line_script,2,2,00:00:08,8,00:00:09,0,16
2017-01-20-ccc_priority_script,2017/01/20,ccc_priority_script,28,28,00:00:08,8,00:00:24,0,224
2017-01-20-ccc_tax_script,2017/01/20,ccc_tax_script,19,19,00:00:27,27,00:01:56,0,513
2017-01-20-ccc_waste_recycling_script,2017/01/20,ccc_waste_recycling_script,0,0,00:00:00,0,00:00:00,0,0
2017-01-21-ccc_311_calgary_script,2017/01/21,ccc_311_calgary_script,1218,1161,00:00:21,21,00:04:10,57,24381
2017-01-21-ccc_311_lobby_ph_script,2017/01/21,ccc_311_lobby_ph_script,0,0,00:00:00,0,00:00:00,0,0
2017-01-21-ccc_aserv_info_script,2017/01/21,ccc_aserv_info_script,0,0,00:00:00,0,00:00:00,0,0
2017-01-21-ccc_bylaw_script,2017/01/21,ccc_bylaw_script,0,0,00:00:00,0,00:00:00,0,0
2017-01-21-ccc_city_script,2017/01/21,ccc_city_script,0,0,00:00:00,0,00:00:00,0,0
2017-01-21-ccc_cty_online_script,2017/01/21,ccc_cty_online_script,0,0,00:00:00,0,00:00:00,0,0
2017-01-21-ccc_feedback_script,2017/01/21,ccc_feedback_script,0,0,00:00:00,0,00:00:00,0,0
2017-01-21-ccc_fpb_script,2017/01/21,ccc_fpb_script,0,0,00:00:00,0,00:00:00,0,0
2017-01-21-ccc_help_script,2017/01/21,ccc_help_script,2,2,00:00:08,8,00:00:11,0,16
2017-01-21-ccc_link_script,2017/01/21,ccc_link_script,0,0,00:00:00,0,00:00:00,0,0
2017-01-21-ccc_media_line_script,2017/01/21,ccc_media_line_script,1,1,00:00:02,2,00:00:02,0,2
2017-01-21-ccc_priority_script,2017/01/21,ccc_priority_script,15,15,00:00:07,7,00:00:17,0,105
2017-01-21-ccc_tax_script,2017/01/21,ccc_tax_script,1,1,00:00:08,8,00:00:08,0,8
2017-01-21-ccc_waste_recycling_script,2017/01/21,ccc_waste_recycling_script,0,0,00:00:00,0,00:00:00,0,0
2017-01-22-ccc_311_calgary_script,2017/01/22,ccc_311_calgary_script,853,818,00:00:24,24,00:09:05,35,19632
2017-01-22-ccc_311_lobby_ph_script,2017/01/22,ccc_311_lobby_ph_script,0,0,00:00:00,0,00:00:00,0,0
2017-01-22-ccc_aserv_info_script,2017/01/22,ccc_aserv_info_script,0,0,00:00:00,0,00:00:00,0,0
2017-01-22-ccc_bylaw_script,2017/01/22,ccc_bylaw_script,0,0,00:00:00,0,00:00:00,0,0
2017-01-22-ccc_city_script,2017/01/22,ccc_city_script,0,0,00:00:00,0,00:00:00,0,0
2017-01-22-ccc_cty_online_script,2017/01/22,ccc_cty_online_script,0,0,00:00:00,0,00:00:00,0,0
2017-01-22-ccc_feedback_script,2017/01/22,ccc_feedback_script,0,0,00:00:00,0,00:00:00,0,0
2017-01-22-ccc_fpb_script,2017/01/22,ccc_fpb_script,0,0,00:00:00,0,00:00:00,0,0
2017-01-22-ccc_help_script,2017/01/22,ccc_help_script,6,5,00:00:07,7,00:00:10,1,35
2017-01-22-ccc_link_script,2017/01/22,ccc_link_script,0,0,00:00:00,0,00:00:00,0,0
2017-01-22-ccc_media_line_script,2017/01/22,ccc_media_line_script,2,2,00:00:05,5,00:00:06,0,10
2017-01-22-ccc_priority_script,2017/01/22,ccc_priority_script,8,8,00:00:22,22,00:01:50,0,176
2017-01-22-ccc_tax_script,2017/01/22,ccc_tax_script,1,1,00:00:03,3,00:00:03,0,3
2017-01-22-ccc_waste_recycling_script,2017/01/22,ccc_waste_recycling_script,0,0,00:00:00,0,00:00:00,0,0
2017-01-23-ccc_311_calgary_script,2017/01/23,ccc_311_calgary_script,2775,2286,00:02:37,157,00:15:22,489,358902
2017-01-23-ccc_311_lobby_ph_script,2017/01/23,ccc_311_lobby_ph_script,1,1,00:00:07,7,00:00:07,0,7
2017-01-23-ccc_aserv_info_script,2017/01/23,ccc_aserv_info_script,0,0,00:00:00,0,00:00:00,0,0
2017-01-23-ccc_bylaw_script,2017/01/23,ccc_bylaw_script,0,0,00:00:00,0,00:00:00,0,0
2017-01-23-ccc_city_script,2017/01/23,ccc_city_script,15,14,00:00:47,47,00:03:49,1,658
2017-01-23-ccc_cty_online_script,2017/01/23,ccc_cty_online_script,0,0,00:00:00,0,00:00:00,0,0
2017-01-23-ccc_feedback_script,2017/01/23,ccc_feedback_script,0,0,00:00:00,0,00:00:00,0,0
2017-01-23-ccc_fpb_script,2017/01/23,ccc_fpb_script,0,0,00:00:00,0,00:00:00,0,0
2017-01-23-ccc_help_script,2017/01/23,ccc_help_script,99,99,00:00:08,8,00:01:03,0,792
2017-01-23-ccc_link_script,2017/01/23,ccc_link_script,0,0,00:00:00,0,00:00:00,0,0
2017-01-23-ccc_media_line_script,2017/01/23,ccc_media_line_script,2,2,00:00:26,26,00:00:29,0,52
2017-01-23-ccc_priority_script,2017/01/23,ccc_priority_script,26,26,00:00:11,11,00:00:39,0,286
2017-01-23-ccc_tax_script,2017/01/23,ccc_tax_script,15,13,00:04:06,246,00:13:27,2,3198
2017-01-23-ccc_waste_recycling_script,2017/01/23,ccc_waste_recycling_script,0,0,00:00:00,0,00:00:00,0,0
2017-01-24-ccc_311_calgary_script,2017/01/24,ccc_311_calgary_script,2754,2624,00:00:42,42,00:05:38,130,110208
2017-01-24-ccc_311_lobby_ph_script,2017/01/24,ccc_311_lobby_ph_script,2,2,00:00:05,5,00:00:07,0,10
2017-01-24-ccc_aserv_info_script,2017/01/24,ccc_aserv_info_script,0,0,00:00:00,0,00:00:00,0,0
2017-01-24-ccc_bylaw_script,2017/01/24,ccc_bylaw_script,0,0,00:00:00,0,00:00:00,0,0
2017-01-24-ccc_city_script,2017/01/24,ccc_city_script,16,16,00:00:24,24,00:03:41,0,384
2017-01-24-ccc_cty_online_script,2017/01/24,ccc_cty_online_script,0,0,00:00:00,0,00:00:00,0,0
2017-01-24-ccc_feedback_script,2017/01/24,ccc_feedback_script,0,0,00:00:00,0,00:00:00,0,0
2017-01-24-ccc_fpb_script,2017/01/24,ccc_fpb_script,0,0,00:00:00,0,00:00:00,0,0
2017-01-24-ccc_help_script,2017/01/24,ccc_help_script,66,66,00:00:05,5,00:00:21,0,330
2017-01-24-ccc_link_script,2017/01/24,ccc_link_script,0,0,00:00:00,0,00:00:00,0,0
2017-01-24-ccc_media_line_script,2017/01/24,ccc_media_line_script,1,1,00:00:03,3,00:00:03,0,3
2017-01-24-ccc_priority_script,2017/01/24,ccc_priority_script,18,18,00:00:09,9,00:00:39,0,162
2017-01-24-ccc_tax_script,2017/01/24,ccc_tax_script,20,19,00:01:41,101,00:03:55,1,1919
2017-01-24-ccc_waste_recycling_script,2017/01/24,ccc_waste_recycling_script,0,0,00:00:00,0,00:00:00,0,0
2017-01-25-ccc_311_calgary_script,2017/01/25,ccc_311_calgary_script,3063,2799,00:01:16,76,00:10:45,264,212724
2017-01-25-ccc_311_lobby_ph_script,2017/01/25,ccc_311_lobby_ph_script,2,2,00:00:02,2,00:00:02,0,4
2017-01-25-ccc_aserv_info_script,2017/01/25,ccc_aserv_info_script,0,0,00:00:00,0,00:00:00,0,0
2017-01-25-ccc_bylaw_script,2017/01/25,ccc_bylaw_script,0,0,00:00:00,0,00:00:00,0,0
2017-01-25-ccc_city_script,2017/01/25,ccc_city_script,14,12,00:00:20,20,00:00:59,2,240
2017-01-25-ccc_cty_online_script,2017/01/25,ccc_cty_online_script,0,0,00:00:00,0,00:00:00,0,0
2017-01-25-ccc_feedback_script,2017/01/25,ccc_feedback_script,0,0,00:00:00,0,00:00:00,0,0
2017-01-25-ccc_fpb_script,2017/01/25,ccc_fpb_script,1,1,00:00:06,6,00:00:06,0,6
2017-01-25-ccc_help_script,2017/01/25,ccc_help_script,57,56,00:00:06,6,00:00:35,1,336
2017-01-25-ccc_link_script,2017/01/25,ccc_link_script,0,0,00:00:00,0,00:00:00,0,0
2017-01-25-ccc_media_line_script,2017/01/25,ccc_media_line_script,3,3,00:00:30,30,00:01:09,0,90
2017-01-25-ccc_priority_script,2017/01/25,ccc_priority_script,28,28,00:00:08,8,00:00:37,0,224
2017-01-25-ccc_tax_script,2017/01/25,ccc_tax_script,22,21,00:01:15,75,00:06:15,1,1575
2017-01-25-ccc_waste_recycling_script,2017/01/25,ccc_waste_recycling_script,0,0,00:00:00,0,00:00:00,0,0
2017-01-26-ccc_311_calgary_script,2017/01/26,ccc_311_calgary_script,2655,2533,00:00:29,29,00:06:12,122,73457
2017-01-26-ccc_311_lobby_ph_script,2017/01/26,ccc_311_lobby_ph_script,2,2,00:00:11,11,00:00:14,0,22
2017-01-26-ccc_aserv_info_script,2017/01/26,ccc_aserv_info_script,0,0,00:00:00,0,00:00:00,0,0
2017-01-26-ccc_bylaw_script,2017/01/26,ccc_bylaw_script,0,0,00:00:00,0,00:00:00,0,0
2017-01-26-ccc_city_script,2017/01/26,ccc_city_script,12,12,00:00:11,11,00:00:34,0,132
2017-01-26-ccc_cty_online_script,2017/01/26,ccc_cty_online_script,0,0,00:00:00,0,00:00:00,0,0
2017-01-26-ccc_feedback_script,2017/01/26,ccc_feedback_script,0,0,00:00:00,0,00:00:00,0,0
2017-01-26-ccc_fpb_script,2017/01/26,ccc_fpb_script,1,0,00:00:00,0,00:00:00,1,0
2017-01-26-ccc_help_script,2017/01/26,ccc_help_script,20,20,00:00:05,5,00:00:11,0,100
2017-01-26-ccc_link_script,2017/01/26,ccc_link_script,0,0,00:00:00,0,00:00:00,0,0
2017-01-26-ccc_media_line_script,2017/01/26,ccc_media_line_script,0,0,00:00:00,0,00:00:00,0,0
2017-01-26-ccc_priority_script,2017/01/26,ccc_priority_script,33,32,00:00:07,7,00:00:44,1,224
2017-01-26-ccc_tax_script,2017/01/26,ccc_tax_script,24,23,00:00:16,16,00:01:28,1,368
2017-01-26-ccc_waste_recycling_script,2017/01/26,ccc_waste_recycling_script,0,0,00:00:00,0,00:00:00,0,0
2017-01-28-ccc_311_calgary_script,2017/01/28,ccc_311_calgary_script,1171,1056,00:00:57,57,00:06:18,115,60192
2017-01-28-ccc_311_lobby_ph_script,2017/01/28,ccc_311_lobby_ph_script,0,0,00:00:00,0,00:00:00,0,0
2017-01-28-ccc_aserv_info_script,2017/01/28,ccc_aserv_info_script,0,0,00:00:00,0,00:00:00,0,0
2017-01-28-ccc_bylaw_script,2017/01/28,ccc_bylaw_script,0,0,00:00:00,0,00:00:00,0,0
2017-01-28-ccc_city_script,2017/01/28,ccc_city_script,0,0,00:00:00,0,00:00:00,0,0
2017-01-28-ccc_cty_online_script,2017/01/28,ccc_cty_online_script,0,0,00:00:00,0,00:00:00,0,0
2017-01-28-ccc_feedback_script,2017/01/28,ccc_feedback_script,0,0,00:00:00,0,00:00:00,0,0
2017-01-28-ccc_fpb_script,2017/01/28,ccc_fpb_script,0,0,00:00:00,0,00:00:00,0,0
2017-01-28-ccc_help_script,2017/01/28,ccc_help_script,8,7,00:00:19,19,00:00:51,1,133
2017-01-28-ccc_link_script,2017/01/28,ccc_link_script,0,0,00:00:00,0,00:00:00,0,0
2017-01-28-ccc_media_line_script,2017/01/28,ccc_media_line_script,3,3,00:00:15,15,00:00:31,0,45
2017-01-28-ccc_priority_script,2017/01/28,ccc_priority_script,16,15,00:00:07,7,00:00:14,1,105
2017-01-28-ccc_tax_script,2017/01/28,ccc_tax_script,1,1,00:02:09,129,00:02:09,0,129
2017-01-28-ccc_waste_recycling_script,2017/01/28,ccc_waste_recycling_script,0,0,00:00:00,0,00:00:00,0,0
2017-01-29-ccc_311_calgary_script,2017/01/29,ccc_311_calgary_script,958,915,00:00:26,26,00:05:20,43,23790
2017-01-29-ccc_311_lobby_ph_script,2017/01/29,ccc_311_lobby_ph_script,0,0,00:00:00,0,00:00:00,0,0
2017-01-29-ccc_aserv_info_script,2017/01/29,ccc_aserv_info_script,0,0,00:00:00,0,00:00:00,0,0
2017-01-29-ccc_bylaw_script,2017/01/29,ccc_bylaw_script,0,0,00:00:00,0,00:00:00,0,0
2017-01-29-ccc_city_script,2017/01/29,ccc_city_script,0,0,00:00:00,0,00:00:00,0,0
2017-01-29-ccc_cty_online_script,2017/01/29,ccc_cty_online_script,0,0,00:00:00,0,00:00:00,0,0
2017-01-29-ccc_feedback_script,2017/01/29,ccc_feedback_script,0,0,00:00:00,0,00:00:00,0,0
2017-01-29-ccc_fpb_script,2017/01/29,ccc_fpb_script,0,0,00:00:00,0,00:00:00,0,0
2017-01-29-ccc_help_script,2017/01/29,ccc_help_script,0,0,00:00:00,0,00:00:00,0,0
2017-01-29-ccc_link_script,2017/01/29,ccc_link_script,0,0,00:00:00,0,00:00:00,0,0
2017-01-29-ccc_media_line_script,2017/01/29,ccc_media_line_script,0,0,00:00:00,0,00:00:00,0,0
2017-01-29-ccc_priority_script,2017/01/29,ccc_priority_script,14,14,00:00:08,8,00:00:34,0,112
2017-01-29-ccc_tax_script,2017/01/29,ccc_tax_script,2,2,00:00:17,17,00:00:30,0,34
2017-01-29-ccc_waste_recycling_script,2017/01/29,ccc_waste_recycling_script,0,0,00:00:00,0,00:00:00,0,0
2017-01-30-ccc_311_calgary_script,2017/01/30,ccc_311_calgary_script,3019,2944,00:00:25,25,00:03:08,74,73600
2017-01-30-ccc_311_lobby_ph_script,2017/01/30,ccc_311_lobby_ph_script,3,2,00:00:08,8,00:00:11,1,16
2017-01-30-ccc_aserv_info_script,2017/01/30,ccc_aserv_info_script,0,0,00:00:00,0,00:00:00,0,0
2017-01-30-ccc_bylaw_script,2017/01/30,ccc_bylaw_script,0,0,00:00:00,0,00:00:00,0,0
2017-01-30-ccc_city_script,2017/01/30,ccc_city_script,20,20,00:00:12,12,00:00:37,0,240
2017-01-30-ccc_cty_online_script,2017/01/30,ccc_cty_online_script,0,0,00:00:00,0,00:00:00,0,0
2017-01-30-ccc_feedback_script,2017/01/30,ccc_feedback_script,1,0,00:00:00,0,00:00:00,0,0
2017-01-30-ccc_fpb_script,2017/01/30,ccc_fpb_script,2,2,00:00:08,8,00:00:13,0,16
2017-01-30-ccc_help_script,2017/01/30,ccc_help_script,25,24,00:00:07,7,00:00:21,1,168
2017-01-30-ccc_link_script,2017/01/30,ccc_link_script,0,0,00:00:00,0,00:00:00,0,0
2017-01-30-ccc_media_line_script,2017/01/30,ccc_media_line_script,1,1,00:00:08,8,00:00:08,0,8
2017-01-30-ccc_priority_script,2017/01/30,ccc_priority_script,15,15,00:00:14,14,00:01:28,0,210
2017-01-30-ccc_tax_script,2017/01/30,ccc_tax_script,24,23,00:00:19,19,00:02:01,1,437
2017-01-30-ccc_waste_recycling_script,2017/01/30,ccc_waste_recycling_script,0,0,00:00:00,0,00:00:00,0,0
2017-01-31-ccc_311_calgary_script,2017/01/31,ccc_311_calgary_script,2924,2688,00:01:08,68,00:06:44,236,182784
2017-01-31-ccc_311_lobby_ph_script,2017/01/31,ccc_311_lobby_ph_script,2,2,00:00:08,8,00:00:12,0,16
2017-01-31-ccc_aserv_info_script,2017/01/31,ccc_aserv_info_script,0,0,00:00:00,0,00:00:00,0,0
2017-01-31-ccc_bylaw_script,2017/01/31,ccc_bylaw_script,0,0,00:00:00,0,00:00:00,0,0
2017-01-31-ccc_city_script,2017/01/31,ccc_city_script,24,24,00:00:23,23,00:03:26,0,552
2017-01-31-ccc_cty_online_script,2017/01/31,ccc_cty_online_script,0,0,00:00:00,0,00:00:00,0,0
2017-01-31-ccc_feedback_script,2017/01/31,ccc_feedback_script,0,0,00:00:00,0,00:00:00,0,0
2017-01-31-ccc_fpb_script,2017/01/31,ccc_fpb_script,0,0,00:00:00,0,00:00:00,0,0
2017-01-31-ccc_help_script,2017/01/31,ccc_help_script,23,22,00:00:14,14,00:00:50,1,308
2017-01-31-ccc_link_script,2017/01/31,ccc_link_script,0,0,00:00:00,0,00:00:00,0,0
2017-01-31-ccc_media_line_script,2017/01/31,ccc_media_line_script,0,0,00:00:00,0,00:00:00,0,0
2017-01-31-ccc_priority_script,2017/01/31,ccc_priority_script,19,19,00:00:07,7,00:00:19,0,133
2017-01-31-ccc_tax_script,2017/01/31,ccc_tax_script,24,24,00:01:25,85,00:05:13,0,2040
2017-01-31-ccc_waste_recycling_script,2017/01/31,ccc_waste_recycling_script,0,0,00:00:00,0,00:00:00,0,0
2017-02-01-ccc_311_calgary_script,2017/02/01,ccc_311_calgary_script,2732,2625,00:00:34,34,00:09:39,107,89250
2017-02-01-ccc_311_lobby_ph_script,2017/02/01,ccc_311_lobby_ph_script,2,2,00:00:06,6,00:00:08,0,12
2017-02-01-ccc_aserv_info_script,2017/02/01,ccc_aserv_info_script,0,0,00:00:00,0,00:00:00,0,0
2017-02-01-ccc_bylaw_script,2017/02/01,ccc_bylaw_script,0,0,00:00:00,0,00:00:00,0,0
2017-02-01-ccc_city_script,2017/02/01,ccc_city_script,18,18,00:00:10,10,00:00:42,0,180
2017-02-01-ccc_cty_online_script,2017/02/01,ccc_cty_online_script,0,0,00:00:00,0,00:00:00,0,0
2017-02-01-ccc_feedback_script,2017/02/01,ccc_feedback_script,0,0,00:00:00,0,00:00:00,0,0
2017-02-01-ccc_fpb_script,2017/02/01,ccc_fpb_script,0,0,00:00:00,0,00:00:00,0,0
2017-02-01-ccc_help_script,2017/02/01,ccc_help_script,20,18,00:00:11,11,00:01:25,2,198
2017-02-01-ccc_link_script,2017/02/01,ccc_link_script,0,0,00:00:00,0,00:00:00,0,0
2017-02-01-ccc_media_line_script,2017/02/01,ccc_media_line_script,2,2,00:00:04,4,00:00:04,0,8
2017-02-01-ccc_priority_script,2017/02/01,ccc_priority_script,28,28,00:00:07,7,00:00:32,0,196
2017-02-01-ccc_tax_script,2017/02/01,ccc_tax_script,23,23,00:00:40,40,00:04:39,0,920
2017-02-01-ccc_waste_recycling_script,2017/02/01,ccc_waste_recycling_script,0,0,00:00:00,0,00:00:00,0,0
2017-02-02-ccc_311_calgary_script,2017/02/02,ccc_311_calgary_script,2649,2563,00:00:27,27,00:04:39,86,69201
2017-02-02-ccc_311_lobby_ph_script,2017/02/02,ccc_311_lobby_ph_script,1,1,00:00:04,4,00:00:04,0,4
2017-02-02-ccc_aserv_info_script,2017/02/02,ccc_aserv_info_script,0,0,00:00:00,0,00:00:00,0,0
2017-02-02-ccc_bylaw_script,2017/02/02,ccc_bylaw_script,0,0,00:00:00,0,00:00:00,0,0
2017-02-02-ccc_city_script,2017/02/02,ccc_city_script,24,24,00:00:10,10,00:00:35,0,240
2017-02-02-ccc_cty_online_script,2017/02/02,ccc_cty_online_script,0,0,00:00:00,0,00:00:00,0,0
2017-02-02-ccc_feedback_script,2017/02/02,ccc_feedback_script,0,0,00:00:00,0,00:00:00,0,0
2017-02-02-ccc_fpb_script,2017/02/02,ccc_fpb_script,0,0,00:00:00,0,00:00:00,0,0
2017-02-02-ccc_help_script,2017/02/02,ccc_help_script,15,15,00:00:09,9,00:00:26,0,135
2017-02-02-ccc_link_script,2017/02/02,ccc_link_script,0,0,00:00:00,0,00:00:00,0,0
2017-02-02-ccc_media_line_script,2017/02/02,ccc_media_line_script,0,0,00:00:00,0,00:00:00,0,0
2017-02-02-ccc_priority_script,2017/02/02,ccc_priority_script,28,28,00:00:07,7,00:00:18,0,196
2017-02-02-ccc_tax_script,2017/02/02,ccc_tax_script,29,28,00:00:29,29,00:02:56,1,812
2017-02-02-ccc_waste_recycling_script,2017/02/02,ccc_waste_recycling_script,0,0,00:00:00,0,00:00:00,0,0
2017-02-03-ccc_311_calgary_script,2017/02/03,ccc_311_calgary_script,2337,2308,00:00:14,14,00:03:41,29,32312
2017-02-03-ccc_311_lobby_ph_script,2017/02/03,ccc_311_lobby_ph_script,2,2,00:00:06,6,00:00:06,0,12
2017-02-03-ccc_aserv_info_script,2017/02/03,ccc_aserv_info_script,0,0,00:00:00,0,00:00:00,0,0
2017-02-03-ccc_bylaw_script,2017/02/03,ccc_bylaw_script,0,0,00:00:00,0,00:00:00,0,0
2017-02-03-ccc_city_script,2017/02/03,ccc_city_script,19,19,00:00:09,9,00:00:29,0,171
2017-02-03-ccc_cty_online_script,2017/02/03,ccc_cty_online_script,0,0,00:00:00,0,00:00:00,0,0
2017-02-03-ccc_feedback_script,2017/02/03,ccc_feedback_script,0,0,00:00:00,0,00:00:00,0,0
2017-02-03-ccc_fpb_script,2017/02/03,ccc_fpb_script,0,0,00:00:00,0,00:00:00,0,0
2017-02-03-ccc_help_script,2017/02/03,ccc_help_script,21,20,00:00:06,6,00:00:21,1,120
2017-02-03-ccc_link_script,2017/02/03,ccc_link_script,0,0,00:00:00,0,00:00:00,0,0
2017-02-03-ccc_media_line_script,2017/02/03,ccc_media_line_script,0,0,00:00:00,0,00:00:00,0,0
2017-02-03-ccc_priority_script,2017/02/03,ccc_priority_script,20,20,00:00:08,8,00:00:19,0,160
2017-02-03-ccc_tax_script,2017/02/03,ccc_tax_script,16,14,00:00:20,20,00:01:18,2,280
2017-02-03-ccc_waste_recycling_script,2017/02/03,ccc_waste_recycling_script,0,0,00:00:00,0,00:00:00,0,0
2017-02-04-ccc_311_calgary_script,2017/02/04,ccc_311_calgary_script,1024,1001,00:00:16,16,00:05:59,23,16016
2017-02-04-ccc_311_lobby_ph_script,2017/02/04,ccc_311_lobby_ph_script,0,0,00:00:00,0,00:00:00,0,0
2017-02-04-ccc_aserv_info_script,2017/02/04,ccc_aserv_info_script,0,0,00:00:00,0,00:00:00,0,0
2017-02-04-ccc_bylaw_script,2017/02/04,ccc_bylaw_script,0,0,00:00:00,0,00:00:00,0,0
2017-02-04-ccc_city_script,2017/02/04,ccc_city_script,0,0,00:00:00,0,00:00:00,0,0
2017-02-04-ccc_cty_online_script,2017/02/04,ccc_cty_online_script,0,0,00:00:00,0,00:00:00,0,0
2017-02-04-ccc_feedback_script,2017/02/04,ccc_feedback_script,0,0,00:00:00,0,00:00:00,0,0
2017-02-04-ccc_fpb_script,2017/02/04,ccc_fpb_script,1,0,00:00:00,0,00:00:00,1,0
2017-02-04-ccc_help_script,2017/02/04,ccc_help_script,12,12,00:00:08,8,00:00:15,0,96
2017-02-04-ccc_link_script,2017/02/04,ccc_link_script,0,0,00:00:00,0,00:00:00,0,0
2017-02-04-ccc_media_line_script,2017/02/04,ccc_media_line_script,2,1,00:00:04,4,00:00:04,1,4
2017-02-04-ccc_priority_script,2017/02/04,ccc_priority_script,38,37,00:00:07,7,00:01:04,1,259
2017-02-04-ccc_tax_script,2017/02/04,ccc_tax_script,0,0,00:00:00,0,00:00:00,0,0
2017-02-04-ccc_waste_recycling_script,2017/02/04,ccc_waste_recycling_script,0,0,00:00:00,0,00:00:00,0,0
2017-02-05-ccc_311_calgary_script,2017/02/05,ccc_311_calgary_script,854,829,00:00:13,13,00:05:00,25,10777
2017-02-05-ccc_311_lobby_ph_script,2017/02/05,ccc_311_lobby_ph_script,0,0,00:00:00,0,00:00:00,0,0
2017-02-05-ccc_aserv_info_script,2017/02/05,ccc_aserv_info_script,0,0,00:00:00,0,00:00:00,0,0
2017-02-05-ccc_bylaw_script,2017/02/05,ccc_bylaw_script,0,0,00:00:00,0,00:00:00,0,0
2017-02-05-ccc_city_script,2017/02/05,ccc_city_script,0,0,00:00:00,0,00:00:00,0,0
2017-02-05-ccc_cty_online_script,2017/02/05,ccc_cty_online_script,0,0,00:00:00,0,00:00:00,0,0
2017-02-05-ccc_feedback_script,2017/02/05,ccc_feedback_script,0,0,00:00:00,0,00:00:00,0,0
2017-02-05-ccc_fpb_script,2017/02/05,ccc_fpb_script,0,0,00:00:00,0,00:00:00,0,0
2017-02-05-ccc_help_script,2017/02/05,ccc_help_script,9,8,00:00:04,4,00:00:08,1,32
2017-02-05-ccc_link_script,2017/02/05,ccc_link_script,0,0,00:00:00,0,00:00:00,0,0
2017-02-05-ccc_media_line_script,2017/02/05,ccc_media_line_script,3,2,00:00:10,10,00:00:11,1,20
2017-02-05-ccc_priority_script,2017/02/05,ccc_priority_script,30,30,00:00:09,9,00:01:15,0,270
2017-02-05-ccc_tax_script,2017/02/05,ccc_tax_script,0,0,00:00:00,0,00:00:00,0,0
2017-02-05-ccc_waste_recycling_script,2017/02/05,ccc_waste_recycling_script,0,0,00:00:00,0,00:00:00,0,0
2017-02-06-ccc_311_calgary_script,2017/02/06,ccc_311_calgary_script,4020,3035,00:02:29,149,00:18:29,985,452215
2017-02-06-ccc_311_lobby_ph_script,2017/02/06,ccc_311_lobby_ph_script,0,0,00:00:00,0,00:00:00,0,0
2017-02-06-ccc_aserv_info_script,2017/02/06,ccc_aserv_info_script,0,0,00:00:00,0,00:00:00,0,0
2017-02-06-ccc_bylaw_script,2017/02/06,ccc_bylaw_script,0,0,00:00:00,0,00:00:00,0,0
2017-02-06-ccc_city_script,2017/02/06,ccc_city_script,12,12,00:00:41,41,00:03:08,0,492
2017-02-06-ccc_cty_online_script,2017/02/06,ccc_cty_online_script,0,0,00:00:00,0,00:00:00,0,0
2017-02-06-ccc_feedback_script,2017/02/06,ccc_feedback_script,0,0,00:00:00,0,00:00:00,0,0
2017-02-06-ccc_fpb_script,2017/02/06,ccc_fpb_script,2,1,00:00:09,9,00:00:09,1,9
2017-02-06-ccc_help_script,2017/02/06,ccc_help_script,27,20,00:00:22,22,00:01:02,7,440
2017-02-06-ccc_link_script,2017/02/06,ccc_link_script,0,0,00:00:00,0,00:00:00,0,0
2017-02-06-ccc_media_line_script,2017/02/06,ccc_media_line_script,3,3,00:00:38,38,00:01:38,0,114
2017-02-06-ccc_priority_script,2017/02/06,ccc_priority_script,95,92,00:00:15,15,00:02:44,3,1380
2017-02-06-ccc_tax_script,2017/02/06,ccc_tax_script,31,29,00:01:11,71,00:06:04,2,2059
2017-02-06-ccc_waste_recycling_script,2017/02/06,ccc_waste_recycling_script,0,0,00:00:00,0,00:00:00,0,0
2017-02-07-ccc_311_calgary_script,2017/02/07,ccc_311_calgary_script,3714,3091,00:02:19,139,00:14:41,623,429649
2017-02-07-ccc_311_lobby_ph_script,2017/02/07,ccc_311_lobby_ph_script,3,3,00:00:17,17,00:00:30,0,51
2017-02-07-ccc_aserv_info_script,2017/02/07,ccc_aserv_info_script,0,0,00:00:00,0,00:00:00,0,0
2017-02-07-ccc_bylaw_script,2017/02/07,ccc_bylaw_script,0,0,00:00:00,0,00:00:00,0,0
2017-02-07-ccc_city_script,2017/02/07,ccc_city_script,9,9,00:00:27,27,00:02:00,0,243
2017-02-07-ccc_cty_online_script,2017/02/07,ccc_cty_online_script,0,0,00:00:00,0,00:00:00,0,0
2017-02-07-ccc_feedback_script,2017/02/07,ccc_feedback_script,0,0,00:00:00,0,00:00:00,0,0
2017-02-07-ccc_fpb_script,2017/02/07,ccc_fpb_script,0,0,00:00:00,0,00:00:00,0,0
2017-02-07-ccc_help_script,2017/02/07,ccc_help_script,51,48,00:00:14,14,00:01:25,3,672
2017-02-07-ccc_link_script,2017/02/07,ccc_link_script,0,0,00:00:00,0,00:00:00,0,0
2017-02-07-ccc_media_line_script,2017/02/07,ccc_media_line_script,4,3,00:00:09,9,00:00:15,1,27
2017-02-07-ccc_priority_script,2017/02/07,ccc_priority_script,55,54,00:00:11,11,00:00:55,1,594
2017-02-07-ccc_tax_script,2017/02/07,ccc_tax_script,16,16,00:02:49,169,00:07:43,0,2704
2017-02-07-ccc_waste_recycling_script,2017/02/07,ccc_waste_recycling_script,0,0,00:00:00,0,00:00:00,0,0
2017-02-08-ccc_311_calgary_script,2017/02/08,ccc_311_calgary_script,3539,3171,00:01:22,82,00:09:20,368,260022
2017-02-08-ccc_311_lobby_ph_script,2017/02/08,ccc_311_lobby_ph_script,4,2,00:00:07,7,00:00:10,2,14
2017-02-08-ccc_aserv_info_script,2017/02/08,ccc_aserv_info_script,0,0,00:00:00,0,00:00:00,0,0
2017-02-08-ccc_bylaw_script,2017/02/08,ccc_bylaw_script,0,0,00:00:00,0,00:00:00,0,0
2017-02-08-ccc_city_script,2017/02/08,ccc_city_script,15,14,00:00:46,46,00:03:36,1,644
2017-02-08-ccc_cty_online_script,2017/02/08,ccc_cty_online_script,0,0,00:00:00,0,00:00:00,0,0
2017-02-08-ccc_feedback_script,2017/02/08,ccc_feedback_script,0,0,00:00:00,0,00:00:00,0,0
2017-02-08-ccc_fpb_script,2017/02/08,ccc_fpb_script,1,0,00:00:00,0,00:00:00,1,0
2017-02-08-ccc_help_script,2017/02/08,ccc_help_script,23,22,00:00:18,18,00:01:44,1,396
2017-02-08-ccc_link_script,2017/02/08,ccc_link_script,0,0,00:00:00,0,00:00:00,0,0
2017-02-08-ccc_media_line_script,2017/02/08,ccc_media_line_script,1,1,00:00:06,6,00:00:06,0,6
2017-02-08-ccc_priority_script,2017/02/08,ccc_priority_script,53,51,00:00:10,10,00:01:08,2,510
2017-02-08-ccc_tax_script,2017/02/08,ccc_tax_script,14,14,00:01:00,60,00:03:15,0,840
2017-02-08-ccc_waste_recycling_script,2017/02/08,ccc_waste_recycling_script,0,0,00:00:00,0,00:00:00,0,0
2017-02-09-ccc_311_calgary_script,2017/02/09,ccc_311_calgary_script,3181,2940,00:00:55,55,00:08:24,241,161700
2017-02-09-ccc_311_lobby_ph_script,2017/02/09,ccc_311_lobby_ph_script,5,4,00:00:10,10,00:00:23,1,40
2017-02-09-ccc_aserv_info_script,2017/02/09,ccc_aserv_info_script,0,0,00:00:00,0,00:00:00,0,0
2017-02-09-ccc_bylaw_script,2017/02/09,ccc_bylaw_script,0,0,00:00:00,0,00:00:00,0,0
2017-02-09-ccc_city_script,2017/02/09,ccc_city_script,13,13,00:00:11,11,00:00:27,0,143
2017-02-09-ccc_cty_online_script,2017/02/09,ccc_cty_online_script,0,0,00:00:00,0,00:00:00,0,0
2017-02-09-ccc_feedback_script,2017/02/09,ccc_feedback_script,0,0,00:00:00,0,00:00:00,0,0
2017-02-09-ccc_fpb_script,2017/02/09,ccc_fpb_script,0,0,00:00:00,0,00:00:00,0,0
2017-02-09-ccc_help_script,2017/02/09,ccc_help_script,26,23,00:00:14,14,00:00:48,3,322
2017-02-09-ccc_link_script,2017/02/09,ccc_link_script,0,0,00:00:00,0,00:00:00,0,0
2017-02-09-ccc_media_line_script,2017/02/09,ccc_media_line_script,1,0,00:00:00,0,00:00:00,1,0
2017-02-09-ccc_priority_script,2017/02/09,ccc_priority_script,36,36,00:00:14,14,00:01:15,0,504
2017-02-09-ccc_tax_script,2017/02/09,ccc_tax_script,20,20,00:00:49,49,00:03:25,0,980
2017-02-09-ccc_waste_recycling_script,2017/02/09,ccc_waste_recycling_script,0,0,00:00:00,0,00:00:00,0,0
2017-02-10-ccc_311_calgary_script,2017/02/10,ccc_311_calgary_script,2540,2505,00:00:14,14,00:07:15,35,35070
2017-02-10-ccc_311_lobby_ph_script,2017/02/10,ccc_311_lobby_ph_script,2,2,00:00:02,2,00:00:02,0,4
2017-02-10-ccc_aserv_info_script,2017/02/10,ccc_aserv_info_script,0,0,00:00:00,0,00:00:00,0,0
2017-02-10-ccc_bylaw_script,2017/02/10,ccc_bylaw_script,0,0,00:00:00,0,00:00:00,0,0
2017-02-10-ccc_city_script,2017/02/10,ccc_city_script,13,12,00:00:08,8,00:00:17,1,96
2017-02-10-ccc_cty_online_script,2017/02/10,ccc_cty_online_script,0,0,00:00:00,0,00:00:00,0,0
2017-02-10-ccc_feedback_script,2017/02/10,ccc_feedback_script,0,0,00:00:00,0,00:00:00,0,0
2017-02-10-ccc_fpb_script,2017/02/10,ccc_fpb_script,0,0,00:00:00,0,00:00:00,0,0
2017-02-10-ccc_help_script,2017/02/10,ccc_help_script,7,7,00:00:11,11,00:00:39,0,77
2017-02-10-ccc_link_script,2017/02/10,ccc_link_script,0,0,00:00:00,0,00:00:00,0,0
2017-02-10-ccc_media_line_script,2017/02/10,ccc_media_line_script,1,1,00:00:04,4,00:00:04,0,4
2017-02-10-ccc_priority_script,2017/02/10,ccc_priority_script,23,23,00:00:07,7,00:00:19,0,161
2017-02-10-ccc_tax_script,2017/02/10,ccc_tax_script,13,13,00:00:07,7,00:00:23,0,91
2017-02-10-ccc_waste_recycling_script,2017/02/10,ccc_waste_recycling_script,0,0,00:00:00,0,00:00:00,0,0
2017-02-11-ccc_311_calgary_script,2017/02/11,ccc_311_calgary_script,1150,1121,00:00:19,19,00:03:20,29,21299
2017-02-11-ccc_311_lobby_ph_script,2017/02/11,ccc_311_lobby_ph_script,0,0,00:00:00,0,00:00:00,0,0
2017-02-11-ccc_aserv_info_script,2017/02/11,ccc_aserv_info_script,0,0,00:00:00,0,00:00:00,0,0
2017-02-11-ccc_bylaw_script,2017/02/11,ccc_bylaw_script,0,0,00:00:00,0,00:00:00,0,0
2017-02-11-ccc_city_script,2017/02/11,ccc_city_script,0,0,00:00:00,0,00:00:00,0,0
2017-02-11-ccc_cty_online_script,2017/02/11,ccc_cty_online_script,0,0,00:00:00,0,00:00:00,0,0
2017-02-11-ccc_feedback_script,2017/02/11,ccc_feedback_script,0,0,00:00:00,0,00:00:00,0,0
2017-02-11-ccc_fpb_script,2017/02/11,ccc_fpb_script,0,0,00:00:00,0,00:00:00,0,0
2017-02-11-ccc_help_script,2017/02/11,ccc_help_script,8,7,00:00:18,18,00:00:38,1,126
2017-02-11-ccc_link_script,2017/02/11,ccc_link_script,0,0,00:00:00,0,00:00:00,0,0
2017-02-11-ccc_media_line_script,2017/02/11,ccc_media_line_script,1,1,00:00:02,2,00:00:02,0,2
2017-02-11-ccc_priority_script,2017/02/11,ccc_priority_script,34,32,00:00:10,10,00:01:08,2,320
2017-02-11-ccc_tax_script,2017/02/11,ccc_tax_script,0,0,00:00:00,0,00:00:00,0,0
2017-02-11-ccc_waste_recycling_script,2017/02/11,ccc_waste_recycling_script,0,0,00:00:00,0,00:00:00,0,0
2017-02-12-ccc_311_calgary_script,2017/02/12,ccc_311_calgary_script,925,911,00:00:15,15,00:04:27,14,13665
2017-02-12-ccc_311_lobby_ph_script,2017/02/12,ccc_311_lobby_ph_script,0,0,00:00:00,0,00:00:00,0,0
2017-02-12-ccc_aserv_info_script,2017/02/12,ccc_aserv_info_script,0,0,00:00:00,0,00:00:00,0,0
2017-02-12-ccc_bylaw_script,2017/02/12,ccc_bylaw_script,0,0,00:00:00,0,00:00:00,0,0
2017-02-12-ccc_city_script,2017/02/12,ccc_city_script,0,0,00:00:00,0,00:00:00,0,0
2017-02-12-ccc_cty_online_script,2017/02/12,ccc_cty_online_script,0,0,00:00:00,0,00:00:00,0,0
2017-02-12-ccc_feedback_script,2017/02/12,ccc_feedback_script,0,0,00:00:00,0,00:00:00,0,0
2017-02-12-ccc_fpb_script,2017/02/12,ccc_fpb_script,0,0,00:00:00,0,00:00:00,0,0
2017-02-12-ccc_help_script,2017/02/12,ccc_help_script,12,12,00:00:12,12,00:00:55,0,144
2017-02-12-ccc_link_script,2017/02/12,ccc_link_script,0,0,00:00:00,0,00:00:00,0,0
2017-02-12-ccc_media_line_script,2017/02/12,ccc_media_line_script,3,3,00:00:08,8,00:00:15,0,24
2017-02-12-ccc_priority_script,2017/02/12,ccc_priority_script,28,27,00:00:09,9,00:00:36,1,243
2017-02-12-ccc_tax_script,2017/02/12,ccc_tax_script,0,0,00:00:00,0,00:00:00,0,0
2017-02-12-ccc_waste_recycling_script,2017/02/12,ccc_waste_recycling_script,0,0,00:00:00,0,00:00:00,0,0
2017-02-13-ccc_311_calgary_script,2017/02/13,ccc_311_calgary_script,3135,2814,00:01:41,101,00:10:34,321,284214
2017-02-13-ccc_311_lobby_ph_script,2017/02/13,ccc_311_lobby_ph_script,1,1,00:00:11,11,00:00:11,0,11
2017-02-13-ccc_aserv_info_script,2017/02/13,ccc_aserv_info_script,0,0,00:00:00,0,00:00:00,0,0
2017-02-13-ccc_bylaw_script,2017/02/13,ccc_bylaw_script,0,0,00:00:00,0,00:00:00,0,0
2017-02-13-ccc_city_script,2017/02/13,ccc_city_script,30,30,00:00:32,32,00:04:16,0,960
2017-02-13-ccc_cty_online_script,2017/02/13,ccc_cty_online_script,0,0,00:00:00,0,00:00:00,0,0
2017-02-13-ccc_feedback_script,2017/02/13,ccc_feedback_script,0,0,00:00:00,0,00:00:00,0,0
2017-02-13-ccc_fpb_script,2017/02/13,ccc_fpb_script,2,1,00:03:16,196,00:03:16,1,196
2017-02-13-ccc_help_script,2017/02/13,ccc_help_script,21,19,00:00:15,15,00:01:14,2,285
2017-02-13-ccc_link_script,2017/02/13,ccc_link_script,0,0,00:00:00,0,00:00:00,0,0
2017-02-13-ccc_media_line_script,2017/02/13,ccc_media_line_script,1,1,00:00:25,25,00:00:25,0,25
2017-02-13-ccc_priority_script,2017/02/13,ccc_priority_script,37,36,00:00:09,9,00:00:46,1,324
2017-02-13-ccc_tax_script,2017/02/13,ccc_tax_script,20,15,00:01:32,92,00:05:48,5,1380
2017-02-13-ccc_waste_recycling_script,2017/02/13,ccc_waste_recycling_script,0,0,00:00:00,0,00:00:00,0,0
2017-02-14-ccc_311_calgary_script,2017/02/14,ccc_311_calgary_script,2797,2606,00:00:52,52,00:12:16,191,135512
2017-02-14-ccc_311_lobby_ph_script,2017/02/14,ccc_311_lobby_ph_script,0,0,00:00:00,0,00:00:00,0,0
2017-02-14-ccc_aserv_info_script,2017/02/14,ccc_aserv_info_script,0,0,00:00:00,0,00:00:00,0,0
2017-02-14-ccc_bylaw_script,2017/02/14,ccc_bylaw_script,0,0,00:00:00,0,00:00:00,0,0
2017-02-14-ccc_city_script,2017/02/14,ccc_city_script,21,21,00:00:14,14,00:00:59,0,294
2017-02-14-ccc_cty_online_script,2017/02/14,ccc_cty_online_script,0,0,00:00:00,0,00:00:00,0,0
2017-02-14-ccc_feedback_script,2017/02/14,ccc_feedback_script,0,0,00:00:00,0,00:00:00,0,0
2017-02-14-ccc_fpb_script,2017/02/14,ccc_fpb_script,0,0,00:00:00,0,00:00:00,0,0
2017-02-14-ccc_help_script,2017/02/14,ccc_help_script,25,22,00:00:11,11,00:00:42,3,242
2017-02-14-ccc_link_script,2017/02/14,ccc_link_script,0,0,00:00:00,0,00:00:00,0,0
2017-02-14-ccc_media_line_script,2017/02/14,ccc_media_line_script,4,3,00:00:11,11,00:00:14,1,33
2017-02-14-ccc_priority_script,2017/02/14,ccc_priority_script,32,31,00:00:12,12,00:01:08,1,372
2017-02-14-ccc_tax_script,2017/02/14,ccc_tax_script,25,23,00:00:40,40,00:03:09,2,920
2017-02-14-ccc_waste_recycling_script,2017/02/14,ccc_waste_recycling_script,0,0,00:00:00,0,00:00:00,0,0
2017-02-15-ccc_311_calgary_script,2017/02/15,ccc_311_calgary_script,3169,2778,00:02:01,121,00:11:45,391,336138
2017-02-15-ccc_311_lobby_ph_script,2017/02/15,ccc_311_lobby_ph_script,1,1,00:00:35,35,00:00:35,0,35
2017-02-15-ccc_aserv_info_script,2017/02/15,ccc_aserv_info_script,0,0,00:00:00,0,00:00:00,0,0
2017-02-15-ccc_bylaw_script,2017/02/15,ccc_bylaw_script,0,0,00:00:00,0,00:00:00,0,0
2017-02-15-ccc_city_script,2017/02/15,ccc_city_script,18,16,00:00:37,37,00:03:34,2,592
2017-02-15-ccc_cty_online_script,2017/02/15,ccc_cty_online_script,0,0,00:00:00,0,00:00:00,0,0
2017-02-15-ccc_feedback_script,2017/02/15,ccc_feedback_script,0,0,00:00:00,0,00:00:00,0,0
2017-02-15-ccc_fpb_script,2017/02/15,ccc_fpb_script,0,0,00:00:00,0,00:00:00,0,0
2017-02-15-ccc_help_script,2017/02/15,ccc_help_script,21,19,00:00:18,18,00:00:51,2,342
2017-02-15-ccc_link_script,2017/02/15,ccc_link_script,0,0,00:00:00,0,00:00:00,0,0
2017-02-15-ccc_media_line_script,2017/02/15,ccc_media_line_script,1,1,00:00:04,4,00:00:04,0,4
2017-02-15-ccc_priority_script,2017/02/15,ccc_priority_script,32,31,00:00:13,13,00:01:03,1,403
2017-02-15-ccc_tax_script,2017/02/15,ccc_tax_script,25,19,00:02:06,126,00:06:28,6,2394
2017-02-15-ccc_waste_recycling_script,2017/02/15,ccc_waste_recycling_script,0,0,00:00:00,0,00:00:00,0,0
2017-02-16-ccc_311_calgary_script,2017/02/16,ccc_311_calgary_script,2834,2653,00:00:48,48,00:09:29,181,127344
2017-02-16-ccc_311_lobby_ph_script,2017/02/16,ccc_311_lobby_ph_script,0,0,00:00:00,0,00:00:00,0,0
2017-02-16-ccc_aserv_info_script,2017/02/16,ccc_aserv_info_script,0,0,00:00:00,0,00:00:00,0,0
2017-02-16-ccc_bylaw_script,2017/02/16,ccc_bylaw_script,0,0,00:00:00,0,00:00:00,0,0
2017-02-16-ccc_city_script,2017/02/16,ccc_city_script,18,17,00:00:31,31,00:04:41,1,527
2017-02-16-ccc_cty_online_script,2017/02/16,ccc_cty_online_script,0,0,00:00:00,0,00:00:00,0,0
2017-02-16-ccc_feedback_script,2017/02/16,ccc_feedback_script,0,0,00:00:00,0,00:00:00,0,0
2017-02-16-ccc_fpb_script,2017/02/16,ccc_fpb_script,3,1,00:00:15,15,00:00:15,2,15
2017-02-16-ccc_help_script,2017/02/16,ccc_help_script,30,27,00:00:10,10,00:00:46,3,270
2017-02-16-ccc_link_script,2017/02/16,ccc_link_script,0,0,00:00:00,0,00:00:00,0,0
2017-02-16-ccc_media_line_script,2017/02/16,ccc_media_line_script,0,0,00:00:00,0,00:00:00,0,0
2017-02-16-ccc_priority_script,2017/02/16,ccc_priority_script,27,24,00:00:10,10,00:00:41,3,240
2017-02-16-ccc_tax_script,2017/02/16,ccc_tax_script,25,24,00:01:02,62,00:08:09,1,1488
2017-02-16-ccc_waste_recycling_script,2017/02/16,ccc_waste_recycling_script,0,0,00:00:00,0,00:00:00,0,0
2017-02-17-ccc_311_calgary_script,2017/02/17,ccc_311_calgary_script,2886,2802,00:00:21,21,00:04:29,84,58842
2017-02-17-ccc_311_lobby_ph_script,2017/02/17,ccc_311_lobby_ph_script,0,0,00:00:00,0,00:00:00,0,0
2017-02-17-ccc_aserv_info_script,2017/02/17,ccc_aserv_info_script,0,0,00:00:00,0,00:00:00,0,0
2017-02-17-ccc_bylaw_script,2017/02/17,ccc_bylaw_script,0,0,00:00:00,0,00:00:00,0,0
2017-02-17-ccc_city_script,2017/02/17,ccc_city_script,24,24,00:00:09,9,00:00:46,0,216
2017-02-17-ccc_cty_online_script,2017/02/17,ccc_cty_online_script,0,0,00:00:00,0,00:00:00,0,0
2017-02-17-ccc_feedback_script,2017/02/17,ccc_feedback_script,0,0,00:00:00,0,00:00:00,0,0
2017-02-17-ccc_fpb_script,2017/02/17,ccc_fpb_script,0,0,00:00:00,0,00:00:00,0,0
2017-02-17-ccc_help_script,2017/02/17,ccc_help_script,12,11,00:00:13,13,00:00:58,1,143
2017-02-17-ccc_link_script,2017/02/17,ccc_link_script,0,0,00:00:00,0,00:00:00,0,0
2017-02-17-ccc_media_line_script,2017/02/17,ccc_media_line_script,0,0,00:00:00,0,00:00:00,0,0
2017-02-17-ccc_priority_script,2017/02/17,ccc_priority_script,47,47,00:00:12,12,00:02:09,0,564
2017-02-17-ccc_tax_script,2017/02/17,ccc_tax_script,18,18,00:00:21,21,00:01:10,0,378
2017-02-17-ccc_waste_recycling_script,2017/02/17,ccc_waste_recycling_script,0,0,00:00:00,0,00:00:00,0,0
2017-02-18-ccc_311_calgary_script,2017/02/18,ccc_311_calgary_script,1259,1195,00:00:32,32,00:05:34,64,38240
2017-02-18-ccc_311_lobby_ph_script,2017/02/18,ccc_311_lobby_ph_script,0,0,00:00:00,0,00:00:00,0,0
2017-02-18-ccc_aserv_info_script,2017/02/18,ccc_aserv_info_script,0,0,00:00:00,0,00:00:00,0,0
2017-02-18-ccc_bylaw_script,2017/02/18,ccc_bylaw_script,0,0,00:00:00,0,00:00:00,0,0
2017-02-18-ccc_city_script,2017/02/18,ccc_city_script,0,0,00:00:00,0,00:00:00,0,0
2017-02-18-ccc_cty_online_script,2017/02/18,ccc_cty_online_script,0,0,00:00:00,0,00:00:00,0,0
2017-02-18-ccc_feedback_script,2017/02/18,ccc_feedback_script,0,0,00:00:00,0,00:00:00,0,0
2017-02-18-ccc_fpb_script,2017/02/18,ccc_fpb_script,0,0,00:00:00,0,00:00:00,0,0
2017-02-18-ccc_help_script,2017/02/18,ccc_help_script,10,9,00:00:14,14,00:00:39,1,126
2017-02-18-ccc_link_script,2017/02/18,ccc_link_script,0,0,00:00:00,0,00:00:00,0,0
2017-02-18-ccc_media_line_script,2017/02/18,ccc_media_line_script,2,2,00:00:04,4,00:00:05,0,8
2017-02-18-ccc_priority_script,2017/02/18,ccc_priority_script,30,30,00:00:11,11,00:01:05,0,330
2017-02-18-ccc_tax_script,2017/02/18,ccc_tax_script,0,0,00:00:00,0,00:00:00,0,0
2017-02-18-ccc_waste_recycling_script,2017/02/18,ccc_waste_recycling_script,0,0,00:00:00,0,00:00:00,0,0
2017-02-19-ccc_311_calgary_script,2017/02/19,ccc_311_calgary_script,854,840,00:00:10,10,00:05:58,14,8400
2017-02-19-ccc_311_lobby_ph_script,2017/02/19,ccc_311_lobby_ph_script,0,0,00:00:00,0,00:00:00,0,0
2017-02-19-ccc_aserv_info_script,2017/02/19,ccc_aserv_info_script,0,0,00:00:00,0,00:00:00,0,0
2017-02-19-ccc_bylaw_script,2017/02/19,ccc_bylaw_script,0,0,00:00:00,0,00:00:00,0,0
2017-02-19-ccc_city_script,2017/02/19,ccc_city_script,0,0,00:00:00,0,00:00:00,0,0
2017-02-19-ccc_cty_online_script,2017/02/19,ccc_cty_online_script,0,0,00:00:00,0,00:00:00,0,0
2017-02-19-ccc_feedback_script,2017/02/19,ccc_feedback_script,0,0,00:00:00,0,00:00:00,0,0
2017-02-19-ccc_fpb_script,2017/02/19,ccc_fpb_script,0,0,00:00:00,0,00:00:00,0,0
2017-02-19-ccc_help_script,2017/02/19,ccc_help_script,11,11,00:00:08,8,00:00:16,0,88
2017-02-19-ccc_link_script,2017/02/19,ccc_link_script,0,0,00:00:00,0,00:00:00,0,0
2017-02-19-ccc_media_line_script,2017/02/19,ccc_media_line_script,1,1,00:00:45,45,00:00:45,0,45
2017-02-19-ccc_priority_script,2017/02/19,ccc_priority_script,22,22,00:00:08,8,00:00:35,0,176
2017-02-19-ccc_tax_script,2017/02/19,ccc_tax_script,0,0,00:00:00,0,00:00:00,0,0
2017-02-19-ccc_waste_recycling_script,2017/02/19,ccc_waste_recycling_script,0,0,00:00:00,0,00:00:00,0,0
2017-02-20-ccc_311_calgary_script,2017/02/20,ccc_311_calgary_script,1448,1428,00:00:10,10,00:04:57,20,14280
2017-02-20-ccc_311_lobby_ph_script,2017/02/20,ccc_311_lobby_ph_script,0,0,00:00:00,0,00:00:00,0,0
2017-02-20-ccc_aserv_info_script,2017/02/20,ccc_aserv_info_script,0,0,00:00:00,0,00:00:00,0,0
2017-02-20-ccc_bylaw_script,2017/02/20,ccc_bylaw_script,0,0,00:00:00,0,00:00:00,0,0
2017-02-20-ccc_city_script,2017/02/20,ccc_city_script,0,0,00:00:00,0,00:00:00,0,0
2017-02-20-ccc_cty_online_script,2017/02/20,ccc_cty_online_script,0,0,00:00:00,0,00:00:00,0,0
2017-02-20-ccc_feedback_script,2017/02/20,ccc_feedback_script,0,0,00:00:00,0,00:00:00,0,0
2017-02-20-ccc_fpb_script,2017/02/20,ccc_fpb_script,0,0,00:00:00,0,00:00:00,0,0
2017-02-20-ccc_help_script,2017/02/20,ccc_help_script,1,1,00:00:02,2,00:00:02,0,2
2017-02-20-ccc_link_script,2017/02/20,ccc_link_script,0,0,00:00:00,0,00:00:00,0,0
2017-02-20-ccc_media_line_script,2017/02/20,ccc_media_line_script,0,0,00:00:00,0,00:00:00,0,0
2017-02-20-ccc_priority_script,2017/02/20,ccc_priority_script,21,20,00:00:05,5,00:00:09,1,100
2017-02-20-ccc_tax_script,2017/02/20,ccc_tax_script,1,1,00:00:03,3,00:00:03,0,3
2017-02-20-ccc_waste_recycling_script,2017/02/20,ccc_waste_recycling_script,0,0,00:00:00,0,00:00:00,0,0
2017-02-21-ccc_311_calgary_script,2017/02/21,ccc_311_calgary_script,3198,3059,00:00:15,15,00:05:16,77,45885
2017-02-21-ccc_311_lobby_ph_script,2017/02/21,ccc_311_lobby_ph_script,5,5,00:00:07,7,00:00:08,0,35
2017-02-21-ccc_aserv_info_script,2017/02/21,ccc_aserv_info_script,0,0,00:00:00,0,00:00:00,0,0
2017-02-21-ccc_bylaw_script,2017/02/21,ccc_bylaw_script,0,0,00:00:00,0,00:00:00,0,0
2017-02-21-ccc_city_script,2017/02/21,ccc_city_script,12,12,00:00:06,6,00:00:13,0,72
2017-02-21-ccc_cty_online_script,2017/02/21,ccc_cty_online_script,0,0,00:00:00,0,00:00:00,0,0
2017-02-21-ccc_feedback_script,2017/02/21,ccc_feedback_script,0,0,00:00:00,0,00:00:00,0,0
2017-02-21-ccc_fpb_script,2017/02/21,ccc_fpb_script,2,2,00:00:10,10,00:00:10,0,20
2017-02-21-ccc_help_script,2017/02/21,ccc_help_script,9,9,00:00:06,6,00:00:16,0,54
2017-02-21-ccc_link_script,2017/02/21,ccc_link_script,0,0,00:00:00,0,00:00:00,0,0
2017-02-21-ccc_media_line_script,2017/02/21,ccc_media_line_script,0,0,00:00:00,0,00:00:00,0,0
2017-02-21-ccc_priority_script,2017/02/21,ccc_priority_script,31,31,00:00:08,8,00:01:01,0,248
2017-02-21-ccc_tax_script,2017/02/21,ccc_tax_script,19,18,00:00:15,15,00:00:45,1,270
2017-02-21-ccc_waste_recycling_script,2017/02/21,ccc_waste_recycling_script,0,0,00:00:00,0,00:00:00,0,0
2017-02-22-ccc_311_calgary_script,2017/02/22,ccc_311_calgary_script,2730,2625,00:00:36,36,00:05:53,105,94500
2017-02-22-ccc_311_lobby_ph_script,2017/02/22,ccc_311_lobby_ph_script,6,5,00:00:07,7,00:00:15,1,35
2017-02-22-ccc_aserv_info_script,2017/02/22,ccc_aserv_info_script,0,0,00:00:00,0,00:00:00,0,0
2017-02-22-ccc_bylaw_script,2017/02/22,ccc_bylaw_script,0,0,00:00:00,0,00:00:00,0,0
2017-02-22-ccc_city_script,2017/02/22,ccc_city_script,13,13,00:00:15,15,00:00:43,0,195
2017-02-22-ccc_cty_online_script,2017/02/22,ccc_cty_online_script,0,0,00:00:00,0,00:00:00,0,0
2017-02-22-ccc_feedback_script,2017/02/22,ccc_feedback_script,0,0,00:00:00,0,00:00:00,0,0
2017-02-22-ccc_fpb_script,2017/02/22,ccc_fpb_script,0,0,00:00:00,0,00:00:00,0,0
2017-02-22-ccc_help_script,2017/02/22,ccc_help_script,10,9,00:00:07,7,00:00:13,1,63
2017-02-22-ccc_link_script,2017/02/22,ccc_link_script,0,0,00:00:00,0,00:00:00,0,0
2017-02-22-ccc_media_line_script,2017/02/22,ccc_media_line_script,0,0,00:00:00,0,00:00:00,0,0
2017-02-22-ccc_priority_script,2017/02/22,ccc_priority_script,21,21,00:00:07,7,00:00:34,0,147
2017-02-22-ccc_tax_script,2017/02/22,ccc_tax_script,23,23,00:00:58,58,00:04:28,0,1334
2017-02-22-ccc_waste_recycling_script,2017/02/22,ccc_waste_recycling_script,0,0,00:00:00,0,00:00:00,0,0
2017-02-23-ccc_311_calgary_script,2017/02/23,ccc_311_calgary_script,2563,2475,00:00:28,28,00:03:48,88,69300
2017-02-23-ccc_311_lobby_ph_script,2017/02/23,ccc_311_lobby_ph_script,4,4,00:00:16,16,00:00:25,0,64
2017-02-23-ccc_aserv_info_script,2017/02/23,ccc_aserv_info_script,0,0,00:00:00,0,00:00:00,0,0
2017-02-23-ccc_bylaw_script,2017/02/23,ccc_bylaw_script,0,0,00:00:00,0,00:00:00,0,0
2017-02-23-ccc_city_script,2017/02/23,ccc_city_script,10,10,00:00:10,10,00:00:15,0,100
2017-02-23-ccc_cty_online_script,2017/02/23,ccc_cty_online_script,0,0,00:00:00,0,00:00:00,0,0
2017-02-23-ccc_feedback_script,2017/02/23,ccc_feedback_script,0,0,00:00:00,0,00:00:00,0,0
2017-02-23-ccc_fpb_script,2017/02/23,ccc_fpb_script,0,0,00:00:00,0,00:00:00,0,0
2017-02-23-ccc_help_script,2017/02/23,ccc_help_script,3,3,00:00:03,3,00:00:06,0,9
2017-02-23-ccc_link_script,2017/02/23,ccc_link_script,0,0,00:00:00,0,00:00:00,0,0
2017-02-23-ccc_media_line_script,2017/02/23,ccc_media_line_script,1,1,00:00:10,10,00:00:10,0,10
2017-02-23-ccc_priority_script,2017/02/23,ccc_priority_script,24,24,00:00:08,8,00:00:25,0,192
2017-02-23-ccc_tax_script,2017/02/23,ccc_tax_script,32,32,00:00:22,22,00:02:25,0,704
2017-02-23-ccc_waste_recycling_script,2017/02/23,ccc_waste_recycling_script,0,0,00:00:00,0,00:00:00,0,0
2017-02-24-ccc_311_calgary_script,2017/02/24,ccc_311_calgary_script,2379,2217,00:00:43,43,00:09:59,162,95331
2017-02-24-ccc_311_lobby_ph_script,2017/02/24,ccc_311_lobby_ph_script,0,0,00:00:00,0,00:00:00,0,0
2017-02-24-ccc_aserv_info_script,2017/02/24,ccc_aserv_info_script,0,0,00:00:00,0,00:00:00,0,0
2017-02-24-ccc_bylaw_script,2017/02/24,ccc_bylaw_script,0,0,00:00:00,0,00:00:00,0,0
2017-02-24-ccc_city_script,2017/02/24,ccc_city_script,9,9,00:00:12,12,00:00:27,0,108
2017-02-24-ccc_cty_online_script,2017/02/24,ccc_cty_online_script,0,0,00:00:00,0,00:00:00,0,0
2017-02-24-ccc_feedback_script,2017/02/24,ccc_feedback_script,0,0,00:00:00,0,00:00:00,0,0
2017-02-24-ccc_fpb_script,2017/02/24,ccc_fpb_script,2,1,00:01:07,67,00:01:07,1,67
2017-02-24-ccc_help_script,2017/02/24,ccc_help_script,22,20,00:00:19,19,00:02:38,2,380
2017-02-24-ccc_link_script,2017/02/24,ccc_link_script,1,0,00:00:00,0,00:00:00,0,0
2017-02-24-ccc_media_line_script,2017/02/24,ccc_media_line_script,1,1,00:00:05,5,00:00:05,0,5
2017-02-24-ccc_priority_script,2017/02/24,ccc_priority_script,29,28,00:00:11,11,00:00:49,1,308
2017-02-24-ccc_tax_script,2017/02/24,ccc_tax_script,25,23,00:01:10,70,00:06:32,2,1610
2017-02-24-ccc_waste_recycling_script,2017/02/24,ccc_waste_recycling_script,0,0,00:00:00,0,00:00:00,0,0
2017-02-25-ccc_311_calgary_script,2017/02/25,ccc_311_calgary_script,956,895,00:00:53,53,00:12:26,61,47435
2017-02-25-ccc_311_lobby_ph_script,2017/02/25,ccc_311_lobby_ph_script,0,0,00:00:00,0,00:00:00,0,0
2017-02-25-ccc_aserv_info_script,2017/02/25,ccc_aserv_info_script,0,0,00:00:00,0,00:00:00,0,0
2017-02-25-ccc_bylaw_script,2017/02/25,ccc_bylaw_script,0,0,00:00:00,0,00:00:00,0,0
2017-02-25-ccc_city_script,2017/02/25,ccc_city_script,0,0,00:00:00,0,00:00:00,0,0
2017-02-25-ccc_cty_online_script,2017/02/25,ccc_cty_online_script,0,0,00:00:00,0,00:00:00,0,0
2017-02-25-ccc_feedback_script,2017/02/25,ccc_feedback_script,0,0,00:00:00,0,00:00:00,0,0
2017-02-25-ccc_fpb_script,2017/02/25,ccc_fpb_script,0,0,00:00:00,0,00:00:00,0,0
2017-02-25-ccc_help_script,2017/02/25,ccc_help_script,13,11,00:00:13,13,00:01:13,0,143
2017-02-25-ccc_link_script,2017/02/25,ccc_link_script,0,0,00:00:00,0,00:00:00,0,0
2017-02-25-ccc_media_line_script,2017/02/25,ccc_media_line_script,1,0,00:00:00,0,00:00:00,1,0
2017-02-25-ccc_priority_script,2017/02/25,ccc_priority_script,23,23,00:00:13,13,00:00:53,0,299
2017-02-25-ccc_tax_script,2017/02/25,ccc_tax_script,0,0,00:00:00,0,00:00:00,0,0
2017-02-25-ccc_waste_recycling_script,2017/02/25,ccc_waste_recycling_script,0,0,00:00:00,0,00:00:00,0,0
2017-02-26-ccc_311_calgary_script,2017/02/26,ccc_311_calgary_script,680,658,00:00:17,17,00:03:52,20,11186
2017-02-26-ccc_311_lobby_ph_script,2017/02/26,ccc_311_lobby_ph_script,0,0,00:00:00,0,00:00:00,0,0
2017-02-26-ccc_aserv_info_script,2017/02/26,ccc_aserv_info_script,0,0,00:00:00,0,00:00:00,0,0
2017-02-26-ccc_bylaw_script,2017/02/26,ccc_bylaw_script,0,0,00:00:00,0,00:00:00,0,0
2017-02-26-ccc_city_script,2017/02/26,ccc_city_script,0,0,00:00:00,0,00:00:00,0,0
2017-02-26-ccc_cty_online_script,2017/02/26,ccc_cty_online_script,0,0,00:00:00,0,00:00:00,0,0
2017-02-26-ccc_feedback_script,2017/02/26,ccc_feedback_script,0,0,00:00:00,0,00:00:00,0,0
2017-02-26-ccc_fpb_script,2017/02/26,ccc_fpb_script,0,0,00:00:00,0,00:00:00,0,0
2017-02-26-ccc_help_script,2017/02/26,ccc_help_script,3,3,00:00:04,4,00:00:05,0,12
2017-02-26-ccc_link_script,2017/02/26,ccc_link_script,0,0,00:00:00,0,00:00:00,0,0
2017-02-26-ccc_media_line_script,2017/02/26,ccc_media_line_script,1,1,00:00:12,12,00:00:12,0,12
2017-02-26-ccc_priority_script,2017/02/26,ccc_priority_script,9,9,00:00:07,7,00:00:10,0,63
2017-02-26-ccc_tax_script,2017/02/26,ccc_tax_script,0,0,00:00:00,0,00:00:00,0,0
2017-02-26-ccc_waste_recycling_script,2017/02/26,ccc_waste_recycling_script,0,0,00:00:00,0,00:00:00,0,0
2017-02-27-ccc_311_calgary_script,2017/02/27,ccc_311_calgary_script,2745,2608,00:00:41,41,00:06:30,137,106928
2017-02-27-ccc_311_lobby_ph_script,2017/02/27,ccc_311_lobby_ph_script,1,0,00:00:00,0,00:00:00,1,0
2017-02-27-ccc_aserv_info_script,2017/02/27,ccc_aserv_info_script,0,0,00:00:00,0,00:00:00,0,0
2017-02-27-ccc_bylaw_script,2017/02/27,ccc_bylaw_script,0,0,00:00:00,0,00:00:00,0,0
2017-02-27-ccc_city_script,2017/02/27,ccc_city_script,24,23,00:00:21,21,00:01:26,1,483
2017-02-27-ccc_cty_online_script,2017/02/27,ccc_cty_online_script,0,0,00:00:00,0,00:00:00,0,0
2017-02-27-ccc_feedback_script,2017/02/27,ccc_feedback_script,1,0,00:00:00,0,00:00:00,0,0
2017-02-27-ccc_fpb_script,2017/02/27,ccc_fpb_script,2,1,00:00:03,3,00:00:03,1,3
2017-02-27-ccc_help_script,2017/02/27,ccc_help_script,10,7,00:00:04,4,00:00:05,3,28
2017-02-27-ccc_link_script,2017/02/27,ccc_link_script,0,0,00:00:00,0,00:00:00,0,0
2017-02-27-ccc_media_line_script,2017/02/27,ccc_media_line_script,0,0,00:00:00,0,00:00:00,0,0
2017-02-27-ccc_priority_script,2017/02/27,ccc_priority_script,27,26,00:00:12,12,00:00:55,1,312
2017-02-27-ccc_tax_script,2017/02/27,ccc_tax_script,16,16,00:00:32,32,00:03:02,0,512
2017-02-27-ccc_waste_recycling_script,2017/02/27,ccc_waste_recycling_script,0,0,00:00:00,0,00:00:00,0,0
2017-02-28-ccc_311_calgary_script,2017/02/28,ccc_311_calgary_script,2493,2366,00:00:44,44,00:06:14,127,104104
2017-02-28-ccc_311_lobby_ph_script,2017/02/28,ccc_311_lobby_ph_script,1,1,00:00:15,15,00:00:15,0,15
2017-02-28-ccc_aserv_info_script,2017/02/28,ccc_aserv_info_script,0,0,00:00:00,0,00:00:00,0,0
2017-02-28-ccc_bylaw_script,2017/02/28,ccc_bylaw_script,0,0,00:00:00,0,00:00:00,0,0
2017-02-28-ccc_city_script,2017/02/28,ccc_city_script,34,34,00:00:23,23,00:02:53,0,782
2017-02-28-ccc_cty_online_script,2017/02/28,ccc_cty_online_script,0,0,00:00:00,0,00:00:00,0,0
2017-02-28-ccc_feedback_script,2017/02/28,ccc_feedback_script,0,0,00:00:00,0,00:00:00,0,0
2017-02-28-ccc_fpb_script,2017/02/28,ccc_fpb_script,1,1,00:00:04,4,00:00:04,0,4
2017-02-28-ccc_help_script,2017/02/28,ccc_help_script,11,9,00:00:10,10,00:00:17,2,90
2017-02-28-ccc_link_script,2017/02/28,ccc_link_script,0,0,00:00:00,0,00:00:00,0,0
2017-02-28-ccc_media_line_script,2017/02/28,ccc_media_line_script,1,1,00:00:10,10,00:00:10,0,10
2017-02-28-ccc_priority_script,2017/02/28,ccc_priority_script,43,43,00:00:09,9,00:00:29,0,387
2017-02-28-ccc_tax_script,2017/02/28,ccc_tax_script,22,22,00:00:46,46,00:03:10,0,1012
2017-02-28-ccc_waste_recycling_script,2017/02/28,ccc_waste_recycling_script,0,0,00:00:00,0,00:00:00,0,0
2017-03-01-ccc_311_calgary_script,2017/03/01,ccc_311_calgary_script,2527,2372,00:00:44,44,00:05:50,155,104368
2017-03-01-ccc_311_lobby_ph_script,2017/03/01,ccc_311_lobby_ph_script,3,2,00:00:04,4,00:00:04,1,8
2017-03-01-ccc_aserv_info_script,2017/03/01,ccc_aserv_info_script,0,0,00:00:00,0,00:00:00,0,0
2017-03-01-ccc_bylaw_script,2017/03/01,ccc_bylaw_script,0,0,00:00:00,0,00:00:00,0,0
2017-03-01-ccc_city_script,2017/03/01,ccc_city_script,14,13,00:00:23,23,00:01:09,1,299
2017-03-01-ccc_cty_online_script,2017/03/01,ccc_cty_online_script,0,0,00:00:00,0,00:00:00,0,0
2017-03-01-ccc_feedback_script,2017/03/01,ccc_feedback_script,0,0,00:00:00,0,00:00:00,0,0
2017-03-01-ccc_fpb_script,2017/03/01,ccc_fpb_script,1,1,00:00:21,21,00:00:21,0,21
2017-03-01-ccc_help_script,2017/03/01,ccc_help_script,10,10,00:00:08,8,00:00:21,0,80
2017-03-01-ccc_link_script,2017/03/01,ccc_link_script,0,0,00:00:00,0,00:00:00,0,0
2017-03-01-ccc_media_line_script,2017/03/01,ccc_media_line_script,2,1,00:00:06,6,00:00:06,1,6
2017-03-01-ccc_priority_script,2017/03/01,ccc_priority_script,29,26,00:00:09,9,00:00:34,3,234
2017-03-01-ccc_tax_script,2017/03/01,ccc_tax_script,21,21,00:00:24,24,00:01:56,0,504
2017-03-01-ccc_waste_recycling_script,2017/03/01,ccc_waste_recycling_script,0,0,00:00:00,0,00:00:00,0,0
2017-03-02-ccc_311_calgary_script,2017/03/02,ccc_311_calgary_script,2871,2618,00:01:08,68,00:06:51,253,178024
2017-03-02-ccc_311_lobby_ph_script,2017/03/02,ccc_311_lobby_ph_script,1,1,00:00:04,4,00:00:04,0,4
2017-03-02-ccc_aserv_info_script,2017/03/02,ccc_aserv_info_script,0,0,00:00:00,0,00:00:00,0,0
2017-03-02-ccc_bylaw_script,2017/03/02,ccc_bylaw_script,0,0,00:00:00,0,00:00:00,0,0
2017-03-02-ccc_city_script,2017/03/02,ccc_city_script,28,25,00:00:21,21,00:01:22,3,525
2017-03-02-ccc_cty_online_script,2017/03/02,ccc_cty_online_script,0,0,00:00:00,0,00:00:00,0,0
2017-03-02-ccc_feedback_script,2017/03/02,ccc_feedback_script,0,0,00:00:00,0,00:00:00,0,0
2017-03-02-ccc_fpb_script,2017/03/02,ccc_fpb_script,38,36,00:00:08,8,00:00:35,2,288
2017-03-02-ccc_help_script,2017/03/02,ccc_help_script,11,11,00:00:10,10,00:00:23,0,110
2017-03-02-ccc_link_script,2017/03/02,ccc_link_script,0,0,00:00:00,0,00:00:00,0,0
2017-03-02-ccc_media_line_script,2017/03/02,ccc_media_line_script,2,2,00:00:54,54,00:01:44,0,108
2017-03-02-ccc_priority_script,2017/03/02,ccc_priority_script,26,26,00:00:11,11,00:00:34,0,286
2017-03-02-ccc_tax_script,2017/03/02,ccc_tax_script,22,20,00:01:17,77,00:05:00,2,1540
2017-03-02-ccc_waste_recycling_script,2017/03/02,ccc_waste_recycling_script,0,0,00:00:00,0,00:00:00,0,0
2017-03-03-ccc_311_calgary_script,2017/03/03,ccc_311_calgary_script,2647,2366,00:01:28,88,00:07:32,281,208208
2017-03-03-ccc_311_lobby_ph_script,2017/03/03,ccc_311_lobby_ph_script,2,1,00:00:13,13,00:00:13,1,13
2017-03-03-ccc_aserv_info_script,2017/03/03,ccc_aserv_info_script,0,0,00:00:00,0,00:00:00,0,0
2017-03-03-ccc_bylaw_script,2017/03/03,ccc_bylaw_script,0,0,00:00:00,0,00:00:00,0,0
2017-03-03-ccc_city_script,2017/03/03,ccc_city_script,25,23,00:00:30,30,00:02:32,2,690
2017-03-03-ccc_cty_online_script,2017/03/03,ccc_cty_online_script,0,0,00:00:00,0,00:00:00,0,0
2017-03-03-ccc_feedback_script,2017/03/03,ccc_feedback_script,0,0,00:00:00,0,00:00:00,0,0
2017-03-03-ccc_fpb_script,2017/03/03,ccc_fpb_script,18,14,00:00:11,11,00:01:09,4,154
2017-03-03-ccc_help_script,2017/03/03,ccc_help_script,17,17,00:00:08,8,00:00:34,0,136
2017-03-03-ccc_link_script,2017/03/03,ccc_link_script,0,0,00:00:00,0,00:00:00,0,0
2017-03-03-ccc_media_line_script,2017/03/03,ccc_media_line_script,1,0,00:00:00,0,00:00:00,1,0
2017-03-03-ccc_priority_script,2017/03/03,ccc_priority_script,22,21,00:00:14,14,00:00:57,1,294
2017-03-03-ccc_tax_script,2017/03/03,ccc_tax_script,23,22,00:01:58,118,00:05:43,1,2596
2017-03-03-ccc_waste_recycling_script,2017/03/03,ccc_waste_recycling_script,0,0,00:00:00,0,00:00:00,0,0
2017-03-06-ccc_311_calgary_script,2017/03/06,ccc_311_calgary_script,3302,2871,00:01:35,95,00:11:21,431,272745
2017-03-06-ccc_311_lobby_ph_script,2017/03/06,ccc_311_lobby_ph_script,3,1,00:00:03,3,00:00:03,2,3
2017-03-06-ccc_aserv_info_script,2017/03/06,ccc_aserv_info_script,0,0,00:00:00,0,00:00:00,0,0
2017-03-06-ccc_bylaw_script,2017/03/06,ccc_bylaw_script,0,0,00:00:00,0,00:00:00,0,0
2017-03-06-ccc_city_script,2017/03/06,ccc_city_script,15,15,00:00:19,19,00:01:07,0,285
2017-03-06-ccc_cty_online_script,2017/03/06,ccc_cty_online_script,0,0,00:00:00,0,00:00:00,0,0
2017-03-06-ccc_feedback_script,2017/03/06,ccc_feedback_script,1,0,00:00:00,0,00:00:00,0,0
2017-03-06-ccc_fpb_script,2017/03/06,ccc_fpb_script,0,0,00:00:00,0,00:00:00,0,0
2017-03-06-ccc_help_script,2017/03/06,ccc_help_script,16,13,00:00:29,29,00:03:32,3,377
2017-03-06-ccc_link_script,2017/03/06,ccc_link_script,0,0,00:00:00,0,00:00:00,0,0
2017-03-06-ccc_media_line_script,2017/03/06,ccc_media_line_script,0,0,00:00:00,0,00:00:00,0,0
2017-03-06-ccc_priority_script,2017/03/06,ccc_priority_script,31,30,00:00:20,20,00:02:05,1,600
2017-03-06-ccc_tax_script,2017/03/06,ccc_tax_script,21,20,00:01:40,100,00:04:06,1,2000
2017-03-06-ccc_waste_recycling_script,2017/03/06,ccc_waste_recycling_script,0,0,00:00:00,0,00:00:00,0,0
2017-03-11-ccc_311_calgary_script,2017/03/11,ccc_311_calgary_script,929,899,00:00:19,19,00:04:45,30,17081
2017-03-11-ccc_311_lobby_ph_script,2017/03/11,ccc_311_lobby_ph_script,0,0,00:00:00,0,00:00:00,0,0
2017-03-11-ccc_aserv_info_script,2017/03/11,ccc_aserv_info_script,0,0,00:00:00,0,00:00:00,0,0
2017-03-11-ccc_bylaw_script,2017/03/11,ccc_bylaw_script,0,0,00:00:00,0,00:00:00,0,0
2017-03-11-ccc_city_script,2017/03/11,ccc_city_script,0,0,00:00:00,0,00:00:00,0,0
2017-03-11-ccc_cty_online_script,2017/03/11,ccc_cty_online_script,0,0,00:00:00,0,00:00:00,0,0
2017-03-11-ccc_feedback_script,2017/03/11,ccc_feedback_script,0,0,00:00:00,0,00:00:00,0,0
2017-03-11-ccc_fpb_script,2017/03/11,ccc_fpb_script,1,1,00:00:11,11,00:00:11,0,11
2017-03-11-ccc_help_script,2017/03/11,ccc_help_script,10,9,00:00:07,7,00:00:21,1,63
2017-03-11-ccc_link_script,2017/03/11,ccc_link_script,0,0,00:00:00,0,00:00:00,0,0
2017-03-11-ccc_media_line_script,2017/03/11,ccc_media_line_script,1,1,00:00:03,3,00:00:03,0,3
2017-03-11-ccc_priority_script,2017/03/11,ccc_priority_script,20,20,00:00:08,8,00:00:33,0,160
2017-03-11-ccc_tax_script,2017/03/11,ccc_tax_script,0,0,00:00:00,0,00:00:00,0,0
2017-03-11-ccc_waste_recycling_script,2017/03/11,ccc_waste_recycling_script,0,0,00:00:00,0,00:00:00,0,0
2017-03-12-ccc_311_calgary_script,2017/03/12,ccc_311_calgary_script,818,801,00:00:12,12,00:03:48,17,9612
2017-03-12-ccc_311_lobby_ph_script,2017/03/12,ccc_311_lobby_ph_script,0,0,00:00:00,0,00:00:00,0,0
2017-03-12-ccc_aserv_info_script,2017/03/12,ccc_aserv_info_script,0,0,00:00:00,0,00:00:00,0,0
2017-03-12-ccc_bylaw_script,2017/03/12,ccc_bylaw_script,0,0,00:00:00,0,00:00:00,0,0
2017-03-12-ccc_city_script,2017/03/12,ccc_city_script,0,0,00:00:00,0,00:00:00,0,0
2017-03-12-ccc_cty_online_script,2017/03/12,ccc_cty_online_script,0,0,00:00:00,0,00:00:00,0,0
2017-03-12-ccc_feedback_script,2017/03/12,ccc_feedback_script,0,0,00:00:00,0,00:00:00,0,0
2017-03-12-ccc_fpb_script,2017/03/12,ccc_fpb_script,0,0,00:00:00,0,00:00:00,0,0
2017-03-12-ccc_help_script,2017/03/12,ccc_help_script,9,9,00:00:17,17,00:01:51,0,153
2017-03-12-ccc_link_script,2017/03/12,ccc_link_script,0,0,00:00:00,0,00:00:00,0,0
2017-03-12-ccc_media_line_script,2017/03/12,ccc_media_line_script,0,0,00:00:00,0,00:00:00,0,0
2017-03-12-ccc_priority_script,2017/03/12,ccc_priority_script,28,28,00:00:11,11,00:01:27,0,308
2017-03-12-ccc_tax_script,2017/03/12,ccc_tax_script,1,1,00:00:05,5,00:00:05,0,5
2017-03-12-ccc_waste_recycling_script,2017/03/12,ccc_waste_recycling_script,0,0,00:00:00,0,00:00:00,0,0
2017-03-13-ccc_311_calgary_script,2017/03/13,ccc_311_calgary_script,2788,2673,00:00:40,40,00:06:23,115,106920
2017-03-13-ccc_311_lobby_ph_script,2017/03/13,ccc_311_lobby_ph_script,4,4,00:00:13,13,00:00:38,0,52
2017-03-13-ccc_aserv_info_script,2017/03/13,ccc_aserv_info_script,0,0,00:00:00,0,00:00:00,0,0
2017-03-13-ccc_bylaw_script,2017/03/13,ccc_bylaw_script,0,0,00:00:00,0,00:00:00,0,0
2017-03-13-ccc_city_script,2017/03/13,ccc_city_script,18,18,00:00:12,12,00:00:35,0,216
2017-03-13-ccc_cty_online_script,2017/03/13,ccc_cty_online_script,0,0,00:00:00,0,00:00:00,0,0
2017-03-13-ccc_feedback_script,2017/03/13,ccc_feedback_script,0,0,00:00:00,0,00:00:00,0,0
2017-03-13-ccc_fpb_script,2017/03/13,ccc_fpb_script,0,0,00:00:00,0,00:00:00,0,0
2017-03-13-ccc_help_script,2017/03/13,ccc_help_script,10,9,00:00:06,6,00:00:17,1,54
2017-03-13-ccc_link_script,2017/03/13,ccc_link_script,0,0,00:00:00,0,00:00:00,0,0
2017-03-13-ccc_media_line_script,2017/03/13,ccc_media_line_script,1,1,00:00:06,6,00:00:06,0,6
2017-03-13-ccc_priority_script,2017/03/13,ccc_priority_script,39,39,00:00:08,8,00:00:42,0,312
2017-03-13-ccc_tax_script,2017/03/13,ccc_tax_script,20,20,00:00:41,41,00:03:15,0,820
2017-03-13-ccc_waste_recycling_script,2017/03/13,ccc_waste_recycling_script,0,0,00:00:00,0,00:00:00,0,0
2017-03-14-ccc_311_calgary_script,2017/03/14,ccc_311_calgary_script,3315,2791,00:02:43,163,00:11:15,524,454933
2017-03-14-ccc_311_lobby_ph_script,2017/03/14,ccc_311_lobby_ph_script,3,3,00:00:17,17,00:00:42,0,51
2017-03-14-ccc_aserv_info_script,2017/03/14,ccc_aserv_info_script,0,0,00:00:00,0,00:00:00,0,0
2017-03-14-ccc_bylaw_script,2017/03/14,ccc_bylaw_script,0,0,00:00:00,0,00:00:00,0,0
2017-03-14-ccc_city_script,2017/03/14,ccc_city_script,21,19,00:00:33,33,00:02:21,2,627
2017-03-14-ccc_cty_online_script,2017/03/14,ccc_cty_online_script,0,0,00:00:00,0,00:00:00,0,0
2017-03-14-ccc_feedback_script,2017/03/14,ccc_feedback_script,0,0,00:00:00,0,00:00:00,0,0
2017-03-14-ccc_fpb_script,2017/03/14,ccc_fpb_script,0,0,00:00:00,0,00:00:00,0,0
2017-03-14-ccc_help_script,2017/03/14,ccc_help_script,68,57,00:00:16,16,00:00:57,11,912
2017-03-14-ccc_link_script,2017/03/14,ccc_link_script,2,0,00:00:00,0,00:00:00,1,0
2017-03-14-ccc_media_line_script,2017/03/14,ccc_media_line_script,1,1,00:00:03,3,00:00:03,0,3
2017-03-14-ccc_priority_script,2017/03/14,ccc_priority_script,36,35,00:00:15,15,00:00:46,1,525
2017-03-14-ccc_tax_script,2017/03/14,ccc_tax_script,23,20,00:03:17,197,00:06:06,3,3940
2017-03-14-ccc_waste_recycling_script,2017/03/14,ccc_waste_recycling_script,0,0,00:00:00,0,00:00:00,0,0
2017-03-15-ccc_311_calgary_script,2017/03/15,ccc_311_calgary_script,3327,2892,00:01:57,117,00:12:20,435,338364
2017-03-15-ccc_311_lobby_ph_script,2017/03/15,ccc_311_lobby_ph_script,4,4,00:00:14,14,00:00:32,0,56
2017-03-15-ccc_aserv_info_script,2017/03/15,ccc_aserv_info_script,0,0,00:00:00,0,00:00:00,0,0
2017-03-15-ccc_bylaw_script,2017/03/15,ccc_bylaw_script,0,0,00:00:00,0,00:00:00,0,0
2017-03-15-ccc_city_script,2017/03/15,ccc_city_script,23,20,00:00:30,30,00:03:45,3,600
2017-03-15-ccc_cty_online_script,2017/03/15,ccc_cty_online_script,0,0,00:00:00,0,00:00:00,0,0
2017-03-15-ccc_feedback_script,2017/03/15,ccc_feedback_script,0,0,00:00:00,0,00:00:00,0,0
2017-03-15-ccc_fpb_script,2017/03/15,ccc_fpb_script,3,2,00:03:21,201,00:06:39,1,402
2017-03-15-ccc_help_script,2017/03/15,ccc_help_script,54,50,00:00:17,17,00:01:36,4,850
2017-03-15-ccc_link_script,2017/03/15,ccc_link_script,0,0,00:00:00,0,00:00:00,0,0
2017-03-15-ccc_media_line_script,2017/03/15,ccc_media_line_script,3,3,00:00:04,4,00:00:05,0,12
2017-03-15-ccc_priority_script,2017/03/15,ccc_priority_script,50,49,00:00:15,15,00:01:57,1,735
2017-03-15-ccc_tax_script,2017/03/15,ccc_tax_script,30,29,00:01:37,97,00:07:21,1,2813
2017-03-15-ccc_waste_recycling_script,2017/03/15,ccc_waste_recycling_script,0,0,00:00:00,0,00:00:00,0,0
2017-03-16-ccc_311_calgary_script,2017/03/16,ccc_311_calgary_script,3025,2713,00:01:22,82,00:14:58,312,222466
2017-03-16-ccc_311_lobby_ph_script,2017/03/16,ccc_311_lobby_ph_script,2,2,00:00:07,7,00:00:07,0,14
2017-03-16-ccc_aserv_info_script,2017/03/16,ccc_aserv_info_script,0,0,00:00:00,0,00:00:00,0,0
2017-03-16-ccc_bylaw_script,2017/03/16,ccc_bylaw_script,0,0,00:00:00,0,00:00:00,0,0
2017-03-16-ccc_city_script,2017/03/16,ccc_city_script,17,16,00:00:30,30,00:04:36,1,480
2017-03-16-ccc_cty_online_script,2017/03/16,ccc_cty_online_script,0,0,00:00:00,0,00:00:00,0,0
2017-03-16-ccc_feedback_script,2017/03/16,ccc_feedback_script,0,0,00:00:00,0,00:00:00,0,0
2017-03-16-ccc_fpb_script,2017/03/16,ccc_fpb_script,1,1,00:00:34,34,00:00:34,0,34
2017-03-16-ccc_help_script,2017/03/16,ccc_help_script,32,27,00:00:15,15,00:01:42,5,405
2017-03-16-ccc_link_script,2017/03/16,ccc_link_script,0,0,00:00:00,0,00:00:00,0,0
2017-03-16-ccc_media_line_script,2017/03/16,ccc_media_line_script,3,2,00:00:08,8,00:00:11,1,16
2017-03-16-ccc_priority_script,2017/03/16,ccc_priority_script,38,38,00:00:11,11,00:00:49,0,418
2017-03-16-ccc_tax_script,2017/03/16,ccc_tax_script,27,25,00:00:41,41,00:05:27,2,1025
2017-03-16-ccc_waste_recycling_script,2017/03/16,ccc_waste_recycling_script,0,0,00:00:00,0,00:00:00,0,0
2017-03-17-ccc_311_calgary_script,2017/03/17,ccc_311_calgary_script,2500,2397,00:00:30,30,00:06:21,103,71910
2017-03-17-ccc_311_lobby_ph_script,2017/03/17,ccc_311_lobby_ph_script,0,0,00:00:00,0,00:00:00,0,0
2017-03-17-ccc_aserv_info_script,2017/03/17,ccc_aserv_info_script,0,0,00:00:00,0,00:00:00,0,0
2017-03-17-ccc_bylaw_script,2017/03/17,ccc_bylaw_script,0,0,00:00:00,0,00:00:00,0,0
2017-03-17-ccc_city_script,2017/03/17,ccc_city_script,14,14,00:00:15,15,00:00:50,0,210
2017-03-17-ccc_cty_online_script,2017/03/17,ccc_cty_online_script,0,0,00:00:00,0,00:00:00,0,0
2017-03-17-ccc_feedback_script,2017/03/17,ccc_feedback_script,0,0,00:00:00,0,00:00:00,0,0
2017-03-17-ccc_fpb_script,2017/03/17,ccc_fpb_script,3,2,00:00:02,2,00:00:03,1,4
2017-03-17-ccc_help_script,2017/03/17,ccc_help_script,20,20,00:00:08,8,00:00:26,0,160
2017-03-17-ccc_link_script,2017/03/17,ccc_link_script,0,0,00:00:00,0,00:00:00,0,0
2017-03-17-ccc_media_line_script,2017/03/17,ccc_media_line_script,1,1,00:00:03,3,00:00:03,0,3
2017-03-17-ccc_priority_script,2017/03/17,ccc_priority_script,22,22,00:00:11,11,00:00:37,0,242
2017-03-17-ccc_tax_script,2017/03/17,ccc_tax_script,20,18,00:00:21,21,00:01:50,2,378
2017-03-17-ccc_waste_recycling_script,2017/03/17,ccc_waste_recycling_script,0,0,00:00:00,0,00:00:00,0,0
2017-03-18-ccc_311_calgary_script,2017/03/18,ccc_311_calgary_script,1473,1246,00:01:47,107,00:18:43,225,133322
2017-03-18-ccc_311_lobby_ph_script,2017/03/18,ccc_311_lobby_ph_script,0,0,00:00:00,0,00:00:00,0,0
2017-03-18-ccc_aserv_info_script,2017/03/18,ccc_aserv_info_script,0,0,00:00:00,0,00:00:00,0,0
2017-03-18-ccc_bylaw_script,2017/03/18,ccc_bylaw_script,0,0,00:00:00,0,00:00:00,0,0
2017-03-18-ccc_city_script,2017/03/18,ccc_city_script,0,0,00:00:00,0,00:00:00,0,0
2017-03-18-ccc_cty_online_script,2017/03/18,ccc_cty_online_script,0,0,00:00:00,0,00:00:00,0,0
2017-03-18-ccc_feedback_script,2017/03/18,ccc_feedback_script,0,0,00:00:00,0,00:00:00,0,0
2017-03-18-ccc_fpb_script,2017/03/18,ccc_fpb_script,1,1,00:01:47,107,00:01:47,0,107
2017-03-18-ccc_help_script,2017/03/18,ccc_help_script,12,8,00:00:13,13,00:00:31,4,104
2017-03-18-ccc_link_script,2017/03/18,ccc_link_script,0,0,00:00:00,0,00:00:00,0,0
2017-03-18-ccc_media_line_script,2017/03/18,ccc_media_line_script,0,0,00:00:00,0,00:00:00,0,0
2017-03-18-ccc_priority_script,2017/03/18,ccc_priority_script,29,24,00:00:26,26,00:03:01,5,624
2017-03-18-ccc_tax_script,2017/03/18,ccc_tax_script,1,1,00:00:53,53,00:00:53,0,53
2017-03-18-ccc_waste_recycling_script,2017/03/18,ccc_waste_recycling_script,0,0,00:00:00,0,00:00:00,0,0
2017-03-19-ccc_311_calgary_script,2017/03/19,ccc_311_calgary_script,958,935,00:00:21,21,00:06:23,25,19635
2017-03-19-ccc_311_lobby_ph_script,2017/03/19,ccc_311_lobby_ph_script,0,0,00:00:00,0,00:00:00,0,0
2017-03-19-ccc_aserv_info_script,2017/03/19,ccc_aserv_info_script,0,0,00:00:00,0,00:00:00,0,0
2017-03-19-ccc_bylaw_script,2017/03/19,ccc_bylaw_script,0,0,00:00:00,0,00:00:00,0,0
2017-03-19-ccc_city_script,2017/03/19,ccc_city_script,0,0,00:00:00,0,00:00:00,0,0
2017-03-19-ccc_cty_online_script,2017/03/19,ccc_cty_online_script,0,0,00:00:00,0,00:00:00,0,0
2017-03-19-ccc_feedback_script,2017/03/19,ccc_feedback_script,0,0,00:00:00,0,00:00:00,0,0
2017-03-19-ccc_fpb_script,2017/03/19,ccc_fpb_script,0,0,00:00:00,0,00:00:00,0,0
2017-03-19-ccc_help_script,2017/03/19,ccc_help_script,4,4,00:00:13,13,00:00:35,0,52
2017-03-19-ccc_link_script,2017/03/19,ccc_link_script,0,0,00:00:00,0,00:00:00,0,0
2017-03-19-ccc_media_line_script,2017/03/19,ccc_media_line_script,0,0,00:00:00,0,00:00:00,0,0
2017-03-19-ccc_priority_script,2017/03/19,ccc_priority_script,11,10,00:00:11,11,00:00:39,1,110
2017-03-19-ccc_tax_script,2017/03/19,ccc_tax_script,0,0,00:00:00,0,00:00:00,0,0
2017-03-19-ccc_waste_recycling_script,2017/03/19,ccc_waste_recycling_script,0,0,00:00:00,0,00:00:00,0,0
2017-03-20-ccc_311_calgary_script,2017/03/20,ccc_311_calgary_script,3246,3000,00:01:01,61,00:08:26,246,183000
2017-03-20-ccc_311_lobby_ph_script,2017/03/20,ccc_311_lobby_ph_script,2,2,00:00:06,6,00:00:07,0,12
2017-03-20-ccc_aserv_info_script,2017/03/20,ccc_aserv_info_script,0,0,00:00:00,0,00:00:00,0,0
2017-03-20-ccc_bylaw_script,2017/03/20,ccc_bylaw_script,0,0,00:00:00,0,00:00:00,0,0
2017-03-20-ccc_city_script,2017/03/20,ccc_city_script,9,9,00:00:29,29,00:01:27,0,261
2017-03-20-ccc_cty_online_script,2017/03/20,ccc_cty_online_script,0,0,00:00:00,0,00:00:00,0,0
2017-03-20-ccc_feedback_script,2017/03/20,ccc_feedback_script,0,0,00:00:00,0,00:00:00,0,0
2017-03-20-ccc_fpb_script,2017/03/20,ccc_fpb_script,1,1,00:00:09,9,00:00:09,0,9
2017-03-20-ccc_help_script,2017/03/20,ccc_help_script,33,30,00:00:10,10,00:00:40,3,300
2017-03-20-ccc_link_script,2017/03/20,ccc_link_script,0,0,00:00:00,0,00:00:00,0,0
2017-03-20-ccc_media_line_script,2017/03/20,ccc_media_line_script,8,5,00:00:08,8,00:00:15,3,40
2017-03-20-ccc_priority_script,2017/03/20,ccc_priority_script,30,28,00:00:11,11,00:00:53,2,308
2017-03-20-ccc_tax_script,2017/03/20,ccc_tax_script,21,20,00:01:09,69,00:04:22,1,1380
2017-03-20-ccc_waste_recycling_script,2017/03/20,ccc_waste_recycling_script,0,0,00:00:00,0,00:00:00,0,0
2017-03-21-ccc_311_calgary_script,2017/03/21,ccc_311_calgary_script,2704,2629,00:00:20,20,00:03:29,75,52580
2017-03-21-ccc_311_lobby_ph_script,2017/03/21,ccc_311_lobby_ph_script,5,5,00:00:06,6,00:00:07,0,30
2017-03-21-ccc_aserv_info_script,2017/03/21,ccc_aserv_info_script,0,0,00:00:00,0,00:00:00,0,0
2017-03-21-ccc_bylaw_script,2017/03/21,ccc_bylaw_script,0,0,00:00:00,0,00:00:00,0,0
2017-03-21-ccc_city_script,2017/03/21,ccc_city_script,10,10,00:00:12,12,00:00:33,0,120
2017-03-21-ccc_cty_online_script,2017/03/21,ccc_cty_online_script,0,0,00:00:00,0,00:00:00,0,0
2017-03-21-ccc_feedback_script,2017/03/21,ccc_feedback_script,0,0,00:00:00,0,00:00:00,0,0
2017-03-21-ccc_fpb_script,2017/03/21,ccc_fpb_script,1,0,00:00:00,0,00:00:00,1,0
2017-03-21-ccc_help_script,2017/03/21,ccc_help_script,18,18,00:00:07,7,00:00:18,0,126
2017-03-21-ccc_link_script,2017/03/21,ccc_link_script,0,0,00:00:00,0,00:00:00,0,0
2017-03-21-ccc_media_line_script,2017/03/21,ccc_media_line_script,0,0,00:00:00,0,00:00:00,0,0
2017-03-21-ccc_priority_script,2017/03/21,ccc_priority_script,32,31,00:00:09,9,00:01:05,1,279
2017-03-21-ccc_tax_script,2017/03/21,ccc_tax_script,22,21,00:00:26,26,00:01:57,1,546
2017-03-21-ccc_waste_recycling_script,2017/03/21,ccc_waste_recycling_script,0,0,00:00:00,0,00:00:00,0,0
2017-03-22-ccc_311_calgary_script,2017/03/22,ccc_311_calgary_script,3107,2658,00:02:23,143,00:09:17,449,380094
2017-03-22-ccc_311_lobby_ph_script,2017/03/22,ccc_311_lobby_ph_script,1,1,00:00:07,7,00:00:07,0,7
2017-03-22-ccc_aserv_info_script,2017/03/22,ccc_aserv_info_script,0,0,00:00:00,0,00:00:00,0,0
2017-03-22-ccc_bylaw_script,2017/03/22,ccc_bylaw_script,0,0,00:00:00,0,00:00:00,0,0
2017-03-22-ccc_city_script,2017/03/22,ccc_city_script,14,14,00:00:52,52,00:05:20,0,728
2017-03-22-ccc_cty_online_script,2017/03/22,ccc_cty_online_script,0,0,00:00:00,0,00:00:00,0,0
2017-03-22-ccc_feedback_script,2017/03/22,ccc_feedback_script,1,0,00:00:00,0,00:00:00,1,0
2017-03-22-ccc_fpb_script,2017/03/22,ccc_fpb_script,1,1,00:00:04,4,00:00:04,0,4
2017-03-22-ccc_help_script,2017/03/22,ccc_help_script,42,37,00:00:16,16,00:01:04,5,592
2017-03-22-ccc_link_script,2017/03/22,ccc_link_script,0,0,00:00:00,0,00:00:00,0,0
2017-03-22-ccc_media_line_script,2017/03/22,ccc_media_line_script,2,2,00:00:13,13,00:00:22,0,26
2017-03-22-ccc_priority_script,2017/03/22,ccc_priority_script,29,29,00:00:08,8,00:00:21,0,232
2017-03-22-ccc_tax_script,2017/03/22,ccc_tax_script,27,22,00:02:14,134,00:06:11,5,2948
2017-03-22-ccc_waste_recycling_script,2017/03/22,ccc_waste_recycling_script,0,0,00:00:00,0,00:00:00,0,0
2017-03-23-ccc_311_calgary_script,2017/03/23,ccc_311_calgary_script,3161,2777,00:01:56,116,00:08:48,384,322132
2017-03-23-ccc_311_lobby_ph_script,2017/03/23,ccc_311_lobby_ph_script,0,0,00:00:00,0,00:00:00,0,0
2017-03-23-ccc_aserv_info_script,2017/03/23,ccc_aserv_info_script,0,0,00:00:00,0,00:00:00,0,0
2017-03-23-ccc_bylaw_script,2017/03/23,ccc_bylaw_script,0,0,00:00:00,0,00:00:00,0,0
2017-03-23-ccc_city_script,2017/03/23,ccc_city_script,8,8,00:00:31,31,00:02:10,0,248
2017-03-23-ccc_cty_online_script,2017/03/23,ccc_cty_online_script,0,0,00:00:00,0,00:00:00,0,0
2017-03-23-ccc_feedback_script,2017/03/23,ccc_feedback_script,0,0,00:00:00,0,00:00:00,0,0
2017-03-23-ccc_fpb_script,2017/03/23,ccc_fpb_script,2,2,00:01:03,63,00:02:01,0,126
2017-03-23-ccc_help_script,2017/03/23,ccc_help_script,38,30,00:00:12,12,00:00:35,8,360
2017-03-23-ccc_link_script,2017/03/23,ccc_link_script,0,0,00:00:00,0,00:00:00,0,0
2017-03-23-ccc_media_line_script,2017/03/23,ccc_media_line_script,0,0,00:00:00,0,00:00:00,0,0
2017-03-23-ccc_priority_script,2017/03/23,ccc_priority_script,39,39,00:00:13,13,00:01:46,0,507
2017-03-23-ccc_tax_script,2017/03/23,ccc_tax_script,22,20,00:01:35,95,00:05:10,2,1900
2017-03-23-ccc_waste_recycling_script,2017/03/23,ccc_waste_recycling_script,0,0,00:00:00,0,00:00:00,0,0
2017-03-24-ccc_311_calgary_script,2017/03/24,ccc_311_calgary_script,2881,2582,00:01:29,89,00:06:25,298,229798
2017-03-24-ccc_311_lobby_ph_script,2017/03/24,ccc_311_lobby_ph_script,4,1,00:00:03,3,00:00:03,3,3
2017-03-24-ccc_aserv_info_script,2017/03/24,ccc_aserv_info_script,0,0,00:00:00,0,00:00:00,0,0
2017-03-24-ccc_bylaw_script,2017/03/24,ccc_bylaw_script,0,0,00:00:00,0,00:00:00,0,0
2017-03-24-ccc_city_script,2017/03/24,ccc_city_script,11,10,00:00:32,32,00:02:39,1,320
2017-03-24-ccc_cty_online_script,2017/03/24,ccc_cty_online_script,0,0,00:00:00,0,00:00:00,0,0
2017-03-24-ccc_feedback_script,2017/03/24,ccc_feedback_script,0,0,00:00:00,0,00:00:00,0,0
2017-03-24-ccc_fpb_script,2017/03/24,ccc_fpb_script,4,1,00:00:15,15,00:00:15,3,15
2017-03-24-ccc_help_script,2017/03/24,ccc_help_script,41,34,00:00:13,13,00:01:09,7,442
2017-03-24-ccc_link_script,2017/03/24,ccc_link_script,0,0,00:00:00,0,00:00:00,0,0
2017-03-24-ccc_media_line_script,2017/03/24,ccc_media_line_script,1,1,00:01:42,102,00:01:42,0,102
2017-03-24-ccc_priority_script,2017/03/24,ccc_priority_script,30,29,00:00:14,14,00:00:54,1,406
2017-03-24-ccc_tax_script,2017/03/24,ccc_tax_script,15,13,00:01:45,105,00:04:27,2,1365
2017-03-24-ccc_waste_recycling_script,2017/03/24,ccc_waste_recycling_script,0,0,00:00:00,0,00:00:00,0,0
2017-03-25-ccc_311_calgary_script,2017/03/25,ccc_311_calgary_script,1205,1175,00:00:17,17,00:04:03,31,19975
2017-03-25-ccc_311_lobby_ph_script,2017/03/25,ccc_311_lobby_ph_script,0,0,00:00:00,0,00:00:00,0,0
2017-03-25-ccc_aserv_info_script,2017/03/25,ccc_aserv_info_script,0,0,00:00:00,0,00:00:00,0,0
2017-03-25-ccc_bylaw_script,2017/03/25,ccc_bylaw_script,0,0,00:00:00,0,00:00:00,0,0
2017-03-25-ccc_city_script,2017/03/25,ccc_city_script,0,0,00:00:00,0,00:00:00,0,0
2017-03-25-ccc_cty_online_script,2017/03/25,ccc_cty_online_script,0,0,00:00:00,0,00:00:00,0,0
2017-03-25-ccc_feedback_script,2017/03/25,ccc_feedback_script,0,0,00:00:00,0,00:00:00,0,0
2017-03-25-ccc_fpb_script,2017/03/25,ccc_fpb_script,1,1,00:00:05,5,00:00:05,0,5
2017-03-25-ccc_help_script,2017/03/25,ccc_help_script,3,3,00:00:24,24,00:01:05,0,72
2017-03-25-ccc_link_script,2017/03/25,ccc_link_script,0,0,00:00:00,0,00:00:00,0,0
2017-03-25-ccc_media_line_script,2017/03/25,ccc_media_line_script,6,5,00:00:08,8,00:00:20,1,40
2017-03-25-ccc_priority_script,2017/03/25,ccc_priority_script,16,16,00:00:07,7,00:00:13,0,112
2017-03-25-ccc_tax_script,2017/03/25,ccc_tax_script,0,0,00:00:00,0,00:00:00,0,0
2017-03-25-ccc_waste_recycling_script,2017/03/25,ccc_waste_recycling_script,0,0,00:00:00,0,00:00:00,0,0
2017-03-26-ccc_311_calgary_script,2017/03/26,ccc_311_calgary_script,1047,1027,00:00:18,18,00:04:31,20,18486
2017-03-26-ccc_311_lobby_ph_script,2017/03/26,ccc_311_lobby_ph_script,0,0,00:00:00,0,00:00:00,0,0
2017-03-26-ccc_aserv_info_script,2017/03/26,ccc_aserv_info_script,0,0,00:00:00,0,00:00:00,0,0
2017-03-26-ccc_bylaw_script,2017/03/26,ccc_bylaw_script,0,0,00:00:00,0,00:00:00,0,0
2017-03-26-ccc_city_script,2017/03/26,ccc_city_script,0,0,00:00:00,0,00:00:00,0,0
2017-03-26-ccc_cty_online_script,2017/03/26,ccc_cty_online_script,0,0,00:00:00,0,00:00:00,0,0
2017-03-26-ccc_feedback_script,2017/03/26,ccc_feedback_script,0,0,00:00:00,0,00:00:00,0,0
2017-03-26-ccc_fpb_script,2017/03/26,ccc_fpb_script,0,0,00:00:00,0,00:00:00,0,0
2017-03-26-ccc_help_script,2017/03/26,ccc_help_script,4,4,00:00:09,9,00:00:12,0,36
2017-03-26-ccc_link_script,2017/03/26,ccc_link_script,0,0,00:00:00,0,00:00:00,0,0
2017-03-26-ccc_media_line_script,2017/03/26,ccc_media_line_script,3,3,00:00:04,4,00:00:06,0,12
2017-03-26-ccc_priority_script,2017/03/26,ccc_priority_script,14,13,00:00:08,8,00:00:16,1,104
2017-03-26-ccc_tax_script,2017/03/26,ccc_tax_script,0,0,00:00:00,0,00:00:00,0,0
2017-03-26-ccc_waste_recycling_script,2017/03/26,ccc_waste_recycling_script,0,0,00:00:00,0,00:00:00,0,0
2017-03-27-ccc_311_calgary_script,2017/03/27,ccc_311_calgary_script,3485,2996,00:02:13,133,00:08:46,489,398468
2017-03-27-ccc_311_lobby_ph_script,2017/03/27,ccc_311_lobby_ph_script,0,0,00:00:00,0,00:00:00,0,0
2017-03-27-ccc_aserv_info_script,2017/03/27,ccc_aserv_info_script,0,0,00:00:00,0,00:00:00,0,0
2017-03-27-ccc_bylaw_script,2017/03/27,ccc_bylaw_script,0,0,00:00:00,0,00:00:00,0,0
2017-03-27-ccc_city_script,2017/03/27,ccc_city_script,14,14,00:00:13,13,00:00:33,0,182
2017-03-27-ccc_cty_online_script,2017/03/27,ccc_cty_online_script,0,0,00:00:00,0,00:00:00,0,0
2017-03-27-ccc_feedback_script,2017/03/27,ccc_feedback_script,0,0,00:00:00,0,00:00:00,0,0
2017-03-27-ccc_fpb_script,2017/03/27,ccc_fpb_script,2,1,00:04:39,279,00:04:39,1,279
2017-03-27-ccc_help_script,2017/03/27,ccc_help_script,39,35,00:00:14,14,00:00:59,4,490
2017-03-27-ccc_link_script,2017/03/27,ccc_link_script,0,0,00:00:00,0,00:00:00,0,0
2017-03-27-ccc_media_line_script,2017/03/27,ccc_media_line_script,0,0,00:00:00,0,00:00:00,0,0
2017-03-27-ccc_priority_script,2017/03/27,ccc_priority_script,28,27,00:00:12,12,00:00:35,1,324
2017-03-27-ccc_tax_script,2017/03/27,ccc_tax_script,31,30,00:02:20,140,00:07:21,1,4200
2017-03-27-ccc_waste_recycling_script,2017/03/27,ccc_waste_recycling_script,0,0,00:00:00,0,00:00:00,0,0
2017-03-28-ccc_311_calgary_script,2017/03/28,ccc_311_calgary_script,3169,2729,00:02:00,120,00:10:10,440,327480
2017-03-28-ccc_311_lobby_ph_script,2017/03/28,ccc_311_lobby_ph_script,2,2,00:00:36,36,00:00:49,0,72
2017-03-28-ccc_aserv_info_script,2017/03/28,ccc_aserv_info_script,0,0,00:00:00,0,00:00:00,0,0
2017-03-28-ccc_bylaw_script,2017/03/28,ccc_bylaw_script,0,0,00:00:00,0,00:00:00,0,0
2017-03-28-ccc_city_script,2017/03/28,ccc_city_script,12,11,00:00:22,22,00:01:31,1,242
2017-03-28-ccc_cty_online_script,2017/03/28,ccc_cty_online_script,0,0,00:00:00,0,00:00:00,0,0
2017-03-28-ccc_feedback_script,2017/03/28,ccc_feedback_script,0,0,00:00:00,0,00:00:00,0,0
2017-03-28-ccc_fpb_script,2017/03/28,ccc_fpb_script,0,0,00:00:00,0,00:00:00,0,0
2017-03-28-ccc_help_script,2017/03/28,ccc_help_script,54,44,00:00:21,21,00:01:46,10,924
2017-03-28-ccc_link_script,2017/03/28,ccc_link_script,0,0,00:00:00,0,00:00:00,0,0
2017-03-28-ccc_media_line_script,2017/03/28,ccc_media_line_script,2,2,00:00:11,11,00:00:18,0,22
2017-03-28-ccc_priority_script,2017/03/28,ccc_priority_script,23,22,00:00:13,13,00:01:21,1,286
2017-03-28-ccc_tax_script,2017/03/28,ccc_tax_script,24,20,00:02:28,148,00:05:44,4,2960
2017-03-28-ccc_waste_recycling_script,2017/03/28,ccc_waste_recycling_script,0,0,00:00:00,0,00:00:00,0,0
2017-03-29-ccc_311_calgary_script,2017/03/29,ccc_311_calgary_script,3103,2825,00:01:09,69,00:07:23,278,194925
2017-03-29-ccc_311_lobby_ph_script,2017/03/29,ccc_311_lobby_ph_script,3,3,00:00:13,13,00:00:26,0,39
2017-03-29-ccc_aserv_info_script,2017/03/29,ccc_aserv_info_script,0,0,00:00:00,0,00:00:00,0,0
2017-03-29-ccc_bylaw_script,2017/03/29,ccc_bylaw_script,0,0,00:00:00,0,00:00:00,0,0
2017-03-29-ccc_city_script,2017/03/29,ccc_city_script,25,25,00:00:16,16,00:00:52,0,400
2017-03-29-ccc_cty_online_script,2017/03/29,ccc_cty_online_script,0,0,00:00:00,0,00:00:00,0,0
2017-03-29-ccc_feedback_script,2017/03/29,ccc_feedback_script,0,0,00:00:00,0,00:00:00,0,0
2017-03-29-ccc_fpb_script,2017/03/29,ccc_fpb_script,2,2,00:00:38,38,00:00:50,0,76
2017-03-29-ccc_help_script,2017/03/29,ccc_help_script,13,12,00:00:17,17,00:00:50,1,204
2017-03-29-ccc_link_script,2017/03/29,ccc_link_script,0,0,00:00:00,0,00:00:00,0,0
2017-03-29-ccc_media_line_script,2017/03/29,ccc_media_line_script,1,1,00:00:03,3,00:00:03,0,3
2017-03-29-ccc_priority_script,2017/03/29,ccc_priority_script,26,26,00:00:09,9,00:00:34,0,234
2017-03-29-ccc_tax_script,2017/03/29,ccc_tax_script,13,12,00:00:51,51,00:03:24,1,612
2017-03-29-ccc_waste_recycling_script,2017/03/29,ccc_waste_recycling_script,0,0,00:00:00,0,00:00:00,0,0
2017-03-30-ccc_311_calgary_script,2017/03/30,ccc_311_calgary_script,3051,2862,00:00:45,45,00:05:55,189,128790
2017-03-30-ccc_311_lobby_ph_script,2017/03/30,ccc_311_lobby_ph_script,2,1,00:00:04,4,00:00:04,1,4
2017-03-30-ccc_aserv_info_script,2017/03/30,ccc_aserv_info_script,0,0,00:00:00,0,00:00:00,0,0
2017-03-30-ccc_bylaw_script,2017/03/30,ccc_bylaw_script,0,0,00:00:00,0,00:00:00,0,0
2017-03-30-ccc_city_script,2017/03/30,ccc_city_script,14,14,00:00:10,10,00:00:22,0,140
2017-03-30-ccc_cty_online_script,2017/03/30,ccc_cty_online_script,0,0,00:00:00,0,00:00:00,0,0
2017-03-30-ccc_feedback_script,2017/03/30,ccc_feedback_script,0,0,00:00:00,0,00:00:00,0,0
2017-03-30-ccc_fpb_script,2017/03/30,ccc_fpb_script,2,1,00:00:44,44,00:00:44,1,44
2017-03-30-ccc_help_script,2017/03/30,ccc_help_script,23,20,00:00:14,14,00:01:14,3,280
2017-03-30-ccc_link_script,2017/03/30,ccc_link_script,0,0,00:00:00,0,00:00:00,0,0
2017-03-30-ccc_media_line_script,2017/03/30,ccc_media_line_script,2,2,00:00:02,2,00:00:03,0,4
2017-03-30-ccc_priority_script,2017/03/30,ccc_priority_script,44,43,00:00:07,7,00:00:39,1,301
2017-03-30-ccc_tax_script,2017/03/30,ccc_tax_script,32,31,00:00:38,38,00:03:58,1,1178
2017-03-30-ccc_waste_recycling_script,2017/03/30,ccc_waste_recycling_script,0,0,00:00:00,0,00:00:00,0,0
2017-03-31-ccc_311_calgary_script,2017/03/31,ccc_311_calgary_script,3059,2615,00:01:56,116,00:08:49,444,303340
2017-03-31-ccc_311_lobby_ph_script,2017/03/31,ccc_311_lobby_ph_script,4,2,00:00:09,9,00:00:11,2,18
2017-03-31-ccc_aserv_info_script,2017/03/31,ccc_aserv_info_script,0,0,00:00:00,0,00:00:00,0,0
2017-03-31-ccc_bylaw_script,2017/03/31,ccc_bylaw_script,0,0,00:00:00,0,00:00:00,0,0
2017-03-31-ccc_city_script,2017/03/31,ccc_city_script,18,18,00:00:29,29,00:01:55,0,522
2017-03-31-ccc_cty_online_script,2017/03/31,ccc_cty_online_script,0,0,00:00:00,0,00:00:00,0,0
2017-03-31-ccc_feedback_script,2017/03/31,ccc_feedback_script,0,0,00:00:00,0,00:00:00,0,0
2017-03-31-ccc_fpb_script,2017/03/31,ccc_fpb_script,0,0,00:00:00,0,00:00:00,0,0
2017-03-31-ccc_help_script,2017/03/31,ccc_help_script,67,63,00:00:24,24,00:03:08,4,1512
2017-03-31-ccc_link_script,2017/03/31,ccc_link_script,0,0,00:00:00,0,00:00:00,0,0
2017-03-31-ccc_media_line_script,2017/03/31,ccc_media_line_script,0,0,00:00:00,0,00:00:00,0,0
2017-03-31-ccc_priority_script,2017/03/31,ccc_priority_script,30,29,00:00:11,11,00:00:46,1,319
2017-03-31-ccc_tax_script,2017/03/31,ccc_tax_script,24,20,00:02:22,142,00:04:43,4,2840
2017-03-31-ccc_waste_recycling_script,2017/03/31,ccc_waste_recycling_script,0,0,00:00:00,0,00:00:00,0,0
2017-04-01-ccc_311_calgary_script,2017/04/01,ccc_311_calgary_script,1984,1308,00:02:38,158,00:19:06,676,206664
2017-04-01-ccc_311_lobby_ph_script,2017/04/01,ccc_311_lobby_ph_script,0,0,00:00:00,0,00:00:00,0,0
2017-04-01-ccc_aserv_info_script,2017/04/01,ccc_aserv_info_script,0,0,00:00:00,0,00:00:00,0,0
2017-04-01-ccc_bylaw_script,2017/04/01,ccc_bylaw_script,0,0,00:00:00,0,00:00:00,0,0
2017-04-01-ccc_city_script,2017/04/01,ccc_city_script,0,0,00:00:00,0,00:00:00,0,0
2017-04-01-ccc_cty_online_script,2017/04/01,ccc_cty_online_script,0,0,00:00:00,0,00:00:00,0,0
2017-04-01-ccc_feedback_script,2017/04/01,ccc_feedback_script,0,0,00:00:00,0,00:00:00,0,0
2017-04-01-ccc_fpb_script,2017/04/01,ccc_fpb_script,2,2,00:08:32,512,00:16:58,0,1024
2017-04-01-ccc_help_script,2017/04/01,ccc_help_script,5,4,00:00:25,25,00:01:01,1,100
2017-04-01-ccc_link_script,2017/04/01,ccc_link_script,0,0,00:00:00,0,00:00:00,0,0
2017-04-01-ccc_media_line_script,2017/04/01,ccc_media_line_script,2,2,00:00:04,4,00:00:05,0,8
2017-04-01-ccc_priority_script,2017/04/01,ccc_priority_script,26,25,00:00:22,22,00:01:55,1,550
2017-04-01-ccc_tax_script,2017/04/01,ccc_tax_script,1,1,00:00:17,17,00:00:17,0,17
2017-04-01-ccc_waste_recycling_script,2017/04/01,ccc_waste_recycling_script,0,0,00:00:00,0,00:00:00,0,0
2017-04-02-ccc_311_calgary_script,2017/04/02,ccc_311_calgary_script,800,764,00:00:22,22,00:05:33,36,16808
2017-04-02-ccc_311_lobby_ph_script,2017/04/02,ccc_311_lobby_ph_script,0,0,00:00:00,0,00:00:00,0,0
2017-04-02-ccc_aserv_info_script,2017/04/02,ccc_aserv_info_script,0,0,00:00:00,0,00:00:00,0,0
2017-04-02-ccc_bylaw_script,2017/04/02,ccc_bylaw_script,0,0,00:00:00,0,00:00:00,0,0
2017-04-02-ccc_city_script,2017/04/02,ccc_city_script,0,0,00:00:00,0,00:00:00,0,0
2017-04-02-ccc_cty_online_script,2017/04/02,ccc_cty_online_script,0,0,00:00:00,0,00:00:00,0,0
2017-04-02-ccc_feedback_script,2017/04/02,ccc_feedback_script,0,0,00:00:00,0,00:00:00,0,0
2017-04-02-ccc_fpb_script,2017/04/02,ccc_fpb_script,1,1,00:00:04,4,00:00:04,0,4
2017-04-02-ccc_help_script,2017/04/02,ccc_help_script,2,2,00:00:23,23,00:00:42,0,46
2017-04-02-ccc_link_script,2017/04/02,ccc_link_script,0,0,00:00:00,0,00:00:00,0,0
2017-04-02-ccc_media_line_script,2017/04/02,ccc_media_line_script,2,2,00:00:04,4,00:00:05,0,8
2017-04-02-ccc_priority_script,2017/04/02,ccc_priority_script,9,9,00:00:13,13,00:00:52,0,117
2017-04-02-ccc_tax_script,2017/04/02,ccc_tax_script,0,0,00:00:00,0,00:00:00,0,0
2017-04-02-ccc_waste_recycling_script,2017/04/02,ccc_waste_recycling_script,0,0,00:00:00,0,00:00:00,0,0
2017-04-03-ccc_311_calgary_script,2017/04/03,ccc_311_calgary_script,3465,2833,00:03:05,185,00:09:01,631,524105
2017-04-03-ccc_311_lobby_ph_script,2017/04/03,ccc_311_lobby_ph_script,3,3,00:00:13,13,00:00:18,0,39
2017-04-03-ccc_aserv_info_script,2017/04/03,ccc_aserv_info_script,0,0,00:00:00,0,00:00:00,0,0
2017-04-03-ccc_bylaw_script,2017/04/03,ccc_bylaw_script,0,0,00:00:00,0,00:00:00,0,0
2017-04-03-ccc_city_script,2017/04/03,ccc_city_script,13,11,00:01:17,77,00:03:58,2,847
2017-04-03-ccc_cty_online_script,2017/04/03,ccc_cty_online_script,0,0,00:00:00,0,00:00:00,0,0
2017-04-03-ccc_feedback_script,2017/04/03,ccc_feedback_script,0,0,00:00:00,0,00:00:00,0,0
2017-04-03-ccc_fpb_script,2017/04/03,ccc_fpb_script,0,0,00:00:00,0,00:00:00,0,0
2017-04-03-ccc_help_script,2017/04/03,ccc_help_script,31,26,00:00:16,16,00:01:35,5,416
2017-04-03-ccc_link_script,2017/04/03,ccc_link_script,0,0,00:00:00,0,00:00:00,0,0
2017-04-03-ccc_media_line_script,2017/04/03,ccc_media_line_script,0,0,00:00:00,0,00:00:00,0,0
2017-04-03-ccc_priority_script,2017/04/03,ccc_priority_script,18,17,00:00:12,12,00:00:33,1,204
2017-04-03-ccc_tax_script,2017/04/03,ccc_tax_script,21,20,00:04:27,267,00:07:19,1,5340
2017-04-03-ccc_waste_recycling_script,2017/04/03,ccc_waste_recycling_script,0,0,00:00:00,0,00:00:00,0,0
2017-04-04-ccc_311_calgary_script,2017/04/04,ccc_311_calgary_script,3421,2889,00:02:32,152,00:13:42,532,439128
2017-04-04-ccc_311_lobby_ph_script,2017/04/04,ccc_311_lobby_ph_script,2,2,00:00:11,11,00:00:18,0,22
2017-04-04-ccc_aserv_info_script,2017/04/04,ccc_aserv_info_script,0,0,00:00:00,0,00:00:00,0,0
2017-04-04-ccc_bylaw_script,2017/04/04,ccc_bylaw_script,0,0,00:00:00,0,00:00:00,0,0
2017-04-04-ccc_city_script,2017/04/04,ccc_city_script,9,9,00:00:21,21,00:01:16,0,189
2017-04-04-ccc_cty_online_script,2017/04/04,ccc_cty_online_script,0,0,00:00:00,0,00:00:00,0,0
2017-04-04-ccc_feedback_script,2017/04/04,ccc_feedback_script,1,0,00:00:00,0,00:00:00,0,0
2017-04-04-ccc_fpb_script,2017/04/04,ccc_fpb_script,3,1,00:00:07,7,00:00:07,2,7
2017-04-04-ccc_help_script,2017/04/04,ccc_help_script,33,27,00:00:15,15,00:00:52,6,405
2017-04-04-ccc_link_script,2017/04/04,ccc_link_script,0,0,00:00:00,0,00:00:00,0,0
2017-04-04-ccc_media_line_script,2017/04/04,ccc_media_line_script,0,0,00:00:00,0,00:00:00,0,0
2017-04-04-ccc_priority_script,2017/04/04,ccc_priority_script,25,24,00:00:13,13,00:00:40,1,312
2017-04-04-ccc_tax_script,2017/04/04,ccc_tax_script,19,15,00:02:17,137,00:05:54,4,2055
2017-04-04-ccc_waste_recycling_script,2017/04/04,ccc_waste_recycling_script,0,0,00:00:00,0,00:00:00,0,0
2017-04-05-ccc_311_calgary_script,2017/04/05,ccc_311_calgary_script,3585,3007,00:02:41,161,00:11:42,578,484127
2017-04-05-ccc_311_lobby_ph_script,2017/04/05,ccc_311_lobby_ph_script,2,2,00:00:32,32,00:00:47,0,64
2017-04-05-ccc_aserv_info_script,2017/04/05,ccc_aserv_info_script,0,0,00:00:00,0,00:00:00,0,0
2017-04-05-ccc_bylaw_script,2017/04/05,ccc_bylaw_script,0,0,00:00:00,0,00:00:00,0,0
2017-04-05-ccc_city_script,2017/04/05,ccc_city_script,19,19,00:01:11,71,00:07:33,0,1349
2017-04-05-ccc_cty_online_script,2017/04/05,ccc_cty_online_script,0,0,00:00:00,0,00:00:00,0,0
2017-04-05-ccc_feedback_script,2017/04/05,ccc_feedback_script,0,0,00:00:00,0,00:00:00,0,0
2017-04-05-ccc_fpb_script,2017/04/05,ccc_fpb_script,3,3,00:03:17,197,00:05:38,0,591
2017-04-05-ccc_help_script,2017/04/05,ccc_help_script,27,26,00:00:16,16,00:01:00,1,416
2017-04-05-ccc_link_script,2017/04/05,ccc_link_script,0,0,00:00:00,0,00:00:00,0,0
2017-04-05-ccc_media_line_script,2017/04/05,ccc_media_line_script,0,0,00:00:00,0,00:00:00,0,0
2017-04-05-ccc_priority_script,2017/04/05,ccc_priority_script,32,29,00:00:16,16,00:01:58,3,464
2017-04-05-ccc_tax_script,2017/04/05,ccc_tax_script,27,20,00:02:43,163,00:11:01,7,3260
2017-04-05-ccc_waste_recycling_script,2017/04/05,ccc_waste_recycling_script,0,0,00:00:00,0,00:00:00,0,0
2017-04-06-ccc_311_calgary_script,2017/04/06,ccc_311_calgary_script,3163,3013,00:00:44,44,00:05:30,150,132572
2017-04-06-ccc_311_lobby_ph_script,2017/04/06,ccc_311_lobby_ph_script,2,1,00:00:04,4,00:00:04,1,4
2017-04-06-ccc_aserv_info_script,2017/04/06,ccc_aserv_info_script,0,0,00:00:00,0,00:00:00,0,0
2017-04-06-ccc_bylaw_script,2017/04/06,ccc_bylaw_script,0,0,00:00:00,0,00:00:00,0,0
2017-04-06-ccc_city_script,2017/04/06,ccc_city_script,11,10,00:00:23,23,00:00:58,1,230
2017-04-06-ccc_cty_online_script,2017/04/06,ccc_cty_online_script,0,0,00:00:00,0,00:00:00,0,0
2017-04-06-ccc_feedback_script,2017/04/06,ccc_feedback_script,0,0,00:00:00,0,00:00:00,0,0
2017-04-06-ccc_fpb_script,2017/04/06,ccc_fpb_script,1,1,00:00:02,2,00:00:02,0,2
2017-04-06-ccc_help_script,2017/04/06,ccc_help_script,32,29,00:00:12,12,00:00:41,3,348
2017-04-06-ccc_link_script,2017/04/06,ccc_link_script,0,0,00:00:00,0,00:00:00,0,0
2017-04-06-ccc_media_line_script,2017/04/06,ccc_media_line_script,2,1,00:00:02,2,00:00:02,1,2
2017-04-06-ccc_priority_script,2017/04/06,ccc_priority_script,32,32,00:00:08,8,00:00:39,0,256
2017-04-06-ccc_tax_script,2017/04/06,ccc_tax_script,22,21,00:00:19,19,00:02:38,1,399
2017-04-06-ccc_waste_recycling_script,2017/04/06,ccc_waste_recycling_script,0,0,00:00:00,0,00:00:00,0,0
2017-04-07-ccc_311_calgary_script,2017/04/07,ccc_311_calgary_script,2863,2759,00:00:40,40,00:04:43,104,110360
2017-04-07-ccc_311_lobby_ph_script,2017/04/07,ccc_311_lobby_ph_script,1,1,00:00:05,5,00:00:05,0,5
2017-04-07-ccc_aserv_info_script,2017/04/07,ccc_aserv_info_script,0,0,00:00:00,0,00:00:00,0,0
2017-04-07-ccc_bylaw_script,2017/04/07,ccc_bylaw_script,0,0,00:00:00,0,00:00:00,0,0
2017-04-07-ccc_city_script,2017/04/07,ccc_city_script,16,16,00:00:20,20,00:01:17,0,320
2017-04-07-ccc_cty_online_script,2017/04/07,ccc_cty_online_script,0,0,00:00:00,0,00:00:00,0,0
2017-04-07-ccc_feedback_script,2017/04/07,ccc_feedback_script,0,0,00:00:00,0,00:00:00,0,0
2017-04-07-ccc_fpb_script,2017/04/07,ccc_fpb_script,0,0,00:00:00,0,00:00:00,0,0
2017-04-07-ccc_help_script,2017/04/07,ccc_help_script,18,17,00:00:12,12,00:00:42,1,204
2017-04-07-ccc_link_script,2017/04/07,ccc_link_script,0,0,00:00:00,0,00:00:00,0,0
2017-04-07-ccc_media_line_script,2017/04/07,ccc_media_line_script,0,0,00:00:00,0,00:00:00,0,0
2017-04-07-ccc_priority_script,2017/04/07,ccc_priority_script,29,27,00:00:09,9,00:00:32,2,243
2017-04-07-ccc_tax_script,2017/04/07,ccc_tax_script,28,28,00:00:24,24,00:03:00,0,672
2017-04-07-ccc_waste_recycling_script,2017/04/07,ccc_waste_recycling_script,0,0,00:00:00,0,00:00:00,0,0
2017-04-08-ccc_311_calgary_script,2017/04/08,ccc_311_calgary_script,1314,1196,00:00:56,56,00:10:25,118,66976
2017-04-08-ccc_311_lobby_ph_script,2017/04/08,ccc_311_lobby_ph_script,0,0,00:00:00,0,00:00:00,0,0
2017-04-08-ccc_aserv_info_script,2017/04/08,ccc_aserv_info_script,0,0,00:00:00,0,00:00:00,0,0
2017-04-08-ccc_bylaw_script,2017/04/08,ccc_bylaw_script,0,0,00:00:00,0,00:00:00,0,0
2017-04-08-ccc_city_script,2017/04/08,ccc_city_script,0,0,00:00:00,0,00:00:00,0,0
2017-04-08-ccc_cty_online_script,2017/04/08,ccc_cty_online_script,0,0,00:00:00,0,00:00:00,0,0
2017-04-08-ccc_feedback_script,2017/04/08,ccc_feedback_script,0,0,00:00:00,0,00:00:00,0,0
2017-04-08-ccc_fpb_script,2017/04/08,ccc_fpb_script,0,0,00:00:00,0,00:00:00,0,0
2017-04-08-ccc_help_script,2017/04/08,ccc_help_script,4,4,00:00:16,16,00:00:53,0,64
2017-04-08-ccc_link_script,2017/04/08,ccc_link_script,0,0,00:00:00,0,00:00:00,0,0
2017-04-08-ccc_media_line_script,2017/04/08,ccc_media_line_script,1,1,00:00:53,53,00:00:53,0,53
2017-04-08-ccc_priority_script,2017/04/08,ccc_priority_script,20,19,00:00:14,14,00:00:57,1,266
2017-04-08-ccc_tax_script,2017/04/08,ccc_tax_script,2,2,00:01:04,64,00:02:05,0,128
2017-04-08-ccc_waste_recycling_script,2017/04/08,ccc_waste_recycling_script,0,0,00:00:00,0,00:00:00,0,0
2017-04-09-ccc_311_calgary_script,2017/04/09,ccc_311_calgary_script,871,830,00:00:37,37,00:07:52,41,30710
2017-04-09-ccc_311_lobby_ph_script,2017/04/09,ccc_311_lobby_ph_script,0,0,00:00:00,0,00:00:00,0,0
2017-04-09-ccc_aserv_info_script,2017/04/09,ccc_aserv_info_script,0,0,00:00:00,0,00:00:00,0,0
2017-04-09-ccc_bylaw_script,2017/04/09,ccc_bylaw_script,0,0,00:00:00,0,00:00:00,0,0
2017-04-09-ccc_city_script,2017/04/09,ccc_city_script,0,0,00:00:00,0,00:00:00,0,0
2017-04-09-ccc_cty_online_script,2017/04/09,ccc_cty_online_script,0,0,00:00:00,0,00:00:00,0,0
2017-04-09-ccc_feedback_script,2017/04/09,ccc_feedback_script,0,0,00:00:00,0,00:00:00,0,0
2017-04-09-ccc_fpb_script,2017/04/09,ccc_fpb_script,2,2,00:00:26,26,00:00:39,0,52
2017-04-09-ccc_help_script,2017/04/09,ccc_help_script,4,4,00:00:05,5,00:00:08,0,20
2017-04-09-ccc_link_script,2017/04/09,ccc_link_script,0,0,00:00:00,0,00:00:00,0,0
2017-04-09-ccc_media_line_script,2017/04/09,ccc_media_line_script,0,0,00:00:00,0,00:00:00,0,0
2017-04-09-ccc_priority_script,2017/04/09,ccc_priority_script,12,12,00:00:12,12,00:00:35,0,144
2017-04-09-ccc_tax_script,2017/04/09,ccc_tax_script,0,0,00:00:00,0,00:00:00,0,0
2017-04-09-ccc_waste_recycling_script,2017/04/09,ccc_waste_recycling_script,0,0,00:00:00,0,00:00:00,0,0
2017-04-10-ccc_311_calgary_script,2017/04/10,ccc_311_calgary_script,3533,3332,00:01:00,60,00:05:50,201,199920
2017-04-10-ccc_311_lobby_ph_script,2017/04/10,ccc_311_lobby_ph_script,1,1,00:00:04,4,00:00:04,0,4
2017-04-10-ccc_aserv_info_script,2017/04/10,ccc_aserv_info_script,0,0,00:00:00,0,00:00:00,0,0
2017-04-10-ccc_bylaw_script,2017/04/10,ccc_bylaw_script,0,0,00:00:00,0,00:00:00,0,0
2017-04-10-ccc_city_script,2017/04/10,ccc_city_script,18,18,00:00:21,21,00:02:01,0,378
2017-04-10-ccc_cty_online_script,2017/04/10,ccc_cty_online_script,0,0,00:00:00,0,00:00:00,0,0
2017-04-10-ccc_feedback_script,2017/04/10,ccc_feedback_script,0,0,00:00:00,0,00:00:00,0,0
2017-04-10-ccc_fpb_script,2017/04/10,ccc_fpb_script,2,2,00:00:32,32,00:00:59,0,64
2017-04-10-ccc_help_script,2017/04/10,ccc_help_script,7,7,00:00:09,9,00:00:21,0,63
2017-04-10-ccc_link_script,2017/04/10,ccc_link_script,0,0,00:00:00,0,00:00:00,0,0
2017-04-10-ccc_media_line_script,2017/04/10,ccc_media_line_script,1,1,00:00:03,3,00:00:03,0,3
2017-04-10-ccc_priority_script,2017/04/10,ccc_priority_script,24,24,00:00:08,8,00:00:18,0,192
2017-04-10-ccc_tax_script,2017/04/10,ccc_tax_script,17,16,00:01:23,83,00:04:57,1,1328
2017-04-10-ccc_waste_recycling_script,2017/04/10,ccc_waste_recycling_script,0,0,00:00:00,0,00:00:00,0,0
2017-04-11-ccc_311_calgary_script,2017/04/11,ccc_311_calgary_script,3266,2820,00:02:18,138,00:08:16,446,389160
2017-04-11-ccc_311_lobby_ph_script,2017/04/11,ccc_311_lobby_ph_script,2,2,00:00:13,13,00:00:21,0,26
2017-04-11-ccc_aserv_info_script,2017/04/11,ccc_aserv_info_script,0,0,00:00:00,0,00:00:00,0,0
2017-04-11-ccc_bylaw_script,2017/04/11,ccc_bylaw_script,0,0,00:00:00,0,00:00:00,0,0
2017-04-11-ccc_city_script,2017/04/11,ccc_city_script,20,19,00:00:26,26,00:02:01,1,494
2017-04-11-ccc_cty_online_script,2017/04/11,ccc_cty_online_script,0,0,00:00:00,0,00:00:00,0,0
2017-04-11-ccc_feedback_script,2017/04/11,ccc_feedback_script,0,0,00:00:00,0,00:00:00,0,0
2017-04-11-ccc_fpb_script,2017/04/11,ccc_fpb_script,1,1,00:03:52,232,00:03:52,0,232
2017-04-11-ccc_help_script,2017/04/11,ccc_help_script,30,28,00:00:12,12,00:00:38,2,336
2017-04-11-ccc_link_script,2017/04/11,ccc_link_script,0,0,00:00:00,0,00:00:00,0,0
2017-04-11-ccc_media_line_script,2017/04/11,ccc_media_line_script,0,0,00:00:00,0,00:00:00,0,0
2017-04-11-ccc_priority_script,2017/04/11,ccc_priority_script,20,20,00:00:15,15,00:02:09,0,300
2017-04-11-ccc_tax_script,2017/04/11,ccc_tax_script,29,26,00:02:27,147,00:07:38,3,3822
2017-04-11-ccc_waste_recycling_script,2017/04/11,ccc_waste_recycling_script,0,0,00:00:00,0,00:00:00,0,0
2017-04-12-ccc_311_calgary_script,2017/04/12,ccc_311_calgary_script,3064,2953,00:00:28,28,00:04:10,111,82684
2017-04-12-ccc_311_lobby_ph_script,2017/04/12,ccc_311_lobby_ph_script,6,3,00:00:04,4,00:00:07,3,12
2017-04-12-ccc_aserv_info_script,2017/04/12,ccc_aserv_info_script,0,0,00:00:00,0,00:00:00,0,0
2017-04-12-ccc_bylaw_script,2017/04/12,ccc_bylaw_script,0,0,00:00:00,0,00:00:00,0,0
2017-04-12-ccc_city_script,2017/04/12,ccc_city_script,16,16,00:00:12,12,00:00:43,0,192
2017-04-12-ccc_cty_online_script,2017/04/12,ccc_cty_online_script,0,0,00:00:00,0,00:00:00,0,0
2017-04-12-ccc_feedback_script,2017/04/12,ccc_feedback_script,0,0,00:00:00,0,00:00:00,0,0
2017-04-12-ccc_fpb_script,2017/04/12,ccc_fpb_script,1,0,00:00:00,0,00:00:00,1,0
2017-04-12-ccc_help_script,2017/04/12,ccc_help_script,23,20,00:00:08,8,00:00:29,3,160
2017-04-12-ccc_link_script,2017/04/12,ccc_link_script,0,0,00:00:00,0,00:00:00,0,0
2017-04-12-ccc_media_line_script,2017/04/12,ccc_media_line_script,0,0,00:00:00,0,00:00:00,0,0
2017-04-12-ccc_priority_script,2017/04/12,ccc_priority_script,21,21,00:00:08,8,00:00:29,0,168
2017-04-12-ccc_tax_script,2017/04/12,ccc_tax_script,22,22,00:00:34,34,00:02:27,0,748
2017-04-12-ccc_waste_recycling_script,2017/04/12,ccc_waste_recycling_script,0,0,00:00:00,0,00:00:00,0,0
2017-04-13-ccc_311_calgary_script,2017/04/13,ccc_311_calgary_script,2959,2872,00:00:24,24,00:04:41,87,68928
2017-04-13-ccc_311_lobby_ph_script,2017/04/13,ccc_311_lobby_ph_script,5,5,00:00:05,5,00:00:06,0,25
2017-04-13-ccc_aserv_info_script,2017/04/13,ccc_aserv_info_script,0,0,00:00:00,0,00:00:00,0,0
2017-04-13-ccc_bylaw_script,2017/04/13,ccc_bylaw_script,0,0,00:00:00,0,00:00:00,0,0
2017-04-13-ccc_city_script,2017/04/13,ccc_city_script,12,12,00:00:09,9,00:00:14,0,108
2017-04-13-ccc_cty_online_script,2017/04/13,ccc_cty_online_script,0,0,00:00:00,0,00:00:00,0,0
2017-04-13-ccc_feedback_script,2017/04/13,ccc_feedback_script,0,0,00:00:00,0,00:00:00,0,0
2017-04-13-ccc_fpb_script,2017/04/13,ccc_fpb_script,2,2,00:00:10,10,00:00:10,0,20
2017-04-13-ccc_help_script,2017/04/13,ccc_help_script,26,25,00:00:08,8,00:00:40,1,200
2017-04-13-ccc_link_script,2017/04/13,ccc_link_script,0,0,00:00:00,0,00:00:00,0,0
2017-04-13-ccc_media_line_script,2017/04/13,ccc_media_line_script,2,2,00:00:04,4,00:00:06,0,8
2017-04-13-ccc_priority_script,2017/04/13,ccc_priority_script,33,31,00:00:08,8,00:00:23,2,248
2017-04-13-ccc_tax_script,2017/04/13,ccc_tax_script,21,21,00:00:25,25,00:02:32,0,525
2017-04-13-ccc_waste_recycling_script,2017/04/13,ccc_waste_recycling_script,0,0,00:00:00,0,00:00:00,0,0
2017-04-14-ccc_311_calgary_script,2017/04/14,ccc_311_calgary_script,1407,1376,00:00:18,18,00:08:00,31,24768
2017-04-14-ccc_311_lobby_ph_script,2017/04/14,ccc_311_lobby_ph_script,0,0,00:00:00,0,00:00:00,0,0
2017-04-14-ccc_aserv_info_script,2017/04/14,ccc_aserv_info_script,0,0,00:00:00,0,00:00:00,0,0
2017-04-14-ccc_bylaw_script,2017/04/14,ccc_bylaw_script,0,0,00:00:00,0,00:00:00,0,0
2017-04-14-ccc_city_script,2017/04/14,ccc_city_script,0,0,00:00:00,0,00:00:00,0,0
2017-04-14-ccc_cty_online_script,2017/04/14,ccc_cty_online_script,0,0,00:00:00,0,00:00:00,0,0
2017-04-14-ccc_feedback_script,2017/04/14,ccc_feedback_script,1,0,00:00:00,0,00:00:00,0,0
2017-04-14-ccc_fpb_script,2017/04/14,ccc_fpb_script,0,0,00:00:00,0,00:00:00,0,0
2017-04-14-ccc_help_script,2017/04/14,ccc_help_script,11,10,00:00:10,10,00:00:46,1,100
2017-04-14-ccc_link_script,2017/04/14,ccc_link_script,0,0,00:00:00,0,00:00:00,0,0
2017-04-14-ccc_media_line_script,2017/04/14,ccc_media_line_script,0,0,00:00:00,0,00:00:00,0,0
2017-04-14-ccc_priority_script,2017/04/14,ccc_priority_script,18,17,00:00:07,7,00:00:15,1,119
2017-04-14-ccc_tax_script,2017/04/14,ccc_tax_script,0,0,00:00:00,0,00:00:00,0,0
2017-04-14-ccc_waste_recycling_script,2017/04/14,ccc_waste_recycling_script,0,0,00:00:00,0,00:00:00,0,0
2017-04-15-ccc_311_calgary_script,2017/04/15,ccc_311_calgary_script,1060,1026,00:00:19,19,00:03:13,34,19494
2017-04-15-ccc_311_lobby_ph_script,2017/04/15,ccc_311_lobby_ph_script,0,0,00:00:00,0,00:00:00,0,0
2017-04-15-ccc_aserv_info_script,2017/04/15,ccc_aserv_info_script,0,0,00:00:00,0,00:00:00,0,0
2017-04-15-ccc_bylaw_script,2017/04/15,ccc_bylaw_script,0,0,00:00:00,0,00:00:00,0,0
2017-04-15-ccc_city_script,2017/04/15,ccc_city_script,0,0,00:00:00,0,00:00:00,0,0
2017-04-15-ccc_cty_online_script,2017/04/15,ccc_cty_online_script,0,0,00:00:00,0,00:00:00,0,0
2017-04-15-ccc_feedback_script,2017/04/15,ccc_feedback_script,0,0,00:00:00,0,00:00:00,0,0
2017-04-15-ccc_fpb_script,2017/04/15,ccc_fpb_script,1,1,00:00:06,6,00:00:06,0,6
2017-04-15-ccc_help_script,2017/04/15,ccc_help_script,4,3,00:00:30,30,00:01:17,1,90
2017-04-15-ccc_link_script,2017/04/15,ccc_link_script,0,0,00:00:00,0,00:00:00,0,0
2017-04-15-ccc_media_line_script,2017/04/15,ccc_media_line_script,1,1,00:00:05,5,00:00:05,0,5
2017-04-15-ccc_priority_script,2017/04/15,ccc_priority_script,22,22,00:00:12,12,00:01:40,0,264
2017-04-15-ccc_tax_script,2017/04/15,ccc_tax_script,0,0,00:00:00,0,00:00:00,0,0
2017-04-15-ccc_waste_recycling_script,2017/04/15,ccc_waste_recycling_script,0,0,00:00:00,0,00:00:00,0,0
2017-04-16-ccc_311_calgary_script,2017/04/16,ccc_311_calgary_script,872,846,00:00:19,19,00:07:04,26,16074
2017-04-16-ccc_311_lobby_ph_script,2017/04/16,ccc_311_lobby_ph_script,0,0,00:00:00,0,00:00:00,0,0
2017-04-16-ccc_aserv_info_script,2017/04/16,ccc_aserv_info_script,0,0,00:00:00,0,00:00:00,0,0
2017-04-16-ccc_bylaw_script,2017/04/16,ccc_bylaw_script,0,0,00:00:00,0,00:00:00,0,0
2017-04-16-ccc_city_script,2017/04/16,ccc_city_script,0,0,00:00:00,0,00:00:00,0,0
2017-04-16-ccc_cty_online_script,2017/04/16,ccc_cty_online_script,0,0,00:00:00,0,00:00:00,0,0
2017-04-16-ccc_feedback_script,2017/04/16,ccc_feedback_script,0,0,00:00:00,0,00:00:00,0,0
2017-04-16-ccc_fpb_script,2017/04/16,ccc_fpb_script,1,1,00:00:03,3,00:00:03,0,3
2017-04-16-ccc_help_script,2017/04/16,ccc_help_script,7,6,00:00:04,4,00:00:07,1,24
2017-04-16-ccc_link_script,2017/04/16,ccc_link_script,0,0,00:00:00,0,00:00:00,0,0
2017-04-16-ccc_media_line_script,2017/04/16,ccc_media_line_script,4,4,00:00:03,3,00:00:05,0,12
2017-04-16-ccc_priority_script,2017/04/16,ccc_priority_script,14,14,00:00:15,15,00:02:17,0,210
2017-04-16-ccc_tax_script,2017/04/16,ccc_tax_script,0,0,00:00:00,0,00:00:00,0,0
2017-04-16-ccc_waste_recycling_script,2017/04/16,ccc_waste_recycling_script,0,0,00:00:00,0,00:00:00,0,0
2017-04-17-ccc_311_calgary_script,2017/04/17,ccc_311_calgary_script,3166,3057,00:00:28,28,00:04:51,109,85596
2017-04-17-ccc_311_lobby_ph_script,2017/04/17,ccc_311_lobby_ph_script,1,1,00:00:06,6,00:00:06,0,6
2017-04-17-ccc_aserv_info_script,2017/04/17,ccc_aserv_info_script,0,0,00:00:00,0,00:00:00,0,0
2017-04-17-ccc_bylaw_script,2017/04/17,ccc_bylaw_script,0,0,00:00:00,0,00:00:00,0,0
2017-04-17-ccc_city_script,2017/04/17,ccc_city_script,13,13,00:00:13,13,00:00:38,0,169
2017-04-17-ccc_cty_online_script,2017/04/17,ccc_cty_online_script,0,0,00:00:00,0,00:00:00,0,0
2017-04-17-ccc_feedback_script,2017/04/17,ccc_feedback_script,0,0,00:00:00,0,00:00:00,0,0
2017-04-17-ccc_fpb_script,2017/04/17,ccc_fpb_script,3,3,00:00:05,5,00:00:08,0,15
2017-04-17-ccc_help_script,2017/04/17,ccc_help_script,15,15,00:00:08,8,00:00:17,0,120
2017-04-17-ccc_link_script,2017/04/17,ccc_link_script,0,0,00:00:00,0,00:00:00,0,0
2017-04-17-ccc_media_line_script,2017/04/17,ccc_media_line_script,1,1,00:00:04,4,00:00:04,0,4
2017-04-17-ccc_priority_script,2017/04/17,ccc_priority_script,36,36,00:00:11,11,00:02:03,0,396
2017-04-17-ccc_tax_script,2017/04/17,ccc_tax_script,2,2,00:00:48,48,00:01:22,0,96
2017-04-17-ccc_waste_recycling_script,2017/04/17,ccc_waste_recycling_script,0,0,00:00:00,0,00:00:00,0,0
2017-04-18-ccc_311_calgary_script,2017/04/18,ccc_311_calgary_script,3357,3207,00:00:37,37,00:07:08,150,118659
2017-04-18-ccc_311_lobby_ph_script,2017/04/18,ccc_311_lobby_ph_script,5,5,00:00:07,7,00:00:18,0,35
2017-04-18-ccc_aserv_info_script,2017/04/18,ccc_aserv_info_script,0,0,00:00:00,0,00:00:00,0,0
2017-04-18-ccc_bylaw_script,2017/04/18,ccc_bylaw_script,0,0,00:00:00,0,00:00:00,0,0
2017-04-18-ccc_city_script,2017/04/18,ccc_city_script,12,12,00:00:13,13,00:00:31,0,156
2017-04-18-ccc_cty_online_script,2017/04/18,ccc_cty_online_script,0,0,00:00:00,0,00:00:00,0,0
2017-04-18-ccc_feedback_script,2017/04/18,ccc_feedback_script,0,0,00:00:00,0,00:00:00,0,0
2017-04-18-ccc_fpb_script,2017/04/18,ccc_fpb_script,4,4,00:00:18,18,00:00:51,0,72
2017-04-18-ccc_help_script,2017/04/18,ccc_help_script,23,22,00:00:12,12,00:01:00,1,264
2017-04-18-ccc_link_script,2017/04/18,ccc_link_script,0,0,00:00:00,0,00:00:00,0,0
2017-04-18-ccc_media_line_script,2017/04/18,ccc_media_line_script,2,2,00:00:03,3,00:00:03,0,6
2017-04-18-ccc_priority_script,2017/04/18,ccc_priority_script,30,30,00:00:13,13,00:01:53,0,390
2017-04-18-ccc_tax_script,2017/04/18,ccc_tax_script,20,20,00:00:51,51,00:02:28,0,1020
2017-04-18-ccc_waste_recycling_script,2017/04/18,ccc_waste_recycling_script,0,0,00:00:00,0,00:00:00,0,0
2017-04-19-ccc_311_calgary_script,2017/04/19,ccc_311_calgary_script,3243,3051,00:00:48,48,00:10:15,192,146448
2017-04-19-ccc_311_lobby_ph_script,2017/04/19,ccc_311_lobby_ph_script,6,5,00:00:08,8,00:00:15,1,40
2017-04-19-ccc_aserv_info_script,2017/04/19,ccc_aserv_info_script,0,0,00:00:00,0,00:00:00,0,0
2017-04-19-ccc_bylaw_script,2017/04/19,ccc_bylaw_script,0,0,00:00:00,0,00:00:00,0,0
2017-04-19-ccc_city_script,2017/04/19,ccc_city_script,9,9,00:00:14,14,00:00:30,0,126
2017-04-19-ccc_cty_online_script,2017/04/19,ccc_cty_online_script,0,0,00:00:00,0,00:00:00,0,0
2017-04-19-ccc_feedback_script,2017/04/19,ccc_feedback_script,0,0,00:00:00,0,00:00:00,0,0
2017-04-19-ccc_fpb_script,2017/04/19,ccc_fpb_script,2,1,00:00:02,2,00:00:02,1,2
2017-04-19-ccc_help_script,2017/04/19,ccc_help_script,23,21,00:00:28,28,00:03:21,2,588
2017-04-19-ccc_link_script,2017/04/19,ccc_link_script,0,0,00:00:00,0,00:00:00,0,0
2017-04-19-ccc_media_line_script,2017/04/19,ccc_media_line_script,2,2,00:00:29,29,00:00:33,0,58
2017-04-19-ccc_priority_script,2017/04/19,ccc_priority_script,27,26,00:00:07,7,00:00:21,1,182
2017-04-19-ccc_tax_script,2017/04/19,ccc_tax_script,22,17,00:00:30,30,00:02:17,5,510
2017-04-19-ccc_waste_recycling_script,2017/04/19,ccc_waste_recycling_script,0,0,00:00:00,0,00:00:00,0,0
2017-04-20-ccc_311_calgary_script,2017/04/20,ccc_311_calgary_script,3355,3119,00:00:56,56,00:17:29,236,174664
2017-04-20-ccc_311_lobby_ph_script,2017/04/20,ccc_311_lobby_ph_script,1,1,00:00:06,6,00:00:06,0,6
2017-04-20-ccc_aserv_info_script,2017/04/20,ccc_aserv_info_script,0,0,00:00:00,0,00:00:00,0,0
2017-04-20-ccc_bylaw_script,2017/04/20,ccc_bylaw_script,0,0,00:00:00,0,00:00:00,0,0
2017-04-20-ccc_city_script,2017/04/20,ccc_city_script,3,3,00:00:21,21,00:00:41,0,63
2017-04-20-ccc_cty_online_script,2017/04/20,ccc_cty_online_script,0,0,00:00:00,0,00:00:00,0,0
2017-04-20-ccc_feedback_script,2017/04/20,ccc_feedback_script,0,0,00:00:00,0,00:00:00,0,0
2017-04-21-ccc_fpb_script,2017/04/21,ccc_fpb_script,4,3,00:00:10,10,00:00:17,1,30
2017-04-21-ccc_help_script,2017/04/21,ccc_help_script,14,13,00:00:06,6,00:00:16,1,78
2017-04-21-ccc_link_script,2017/04/21,ccc_link_script,0,0,00:00:00,0,00:00:00,0,0
2017-04-21-ccc_media_line_script,2017/04/21,ccc_media_line_script,0,0,00:00:00,0,00:00:00,0,0
2017-04-21-ccc_priority_script,2017/04/21,ccc_priority_script,39,39,00:00:08,8,00:00:18,0,312
2017-04-21-ccc_tax_script,2017/04/21,ccc_tax_script,27,25,00:01:20,80,00:07:16,2,2000
2017-04-21-ccc_waste_recycling_script,2017/04/21,ccc_waste_recycling_script,0,0,00:00:00,0,00:00:00,0,0
2017-04-23-ccc_311_calgary_script,2017/04/23,ccc_311_calgary_script,1037,995,00:00:24,24,00:08:48,42,23880
2017-04-23-ccc_311_lobby_ph_script,2017/04/23,ccc_311_lobby_ph_script,0,0,00:00:00,0,00:00:00,0,0
2017-04-23-ccc_aserv_info_script,2017/04/23,ccc_aserv_info_script,0,0,00:00:00,0,00:00:00,0,0
2017-04-23-ccc_bylaw_script,2017/04/23,ccc_bylaw_script,0,0,00:00:00,0,00:00:00,0,0
2017-04-23-ccc_city_script,2017/04/23,ccc_city_script,0,0,00:00:00,0,00:00:00,0,0
2017-04-23-ccc_cty_online_script,2017/04/23,ccc_cty_online_script,0,0,00:00:00,0,00:00:00,0,0
2017-04-23-ccc_feedback_script,2017/04/23,ccc_feedback_script,0,0,00:00:00,0,00:00:00,0,0
2017-04-23-ccc_fpb_script,2017/04/23,ccc_fpb_script,0,0,00:00:00,0,00:00:00,0,0
2017-04-24-ccc_help_script,2017/04/24,ccc_help_script,14,13,00:00:10,10,00:00:35,1,130
2017-04-24-ccc_link_script,2017/04/24,ccc_link_script,0,0,00:00:00,0,00:00:00,0,0
2017-04-24-ccc_media_line_script,2017/04/24,ccc_media_line_script,0,0,00:00:00,0,00:00:00,0,0
2017-04-24-ccc_priority_script,2017/04/24,ccc_priority_script,23,23,00:00:08,8,00:00:23,0,184
2017-04-24-ccc_tax_script,2017/04/24,ccc_tax_script,27,27,00:00:41,41,00:03:18,0,1107
2017-04-24-ccc_waste_recycling_script,2017/04/24,ccc_waste_recycling_script,0,0,00:00:00,0,00:00:00,0,0
2017-04-25-ccc_311_calgary_script,2017/04/25,ccc_311_calgary_script,3073,2981,00:00:30,30,00:11:27,92,89430
2017-04-26-ccc_311_calgary_script,2017/04/26,ccc_311_calgary_script,3182,2824,00:01:56,116,00:08:07,358,327584
2017-04-26-ccc_311_lobby_ph_script,2017/04/26,ccc_311_lobby_ph_script,3,2,00:00:10,10,00:00:16,1,20
2017-04-26-ccc_aserv_info_script,2017/04/26,ccc_aserv_info_script,0,0,00:00:00,0,00:00:00,0,0
2017-04-26-ccc_bylaw_script,2017/04/26,ccc_bylaw_script,0,0,00:00:00,0,00:00:00,0,0
2017-04-26-ccc_city_script,2017/04/26,ccc_city_script,24,24,00:00:31,31,00:03:20,0,744
2017-04-26-ccc_cty_online_script,2017/04/26,ccc_cty_online_script,0,0,00:00:00,0,00:00:00,0,0
2017-04-26-ccc_feedback_script,2017/04/26,ccc_feedback_script,0,0,00:00:00,0,00:00:00,0,0
2017-04-26-ccc_fpb_script,2017/04/26,ccc_fpb_script,2,1,00:00:02,2,00:00:02,1,2
2017-04-26-ccc_help_script,2017/04/26,ccc_help_script,25,22,00:00:13,13,00:01:47,3,286
2017-04-27-ccc_cty_online_script,2017/04/27,ccc_cty_online_script,0,0,00:00:00,0,00:00:00,0,0
2017-04-27-ccc_feedback_script,2017/04/27,ccc_feedback_script,0,0,00:00:00,0,00:00:00,0,0
2017-04-27-ccc_fpb_script,2017/04/27,ccc_fpb_script,2,2,00:00:38,38,00:00:58,0,76
2017-04-27-ccc_help_script,2017/04/27,ccc_help_script,19,19,00:00:15,15,00:01:05,0,285
2017-04-27-ccc_link_script,2017/04/27,ccc_link_script,0,0,00:00:00,0,00:00:00,0,0
2017-04-27-ccc_media_line_script,2017/04/27,ccc_media_line_script,0,0,00:00:00,0,00:00:00,0,0
2017-04-27-ccc_priority_script,2017/04/27,ccc_priority_script,22,22,00:00:07,7,00:00:17,0,154
2017-04-27-ccc_tax_script,2017/04/27,ccc_tax_script,27,26,00:00:55,55,00:03:00,1,1430
2017-04-27-ccc_waste_recycling_script,2017/04/27,ccc_waste_recycling_script,0,0,00:00:00,0,00:00:00,0,0
2017-04-28-ccc_311_calgary_script,2017/04/28,ccc_311_calgary_script,2981,2735,00:01:16,76,00:10:00,246,207860
2017-04-28-ccc_311_lobby_ph_script,2017/04/28,ccc_311_lobby_ph_script,1,1,00:00:09,9,00:00:09,0,9
2017-04-29-ccc_311_lobby_ph_script,2017/04/29,ccc_311_lobby_ph_script,0,0,00:00:00,0,00:00:00,0,0
2017-04-29-ccc_aserv_info_script,2017/04/29,ccc_aserv_info_script,0,0,00:00:00,0,00:00:00,0,0
2017-04-29-ccc_bylaw_script,2017/04/29,ccc_bylaw_script,0,0,00:00:00,0,00:00:00,0,0
2017-04-29-ccc_city_script,2017/04/29,ccc_city_script,0,0,00:00:00,0,00:00:00,0,0
2017-04-29-ccc_cty_online_script,2017/04/29,ccc_cty_online_script,0,0,00:00:00,0,00:00:00,0,0
2017-04-29-ccc_feedback_script,2017/04/29,ccc_feedback_script,0,0,00:00:00,0,00:00:00,0,0
2017-04-29-ccc_fpb_script,2017/04/29,ccc_fpb_script,0,0,00:00:00,0,00:00:00,0,0
2017-04-29-ccc_help_script,2017/04/29,ccc_help_script,7,7,00:00:06,6,00:00:09,0,42
2017-04-29-ccc_link_script,2017/04/29,ccc_link_script,0,0,00:00:00,0,00:00:00,0,0
2017-04-29-ccc_media_line_script,2017/04/29,ccc_media_line_script,1,1,00:00:03,3,00:00:03,0,3
2017-04-29-ccc_priority_script,2017/04/29,ccc_priority_script,16,16,00:00:06,6,00:00:19,0,96
2017-04-29-ccc_tax_script,2017/04/29,ccc_tax_script,0,0,00:00:00,0,00:00:00,0,0
2017-04-29-ccc_waste_recycling_script,2017/04/29,ccc_waste_recycling_script,0,0,00:00:00,0,00:00:00,0,0
2017-04-30-ccc_waste_recycling_script,2017/04/30,ccc_waste_recycling_script,0,0,00:00:00,0,00:00:00,0,0
2017-05-01-ccc_311_calgary_script,2017/05/01,ccc_311_calgary_script,3914,3683,00:00:55,55,00:09:48,231,202565
2017-05-01-ccc_311_lobby_ph_script,2017/05/01,ccc_311_lobby_ph_script,3,3,00:00:08,8,00:00:18,0,24
2017-05-01-ccc_bylaw_script,2017/05/01,ccc_bylaw_script,0,0,00:00:00,0,00:00:00,0,0
2017-05-01-ccc_city_script,2017/05/01,ccc_city_script,14,14,00:00:39,39,00:03:12,0,546
2017-05-01-ccc_cty_online_script,2017/05/01,ccc_cty_online_script,0,0,00:00:00,0,00:00:00,0,0
2017-05-01-ccc_feedback_script,2017/05/01,ccc_feedback_script,0,0,00:00:00,0,00:00:00,0,0
2017-05-01-ccc_fpb_script,2017/05/01,ccc_fpb_script,1,1,00:00:22,22,00:00:22,0,22
2017-05-01-ccc_link_script,2017/05/01,ccc_link_script,0,0,00:00:00,0,00:00:00,0,0
2017-05-01-ccc_media_line_script,2017/05/01,ccc_media_line_script,1,1,00:00:07,7,00:00:07,0,7
2017-05-01-ccc_priority_script,2017/05/01,ccc_priority_script,32,31,00:00:10,10,00:00:34,1,310
2017-05-01-ccc_tax_script,2017/05/01,ccc_tax_script,21,21,00:00:19,19,00:01:36,0,399
2017-05-01-ccc_waste_recycling_script,2017/05/01,ccc_waste_recycling_script,0,0,00:00:00,0,00:00:00,0,0
2017-05-02-ccc_311_calgary_script,2017/05/02,ccc_311_calgary_script,3549,3402,00:00:38,38,00:11:31,147,129276
2017-05-02-ccc_311_lobby_ph_script,2017/05/02,ccc_311_lobby_ph_script,2,2,00:00:04,4,00:00:05,0,8
2017-05-02-ccc_aserv_info_script,2017/05/02,ccc_aserv_info_script,0,0,00:00:00,0,00:00:00,0,0
2017-05-02-ccc_bylaw_script,2017/05/02,ccc_bylaw_script,0,0,00:00:00,0,00:00:00,0,0
2017-05-02-ccc_city_script,2017/05/02,ccc_city_script,14,13,00:00:14,14,00:00:38,1,182
2017-05-02-ccc_cty_online_script,2017/05/02,ccc_cty_online_script,0,0,00:00:00,0,00:00:00,0,0
2017-05-02-ccc_feedback_script,2017/05/02,ccc_feedback_script,0,0,00:00:00,0,00:00:00,0,0
2017-05-02-ccc_fpb_script,2017/05/02,ccc_fpb_script,3,3,00:01:31,91,00:04:26,0,273
2017-05-02-ccc_help_script,2017/05/02,ccc_help_script,16,16,00:00:11,11,00:00:39,0,176
2017-05-02-ccc_link_script,2017/05/02,ccc_link_script,0,0,00:00:00,0,00:00:00,0,0
2017-05-02-ccc_media_line_script,2017/05/02,ccc_media_line_script,1,1,00:00:06,6,00:00:06,0,6
2017-05-02-ccc_priority_script,2017/05/02,ccc_priority_script,28,28,00:00:11,11,00:00:53,0,308
2017-05-02-ccc_tax_script,2017/05/02,ccc_tax_script,32,32,00:00:27,27,00:02:38,0,864
2017-05-02-ccc_waste_recycling_script,2017/05/02,ccc_waste_recycling_script,0,0,00:00:00,0,00:00:00,0,0
2017-05-03-ccc_311_calgary_script,2017/05/03,ccc_311_calgary_script,3754,3367,00:01:50,110,00:07:32,387,370370
2017-05-03-ccc_311_lobby_ph_script,2017/05/03,ccc_311_lobby_ph_script,1,0,00:00:00,0,00:00:00,1,0
2017-05-03-ccc_aserv_info_script,2017/05/03,ccc_aserv_info_script,0,0,00:00:00,0,00:00:00,0,0
2017-05-03-ccc_bylaw_script,2017/05/03,ccc_bylaw_script,0,0,00:00:00,0,00:00:00,0,0
2017-05-03-ccc_city_script,2017/05/03,ccc_city_script,7,6,00:00:14,14,00:00:26,1,84
2017-05-03-ccc_cty_online_script,2017/05/03,ccc_cty_online_script,0,0,00:00:00,0,00:00:00,0,0
2017-05-03-ccc_feedback_script,2017/05/03,ccc_feedback_script,0,0,00:00:00,0,00:00:00,0,0
2017-05-03-ccc_fpb_script,2017/05/03,ccc_fpb_script,2,1,00:00:26,26,00:00:26,1,26
2017-05-03-ccc_help_script,2017/05/03,ccc_help_script,21,20,00:00:16,16,00:00:54,1,320
2017-05-03-ccc_link_script,2017/05/03,ccc_link_script,0,0,00:00:00,0,00:00:00,0,0
2017-05-03-ccc_media_line_script,2017/05/03,ccc_media_line_script,1,1,00:00:10,10,00:00:10,0,10
2017-05-03-ccc_priority_script,2017/05/03,ccc_priority_script,30,29,00:00:11,11,00:01:09,1,319
2017-05-03-ccc_tax_script,2017/05/03,ccc_tax_script,25,21,00:01:43,103,00:06:30,4,2163
2017-05-03-ccc_waste_recycling_script,2017/05/03,ccc_waste_recycling_script,0,0,00:00:00,0,00:00:00,0,0
2017-05-04-ccc_tax_script,2017/05/04,ccc_tax_script,15,14,00:00:42,42,00:03:21,1,588
2017-05-04-ccc_waste_recycling_script,2017/05/04,ccc_waste_recycling_script,0,0,00:00:00,0,00:00:00,0,0
2017-05-05-ccc_311_calgary_script,2017/05/05,ccc_311_calgary_script,3144,2892,00:01:10,70,00:06:13,252,202440
2017-05-05-ccc_311_lobby_ph_script,2017/05/05,ccc_311_lobby_ph_script,3,3,00:00:10,10,00:00:19,0,30
2017-05-05-ccc_aserv_info_script,2017/05/05,ccc_aserv_info_script,0,0,00:00:00,0,00:00:00,0,0
2017-05-05-ccc_bylaw_script,2017/05/05,ccc_bylaw_script,0,0,00:00:00,0,00:00:00,0,0
2017-05-05-ccc_city_script,2017/05/05,ccc_city_script,20,20,00:00:32,32,00:03:21,0,640
2017-05-05-ccc_cty_online_script,2017/05/05,ccc_cty_online_script,0,0,00:00:00,0,00:00:00,0,0
2017-05-05-ccc_feedback_script,2017/05/05,ccc_feedback_script,0,0,00:00:00,0,00:00:00,0,0
2017-05-05-ccc_fpb_script,2017/05/05,ccc_fpb_script,0,0,00:00:00,0,00:00:00,0,0
2017-05-05-ccc_help_script,2017/05/05,ccc_help_script,25,21,00:00:11,11,00:00:40,4,231
2017-05-06-ccc_link_script,2017/05/06,ccc_link_script,0,0,00:00:00,0,00:00:00,0,0
2017-05-06-ccc_media_line_script,2017/05/06,ccc_media_line_script,1,1,00:01:14,74,00:01:14,0,74
2017-05-06-ccc_priority_script,2017/05/06,ccc_priority_script,33,33,00:00:09,9,00:00:58,0,297
2017-05-06-ccc_tax_script,2017/05/06,ccc_tax_script,0,0,00:00:00,0,00:00:00,0,0
2017-05-06-ccc_waste_recycling_script,2017/05/06,ccc_waste_recycling_script,0,0,00:00:00,0,00:00:00,0,0
2017-05-07-ccc_311_calgary_script,2017/05/07,ccc_311_calgary_script,940,917,00:00:21,21,00:07:40,23,19257
2017-05-07-ccc_311_lobby_ph_script,2017/05/07,ccc_311_lobby_ph_script,8,8,00:00:16,16,00:00:39,0,128
2017-05-08-ccc_311_lobby_ph_script,2017/05/08,ccc_311_lobby_ph_script,10,8,00:00:15,15,00:00:40,2,120
2017-05-08-ccc_bylaw_script,2017/05/08,ccc_bylaw_script,0,0,00:00:00,0,00:00:00,0,0
2017-05-08-ccc_city_script,2017/05/08,ccc_city_script,27,26,00:00:15,15,00:00:39,1,390
2017-05-08-ccc_cty_online_script,2017/05/08,ccc_cty_online_script,0,0,00:00:00,0,00:00:00,0,0
2017-05-08-ccc_feedback_script,2017/05/08,ccc_feedback_script,0,0,00:00:00,0,00:00:00,0,0
2017-05-08-ccc_fpb_script,2017/05/08,ccc_fpb_script,5,3,00:00:04,4,00:00:07,2,12
2017-05-08-ccc_help_script,2017/05/08,ccc_help_script,35,33,00:00:15,15,00:02:16,2,495
2017-05-08-ccc_link_script,2017/05/08,ccc_link_script,0,0,00:00:00,0,00:00:00,0,0
2017-05-09-ccc_media_line_script,2017/05/09,ccc_media_line_script,1,1,00:00:22,22,00:00:22,0,22
2017-05-09-ccc_priority_script,2017/05/09,ccc_priority_script,30,30,00:00:08,8,00:00:47,0,240
2017-05-09-ccc_tax_script,2017/05/09,ccc_tax_script,19,19,00:00:10,10,00:00:55,0,190
2017-05-09-ccc_waste_recycling_script,2017/05/09,ccc_waste_recycling_script,0,0,00:00:00,0,00:00:00,0,0
2017-05-10-ccc_311_calgary_script,2017/05/10,ccc_311_calgary_script,3306,3066,00:01:09,69,00:08:36,240,211554
2017-05-10-ccc_311_lobby_ph_script,2017/05/10,ccc_311_lobby_ph_script,1,1,00:00:03,3,00:00:03,0,3
2017-05-10-ccc_aserv_info_script,2017/05/10,ccc_aserv_info_script,0,0,00:00:00,0,00:00:00,0,0
2017-05-11-ccc_bylaw_script,2017/05/11,ccc_bylaw_script,0,0,00:00:00,0,00:00:00,0,0
2017-05-11-ccc_city_script,2017/05/11,ccc_city_script,20,19,00:00:10,10,00:00:24,1,190
2017-05-11-ccc_cty_online_script,2017/05/11,ccc_cty_online_script,0,0,00:00:00,0,00:00:00,0,0
2017-05-11-ccc_feedback_script,2017/05/11,ccc_feedback_script,0,0,00:00:00,0,00:00:00,0,0
2017-05-11-ccc_fpb_script,2017/05/11,ccc_fpb_script,4,4,00:00:30,30,00:01:40,0,120
2017-05-11-ccc_help_script,2017/05/11,ccc_help_script,21,20,00:00:09,9,00:00:36,1,180
2017-05-11-ccc_link_script,2017/05/11,ccc_link_script,0,0,00:00:00,0,00:00:00,0,0
2017-05-12-ccc_media_line_script,2017/05/12,ccc_media_line_script,0,0,00:00:00,0,00:00:00,0,0
2017-05-12-ccc_priority_script,2017/05/12,ccc_priority_script,38,36,00:00:09,9,00:00:44,2,324
2017-05-12-ccc_tax_script,2017/05/12,ccc_tax_script,21,21,00:00:25,25,00:01:28,0,525
2017-05-12-ccc_waste_recycling_script,2017/05/12,ccc_waste_recycling_script,0,0,00:00:00,0,00:00:00,0,0
2017-05-13-ccc_311_calgary_script,2017/05/13,ccc_311_calgary_script,1227,1189,00:00:24,24,00:06:23,38,28536
2017-05-13-ccc_311_lobby_ph_script,2017/05/13,ccc_311_lobby_ph_script,0,0,00:00:00,0,00:00:00,0,0
2017-05-13-ccc_aserv_info_script,2017/05/13,ccc_aserv_info_script,0,0,00:00:00,0,00:00:00,0,0
2017-05-14-ccc_bylaw_script,2017/05/14,ccc_bylaw_script,0,0,00:00:00,0,00:00:00,0,0
2017-05-14-ccc_city_script,2017/05/14,ccc_city_script,0,0,00:00:00,0,00:00:00,0,0
2017-05-14-ccc_cty_online_script,2017/05/14,ccc_cty_online_script,0,0,00:00:00,0,00:00:00,0,0
2017-05-14-ccc_feedback_script,2017/05/14,ccc_feedback_script,0,0,00:00:00,0,00:00:00,0,0
2017-05-14-ccc_fpb_script,2017/05/14,ccc_fpb_script,4,4,00:00:07,7,00:00:14,0,28
2017-05-14-ccc_help_script,2017/05/14,ccc_help_script,2,2,00:00:13,13,00:00:22,0,26
2017-05-14-ccc_link_script,2017/05/14,ccc_link_script,0,0,00:00:00,0,00:00:00,0,0
2017-05-14-ccc_media_line_script,2017/05/14,ccc_media_line_script,0,0,00:00:00,0,00:00:00,0,0
2017-05-15-ccc_priority_script,2017/05/15,ccc_priority_script,16,15,00:00:08,8,00:00:45,1,120
2017-05-15-ccc_tax_script,2017/05/15,ccc_tax_script,16,16,00:01:13,73,00:03:09,0,1168
2017-05-15-ccc_waste_recycling_script,2017/05/15,ccc_waste_recycling_script,0,0,00:00:00,0,00:00:00,0,0
2017-05-16-ccc_311_calgary_script,2017/05/16,ccc_311_calgary_script,3260,3110,00:00:33,33,00:07:31,150,102630
2017-05-16-ccc_311_lobby_ph_script,2017/05/16,ccc_311_lobby_ph_script,8,8,00:00:11,11,00:00:30,0,88
2017-05-16-ccc_aserv_info_script,2017/05/16,ccc_aserv_info_script,0,0,00:00:00,0,00:00:00,0,0
2017-05-16-ccc_bylaw_script,2017/05/16,ccc_bylaw_script,0,0,00:00:00,0,00:00:00,0,0
2017-05-16-ccc_help_script,2017/05/16,ccc_help_script,14,13,00:00:16,16,00:01:15,1,208
2017-05-16-ccc_link_script,2017/05/16,ccc_link_script,0,0,00:00:00,0,00:00:00,0,0
2017-05-16-ccc_media_line_script,2017/05/16,ccc_media_line_script,1,1,00:00:20,20,00:00:20,0,20
2017-05-16-ccc_priority_script,2017/05/16,ccc_priority_script,19,18,00:00:12,12,00:01:04,1,216
2017-05-16-ccc_tax_script,2017/05/16,ccc_tax_script,26,25,00:00:21,21,00:01:19,1,525
2017-05-16-ccc_waste_recycling_script,2017/05/16,ccc_waste_recycling_script,0,0,00:00:00,0,00:00:00,0,0
2017-05-17-ccc_311_calgary_script,2017/05/17,ccc_311_calgary_script,2997,2882,00:00:34,34,00:07:01,115,97988
2017-05-17-ccc_311_lobby_ph_script,2017/05/17,ccc_311_lobby_ph_script,0,0,00:00:00,0,00:00:00,0,0
2017-05-17-ccc_aserv_info_script,2017/05/17,ccc_aserv_info_script,0,0,00:00:00,0,00:00:00,0,0
2017-05-17-ccc_bylaw_script,2017/05/17,ccc_bylaw_script,0,0,00:00:00,0,00:00:00,0,0
2017-05-17-ccc_city_script,2017/05/17,ccc_city_script,15,15,00:00:16,16,00:00:48,0,240
2017-05-17-ccc_cty_online_script,2017/05/17,ccc_cty_online_script,0,0,00:00:00,0,00:00:00,0,0
2017-05-17-ccc_feedback_script,2017/05/17,ccc_feedback_script,0,0,00:00:00,0,00:00:00,0,0
2017-05-17-ccc_fpb_script,2017/05/17,ccc_fpb_script,6,5,00:00:17,17,00:00:52,1,85
2017-05-17-ccc_help_script,2017/05/17,ccc_help_script,17,17,00:00:10,10,00:00:36,0,170
2017-05-17-ccc_link_script,2017/05/17,ccc_link_script,0,0,00:00:00,0,00:00:00,0,0
2017-05-17-ccc_media_line_script,2017/05/17,ccc_media_line_script,1,1,00:00:13,13,00:00:13,0,13
2017-05-17-ccc_priority_script,2017/05/17,ccc_priority_script,32,30,00:00:10,10,00:00:34,2,300
2017-05-17-ccc_tax_script,2017/05/17,ccc_tax_script,22,22,00:00:52,52,00:05:42,0,1144
2017-05-17-ccc_waste_recycling_script,2017/05/17,ccc_waste_recycling_script,0,0,00:00:00,0,00:00:00,0,0
2017-05-18-ccc_311_calgary_script,2017/05/18,ccc_311_calgary_script,3202,3072,00:00:33,33,00:08:14,130,101376
2017-05-18-ccc_311_lobby_ph_script,2017/05/18,ccc_311_lobby_ph_script,5,5,00:00:09,9,00:00:15,0,45
2017-05-18-ccc_aserv_info_script,2017/05/18,ccc_aserv_info_script,0,0,00:00:00,0,00:00:00,0,0
2017-05-18-ccc_bylaw_script,2017/05/18,ccc_bylaw_script,0,0,00:00:00,0,00:00:00,0,0
2017-05-18-ccc_city_script,2017/05/18,ccc_city_script,19,19,00:00:11,11,00:00:37,0,209
2017-05-18-ccc_cty_online_script,2017/05/18,ccc_cty_online_script,0,0,00:00:00,0,00:00:00,0,0
2017-05-18-ccc_feedback_script,2017/05/18,ccc_feedback_script,0,0,00:00:00,0,00:00:00,0,0
2017-05-18-ccc_fpb_script,2017/05/18,ccc_fpb_script,7,7,00:00:10,10,00:00:46,0,70
2017-05-18-ccc_help_script,2017/05/18,ccc_help_script,17,17,00:00:07,7,00:00:19,0,119
2017-05-18-ccc_link_script,2017/05/18,ccc_link_script,0,0,00:00:00,0,00:00:00,0,0
2017-05-18-ccc_media_line_script,2017/05/18,ccc_media_line_script,2,2,00:00:12,12,00:00:15,0,24
2017-05-18-ccc_priority_script,2017/05/18,ccc_priority_script,40,40,00:00:07,7,00:00:19,0,280
2017-05-18-ccc_tax_script,2017/05/18,ccc_tax_script,33,32,00:00:35,35,00:02:27,1,1120
2017-05-18-ccc_waste_recycling_script,2017/05/18,ccc_waste_recycling_script,0,0,00:00:00,0,00:00:00,0,0
2017-05-19-ccc_311_calgary_script,2017/05/19,ccc_311_calgary_script,2728,2639,00:00:28,28,00:06:34,89,73892
2017-05-19-ccc_311_lobby_ph_script,2017/05/19,ccc_311_lobby_ph_script,2,2,00:00:06,6,00:00:06,0,12
2017-05-19-ccc_aserv_info_script,2017/05/19,ccc_aserv_info_script,0,0,00:00:00,0,00:00:00,0,0
2017-05-19-ccc_bylaw_script,2017/05/19,ccc_bylaw_script,0,0,00:00:00,0,00:00:00,0,0
2017-05-19-ccc_city_script,2017/05/19,ccc_city_script,19,18,00:00:12,12,00:00:45,1,216
2017-05-19-ccc_cty_online_script,2017/05/19,ccc_cty_online_script,0,0,00:00:00,0,00:00:00,0,0
2017-05-19-ccc_feedback_script,2017/05/19,ccc_feedback_script,0,0,00:00:00,0,00:00:00,0,0
2017-05-19-ccc_fpb_script,2017/05/19,ccc_fpb_script,6,5,00:01:16,76,00:03:16,1,380
2017-05-19-ccc_help_script,2017/05/19,ccc_help_script,4,4,00:00:06,6,00:00:11,0,24
2017-05-19-ccc_link_script,2017/05/19,ccc_link_script,0,0,00:00:00,0,00:00:00,0,0
2017-05-19-ccc_media_line_script,2017/05/19,ccc_media_line_script,0,0,00:00:00,0,00:00:00,0,0
2017-05-19-ccc_priority_script,2017/05/19,ccc_priority_script,22,20,00:00:07,7,00:00:16,2,140
2017-05-19-ccc_tax_script,2017/05/19,ccc_tax_script,24,22,00:00:33,33,00:05:11,2,726
2017-05-19-ccc_waste_recycling_script,2017/05/19,ccc_waste_recycling_script,0,0,00:00:00,0,00:00:00,0,0
2017-05-20-ccc_311_calgary_script,2017/05/20,ccc_311_calgary_script,1254,1179,00:00:36,36,00:09:34,75,42444
2017-05-20-ccc_311_lobby_ph_script,2017/05/20,ccc_311_lobby_ph_script,0,0,00:00:00,0,00:00:00,0,0
2017-05-20-ccc_aserv_info_script,2017/05/20,ccc_aserv_info_script,0,0,00:00:00,0,00:00:00,0,0
2017-05-20-ccc_bylaw_script,2017/05/20,ccc_bylaw_script,0,0,00:00:00,0,00:00:00,0,0
2017-05-20-ccc_city_script,2017/05/20,ccc_city_script,0,0,00:00:00,0,00:00:00,0,0
2017-05-20-ccc_cty_online_script,2017/05/20,ccc_cty_online_script,0,0,00:00:00,0,00:00:00,0,0
2017-05-20-ccc_feedback_script,2017/05/20,ccc_feedback_script,0,0,00:00:00,0,00:00:00,0,0
2017-05-20-ccc_fpb_script,2017/05/20,ccc_fpb_script,3,3,00:00:09,9,00:00:12,0,27
2017-05-20-ccc_help_script,2017/05/20,ccc_help_script,6,6,00:00:06,6,00:00:09,0,36
2017-05-20-ccc_link_script,2017/05/20,ccc_link_script,0,0,00:00:00,0,00:00:00,0,0
2017-05-20-ccc_media_line_script,2017/05/20,ccc_media_line_script,1,1,00:00:07,7,00:00:07,0,7
2017-05-20-ccc_priority_script,2017/05/20,ccc_priority_script,21,19,00:00:10,10,00:00:50,2,190
2017-05-20-ccc_tax_script,2017/05/20,ccc_tax_script,0,0,00:00:00,0,00:00:00,0,0
2017-05-20-ccc_waste_recycling_script,2017/05/20,ccc_waste_recycling_script,0,0,00:00:00,0,00:00:00,0,0
2017-05-21-ccc_help_script,2017/05/21,ccc_help_script,5,4,00:00:07,7,00:00:18,1,28
2017-05-21-ccc_link_script,2017/05/21,ccc_link_script,0,0,00:00:00,0,00:00:00,0,0
2017-05-21-ccc_media_line_script,2017/05/21,ccc_media_line_script,4,4,00:00:10,10,00:00:20,0,40
2017-05-21-ccc_priority_script,2017/05/21,ccc_priority_script,28,28,00:00:07,7,00:00:20,0,196
2017-05-21-ccc_tax_script,2017/05/21,ccc_tax_script,0,0,00:00:00,0,00:00:00,0,0
2017-05-21-ccc_waste_recycling_script,2017/05/21,ccc_waste_recycling_script,0,0,00:00:00,0,00:00:00,0,0
2017-05-22-ccc_311_calgary_script,2017/05/22,ccc_311_calgary_script,1281,1223,00:00:33,33,00:11:15,58,40359
2017-05-22-ccc_311_lobby_ph_script,2017/05/22,ccc_311_lobby_ph_script,0,0,00:00:00,0,00:00:00,0,0
2017-05-22-ccc_aserv_info_script,2017/05/22,ccc_aserv_info_script,0,0,00:00:00,0,00:00:00,0,0
2017-05-22-ccc_bylaw_script,2017/05/22,ccc_bylaw_script,0,0,00:00:00,0,00:00:00,0,0
2017-05-22-ccc_city_script,2017/05/22,ccc_city_script,0,0,00:00:00,0,00:00:00,0,0
2017-05-22-ccc_cty_online_script,2017/05/22,ccc_cty_online_script,0,0,00:00:00,0,00:00:00,0,0
2017-05-22-ccc_feedback_script,2017/05/22,ccc_feedback_script,0,0,00:00:00,0,00:00:00,0,0
2017-05-22-ccc_fpb_script,2017/05/22,ccc_fpb_script,1,1,00:00:02,2,00:00:02,0,2
2017-05-22-ccc_help_script,2017/05/22,ccc_help_script,6,6,00:00:09,9,00:00:34,0,54
2017-05-22-ccc_link_script,2017/05/22,ccc_link_script,0,0,00:00:00,0,00:00:00,0,0
2017-05-22-ccc_media_line_script,2017/05/22,ccc_media_line_script,2,2,00:00:57,57,00:01:49,0,114
2017-05-22-ccc_priority_script,2017/05/22,ccc_priority_script,18,18,00:00:24,24,00:03:17,0,432
2017-05-22-ccc_tax_script,2017/05/22,ccc_tax_script,0,0,00:00:00,0,00:00:00,0,0
2017-05-22-ccc_waste_recycling_script,2017/05/22,ccc_waste_recycling_script,0,0,00:00:00,0,00:00:00,0,0
2017-05-24-ccc_311_calgary_script,2017/05/24,ccc_311_calgary_script,4001,3537,00:01:25,85,00:28:58,464,300645
2017-05-24-ccc_311_lobby_ph_script,2017/05/24,ccc_311_lobby_ph_script,1,0,00:00:00,0,00:00:00,1,0
2017-05-24-ccc_aserv_info_script,2017/05/24,ccc_aserv_info_script,0,0,00:00:00,0,00:00:00,0,0
2017-05-24-ccc_bylaw_script,2017/05/24,ccc_bylaw_script,0,0,00:00:00,0,00:00:00,0,0
2017-05-24-ccc_city_script,2017/05/24,ccc_city_script,22,22,00:00:14,14,00:01:02,0,308
2017-05-24-ccc_cty_online_script,2017/05/24,ccc_cty_online_script,0,0,00:00:00,0,00:00:00,0,0
2017-05-24-ccc_feedback_script,2017/05/24,ccc_feedback_script,2,0,00:00:00,0,00:00:00,0,0
2017-05-25-ccc_feedback_script,2017/05/25,ccc_feedback_script,0,0,00:00:00,0,00:00:00,0,0
2017-05-25-ccc_fpb_script,2017/05/25,ccc_fpb_script,9,7,00:00:43,43,00:02:15,2,301
2017-05-25-ccc_help_script,2017/05/25,ccc_help_script,31,29,00:00:12,12,00:01:09,2,348
2017-05-25-ccc_link_script,2017/05/25,ccc_link_script,0,0,00:00:00,0,00:00:00,0,0
2017-05-25-ccc_media_line_script,2017/05/25,ccc_media_line_script,3,3,00:00:06,6,00:00:08,0,18
2017-05-25-ccc_priority_script,2017/05/25,ccc_priority_script,51,51,00:00:11,11,00:00:59,0,561
2017-05-25-ccc_tax_script,2017/05/25,ccc_tax_script,19,18,00:02:27,147,00:09:45,1,2646
2017-05-25-ccc_waste_recycling_script,2017/05/25,ccc_waste_recycling_script,0,0,00:00:00,0,00:00:00,0,0
2017-05-26-ccc_link_script,2017/05/26,ccc_link_script,0,0,00:00:00,0,00:00:00,0,0
2017-05-27-ccc_311_calgary_script,2017/05/27,ccc_311_calgary_script,1472,1351,00:00:54,54,00:12:45,121,72954
2017-05-27-ccc_311_lobby_ph_script,2017/05/27,ccc_311_lobby_ph_script,0,0,00:00:00,0,00:00:00,0,0
2017-05-27-ccc_aserv_info_script,2017/05/27,ccc_aserv_info_script,0,0,00:00:00,0,00:00:00,0,0
2017-05-27-ccc_bylaw_script,2017/05/27,ccc_bylaw_script,0,0,00:00:00,0,00:00:00,0,0
2017-05-27-ccc_city_script,2017/05/27,ccc_city_script,0,0,00:00:00,0,00:00:00,0,0
2017-05-27-ccc_cty_online_script,2017/05/27,ccc_cty_online_script,0,0,00:00:00,0,00:00:00,0,0
2017-05-27-ccc_feedback_script,2017/05/27,ccc_feedback_script,0,0,00:00:00,0,00:00:00,0,0
2017-05-27-ccc_fpb_script,2017/05/27,ccc_fpb_script,1,1,00:00:06,6,00:00:06,0,6
2017-05-27-ccc_help_script,2017/05/27,ccc_help_script,8,7,00:00:28,28,00:01:40,1,196
2017-05-28-ccc_link_script,2017/05/28,ccc_link_script,0,0,00:00:00,0,00:00:00,0,0
2017-05-28-ccc_media_line_script,2017/05/28,ccc_media_line_script,0,0,00:00:00,0,00:00:00,0,0
2017-05-28-ccc_priority_script,2017/05/28,ccc_priority_script,29,27,00:00:16,16,00:01:53,2,432
2017-05-28-ccc_tax_script,2017/05/28,ccc_tax_script,1,1,00:02:01,121,00:02:01,0,121
2017-05-28-ccc_waste_recycling_script,2017/05/28,ccc_waste_recycling_script,0,0,00:00:00,0,00:00:00,0,0
2017-05-29-ccc_311_calgary_script,2017/05/29,ccc_311_calgary_script,4849,4142,00:02:38,158,00:11:52,707,654436
2017-05-29-ccc_311_lobby_ph_script,2017/05/29,ccc_311_lobby_ph_script,0,0,00:00:00,0,00:00:00,0,0
2017-05-29-ccc_tax_script,2017/05/29,ccc_tax_script,14,13,00:02:32,152,00:05:43,1,1976
2017-05-29-ccc_waste_recycling_script,2017/05/29,ccc_waste_recycling_script,0,0,00:00:00,0,00:00:00,0,0
2017-05-30-ccc_311_calgary_script,2017/05/30,ccc_311_calgary_script,4875,4134,00:02:40,160,00:08:37,741,661440
2017-05-30-ccc_311_lobby_ph_script,2017/05/30,ccc_311_lobby_ph_script,3,3,00:00:13,13,00:00:15,0,39
2017-05-30-ccc_aserv_info_script,2017/05/30,ccc_aserv_info_script,0,0,00:00:00,0,00:00:00,0,0
2017-05-30-ccc_bylaw_script,2017/05/30,ccc_bylaw_script,0,0,00:00:00,0,00:00:00,0,0
2017-05-30-ccc_city_script,2017/05/30,ccc_city_script,21,20,00:01:16,76,00:04:08,1,1520
2017-05-30-ccc_cty_online_script,2017/05/30,ccc_cty_online_script,0,0,00:00:00,0,00:00:00,0,0
2017-05-30-ccc_feedback_script,2017/05/30,ccc_feedback_script,0,0,00:00:00,0,00:00:00,0,0
2017-05-30-ccc_fpb_script,2017/05/30,ccc_fpb_script,4,2,00:02:29,149,00:04:53,2,298
2017-05-30-ccc_help_script,2017/05/30,ccc_help_script,19,17,00:00:11,11,00:00:36,2,187
2017-05-30-ccc_link_script,2017/05/30,ccc_link_script,0,0,00:00:00,0,00:00:00,0,0
2017-05-30-ccc_media_line_script,2017/05/30,ccc_media_line_script,2,2,00:00:48,48,00:00:56,0,96
2017-05-30-ccc_priority_script,2017/05/30,ccc_priority_script,32,31,00:00:10,10,00:01:10,1,310
2017-05-30-ccc_tax_script,2017/05/30,ccc_tax_script,40,31,00:02:35,155,00:06:20,9,4805
2017-05-30-ccc_waste_recycling_script,2017/05/30,ccc_waste_recycling_script,0,0,00:00:00,0,00:00:00,0,0
2017-06-02-ccc_bylaw_script,2017/06/02,ccc_bylaw_script,0,0,00:00:00,0,00:00:00,0,0
2017-06-02-ccc_city_script,2017/06/02,ccc_city_script,12,10,00:00:32,32,00:03:35,2,320
2017-06-02-ccc_cty_online_script,2017/06/02,ccc_cty_online_script,0,0,00:00:00,0,00:00:00,0,0
2017-06-02-ccc_feedback_script,2017/06/02,ccc_feedback_script,0,0,00:00:00,0,00:00:00,0,0
2017-06-02-ccc_fpb_script,2017/06/02,ccc_fpb_script,3,2,00:01:28,88,00:02:51,1,176
2017-06-02-ccc_help_script,2017/06/02,ccc_help_script,16,14,00:00:12,12,00:00:32,2,168
2017-06-02-ccc_link_script,2017/06/02,ccc_link_script,0,0,00:00:00,0,00:00:00,0,0
2017-06-03-ccc_link_script,2017/06/03,ccc_link_script,0,0,00:00:00,0,00:00:00,0,0
2017-06-03-ccc_media_line_script,2017/06/03,ccc_media_line_script,1,1,00:00:02,2,00:00:02,0,2
2017-06-03-ccc_priority_script,2017/06/03,ccc_priority_script,36,33,00:00:13,13,00:01:18,3,429
2017-06-03-ccc_tax_script,2017/06/03,ccc_tax_script,0,0,00:00:00,0,00:00:00,0,0
2017-06-03-ccc_waste_recycling_script,2017/06/03,ccc_waste_recycling_script,0,0,00:00:00,0,00:00:00,0,0
2017-06-23-ccc_city_script,2017/06/23,ccc_city_script,36,32,00:00:14,14,00:01:46,4,448
2017-06-04-ccc_311_calgary_script,2017/06/04,ccc_311_calgary_script,1377,1294,00:00:46,46,00:09:41,85,59524
2017-06-04-ccc_311_lobby_ph_script,2017/06/04,ccc_311_lobby_ph_script,0,0,00:00:00,0,00:00:00,0,0
2017-06-04-ccc_aserv_info_script,2017/06/04,ccc_aserv_info_script,0,0,00:00:00,0,00:00:00,0,0
2017-06-04-ccc_bylaw_script,2017/06/04,ccc_bylaw_script,0,0,00:00:00,0,00:00:00,0,0
2017-06-05-ccc_bylaw_script,2017/06/05,ccc_bylaw_script,0,0,00:00:00,0,00:00:00,0,0
2017-06-05-ccc_city_script,2017/06/05,ccc_city_script,21,20,00:00:45,45,00:04:03,1,900
2017-06-05-ccc_cty_online_script,2017/06/05,ccc_cty_online_script,0,0,00:00:00,0,00:00:00,0,0
2017-06-05-ccc_feedback_script,2017/06/05,ccc_feedback_script,0,0,00:00:00,0,00:00:00,0,0
2017-06-05-ccc_fpb_script,2017/06/05,ccc_fpb_script,10,7,00:02:22,142,00:08:19,3,994
2017-06-05-ccc_help_script,2017/06/05,ccc_help_script,22,22,00:00:14,14,00:01:02,0,308
2017-06-05-ccc_link_script,2017/06/05,ccc_link_script,0,0,00:00:00,0,00:00:00,0,0
2017-06-05-ccc_media_line_script,2017/06/05,ccc_media_line_script,1,1,00:00:47,47,00:00:47,0,47
2017-06-05-ccc_priority_script,2017/06/05,ccc_priority_script,44,44,00:00:10,10,00:00:49,0,440
2017-06-06-ccc_tax_script,2017/06/06,ccc_tax_script,30,26,00:02:57,177,00:06:41,4,4602
2017-06-06-ccc_waste_recycling_script,2017/06/06,ccc_waste_recycling_script,0,0,00:00:00,0,00:00:00,0,0
2017-06-07-ccc_311_calgary_script,2017/06/07,ccc_311_calgary_script,4394,3851,00:02:03,123,00:08:43,543,473673
2017-06-07-ccc_311_lobby_ph_script,2017/06/07,ccc_311_lobby_ph_script,3,2,00:00:11,11,00:00:18,1,22
2017-06-07-ccc_aserv_info_script,2017/06/07,ccc_aserv_info_script,0,0,00:00:00,0,00:00:00,0,0
2017-06-07-ccc_bylaw_script,2017/06/07,ccc_bylaw_script,0,0,00:00:00,0,00:00:00,0,0
2017-06-07-ccc_city_script,2017/06/07,ccc_city_script,21,20,00:00:19,19,00:01:11,1,380
2017-06-08-ccc_city_script,2017/06/08,ccc_city_script,10,10,00:00:59,59,00:08:04,0,590
2017-06-08-ccc_cty_online_script,2017/06/08,ccc_cty_online_script,0,0,00:00:00,0,00:00:00,0,0
2017-06-08-ccc_feedback_script,2017/06/08,ccc_feedback_script,0,0,00:00:00,0,00:00:00,0,0
2017-06-08-ccc_fpb_script,2017/06/08,ccc_fpb_script,1,0,00:00:00,0,00:00:00,1,0
2017-06-08-ccc_help_script,2017/06/08,ccc_help_script,28,27,00:00:14,14,00:01:56,1,378
2017-06-08-ccc_link_script,2017/06/08,ccc_link_script,0,0,00:00:00,0,00:00:00,0,0
2017-06-08-ccc_media_line_script,2017/06/08,ccc_media_line_script,1,1,00:00:44,44,00:00:44,0,44
2017-06-08-ccc_priority_script,2017/06/08,ccc_priority_script,47,43,00:00:14,14,00:02:05,4,602
2017-06-08-ccc_tax_script,2017/06/08,ccc_tax_script,29,27,00:01:40,100,00:05:33,2,2700
2017-06-09-ccc_waste_recycling_script,2017/06/09,ccc_waste_recycling_script,0,0,00:00:00,0,00:00:00,0,0
2017-06-10-ccc_311_calgary_script,2017/06/10,ccc_311_calgary_script,1201,1171,00:00:25,25,00:07:40,30,29275
2017-06-10-ccc_311_lobby_ph_script,2017/06/10,ccc_311_lobby_ph_script,0,0,00:00:00,0,00:00:00,0,0
2017-06-10-ccc_aserv_info_script,2017/06/10,ccc_aserv_info_script,0,0,00:00:00,0,00:00:00,0,0
2017-06-10-ccc_bylaw_script,2017/06/10,ccc_bylaw_script,0,0,00:00:00,0,00:00:00,0,0
2017-06-10-ccc_city_script,2017/06/10,ccc_city_script,0,0,00:00:00,0,00:00:00,0,0
2017-06-10-ccc_cty_online_script,2017/06/10,ccc_cty_online_script,0,0,00:00:00,0,00:00:00,0,0
2017-06-13-ccc_311_calgary_script,2017/06/13,ccc_311_calgary_script,4301,3668,00:02:29,149,00:09:00,633,546532
2017-06-13-ccc_311_lobby_ph_script,2017/06/13,ccc_311_lobby_ph_script,3,3,00:00:10,10,00:00:17,0,30
2017-06-13-ccc_aserv_info_script,2017/06/13,ccc_aserv_info_script,0,0,00:00:00,0,00:00:00,0,0
2017-06-13-ccc_bylaw_script,2017/06/13,ccc_bylaw_script,0,0,00:00:00,0,00:00:00,0,0
2017-06-13-ccc_city_script,2017/06/13,ccc_city_script,14,14,00:00:19,19,00:00:40,0,266
2017-06-13-ccc_cty_online_script,2017/06/13,ccc_cty_online_script,0,0,00:00:00,0,00:00:00,0,0
2017-06-13-ccc_feedback_script,2017/06/13,ccc_feedback_script,0,0,00:00:00,0,00:00:00,0,0
2017-06-13-ccc_fpb_script,2017/06/13,ccc_fpb_script,6,4,00:02:09,129,00:05:41,2,516
2017-06-13-ccc_help_script,2017/06/13,ccc_help_script,26,22,00:00:10,10,00:00:27,4,220
2017-06-13-ccc_link_script,2017/06/13,ccc_link_script,0,0,00:00:00,0,00:00:00,0,0
2017-06-13-ccc_media_line_script,2017/06/13,ccc_media_line_script,1,0,00:00:00,0,00:00:00,1,0
2017-06-13-ccc_priority_script,2017/06/13,ccc_priority_script,49,48,00:00:09,9,00:01:01,1,432
2017-06-13-ccc_tax_script,2017/06/13,ccc_tax_script,20,19,00:03:09,189,00:07:42,1,3591
2017-06-13-ccc_waste_recycling_script,2017/06/13,ccc_waste_recycling_script,0,0,00:00:00,0,00:00:00,0,0
2017-06-11-ccc_cty_online_script,2017/06/11,ccc_cty_online_script,0,0,00:00:00,0,00:00:00,0,0
2017-06-11-ccc_feedback_script,2017/06/11,ccc_feedback_script,0,0,00:00:00,0,00:00:00,0,0
2017-06-11-ccc_fpb_script,2017/06/11,ccc_fpb_script,1,1,00:00:14,14,00:00:14,0,14
2017-06-11-ccc_help_script,2017/06/11,ccc_help_script,7,3,00:00:05,5,00:00:09,4,15
2017-06-11-ccc_link_script,2017/06/11,ccc_link_script,0,0,00:00:00,0,00:00:00,0,0
2017-06-11-ccc_media_line_script,2017/06/11,ccc_media_line_script,0,0,00:00:00,0,00:00:00,0,0
2017-06-11-ccc_priority_script,2017/06/11,ccc_priority_script,30,30,00:00:11,11,00:01:05,0,330
2017-06-11-ccc_tax_script,2017/06/11,ccc_tax_script,0,0,00:00:00,0,00:00:00,0,0
2017-06-11-ccc_waste_recycling_script,2017/06/11,ccc_waste_recycling_script,0,0,00:00:00,0,00:00:00,0,0
2017-06-14-ccc_311_calgary_script,2017/06/14,ccc_311_calgary_script,3873,3653,00:00:42,42,00:07:25,220,153426
2017-06-14-ccc_311_lobby_ph_script,2017/06/14,ccc_311_lobby_ph_script,2,2,00:00:07,7,00:00:11,0,14
2017-06-14-ccc_aserv_info_script,2017/06/14,ccc_aserv_info_script,0,0,00:00:00,0,00:00:00,0,0
2017-06-14-ccc_bylaw_script,2017/06/14,ccc_bylaw_script,0,0,00:00:00,0,00:00:00,0,0
2017-06-14-ccc_city_script,2017/06/14,ccc_city_script,19,19,00:00:11,11,00:00:36,0,209
2017-06-14-ccc_cty_online_script,2017/06/14,ccc_cty_online_script,0,0,00:00:00,0,00:00:00,0,0
2017-06-14-ccc_feedback_script,2017/06/14,ccc_feedback_script,0,0,00:00:00,0,00:00:00,0,0
2017-06-15-ccc_fpb_script,2017/06/15,ccc_fpb_script,5,3,00:00:05,5,00:00:08,2,15
2017-06-15-ccc_help_script,2017/06/15,ccc_help_script,17,16,00:00:12,12,00:00:28,1,192
2017-06-15-ccc_link_script,2017/06/15,ccc_link_script,0,0,00:00:00,0,00:00:00,0,0
2017-06-15-ccc_media_line_script,2017/06/15,ccc_media_line_script,1,1,00:00:03,3,00:00:03,0,3
2017-06-15-ccc_priority_script,2017/06/15,ccc_priority_script,25,24,00:00:12,12,00:00:40,1,288
2017-06-15-ccc_tax_script,2017/06/15,ccc_tax_script,33,31,00:01:18,78,00:07:23,2,2418
2017-06-15-ccc_waste_recycling_script,2017/06/15,ccc_waste_recycling_script,0,0,00:00:00,0,00:00:00,0,0
2017-06-16-ccc_waste_recycling_script,2017/06/16,ccc_waste_recycling_script,0,0,00:00:00,0,00:00:00,0,0
2017-06-17-ccc_311_calgary_script,2017/06/17,ccc_311_calgary_script,1529,1486,00:00:21,21,00:06:42,43,31206
2017-06-17-ccc_311_lobby_ph_script,2017/06/17,ccc_311_lobby_ph_script,0,0,00:00:00,0,00:00:00,0,0
2017-06-17-ccc_aserv_info_script,2017/06/17,ccc_aserv_info_script,0,0,00:00:00,0,00:00:00,0,0
2017-06-17-ccc_bylaw_script,2017/06/17,ccc_bylaw_script,0,0,00:00:00,0,00:00:00,0,0
2017-06-17-ccc_city_script,2017/06/17,ccc_city_script,0,0,00:00:00,0,00:00:00,0,0
2017-06-17-ccc_cty_online_script,2017/06/17,ccc_cty_online_script,0,0,00:00:00,0,00:00:00,0,0
2017-06-17-ccc_feedback_script,2017/06/17,ccc_feedback_script,0,0,00:00:00,0,00:00:00,0,0
2017-06-17-ccc_fpb_script,2017/06/17,ccc_fpb_script,2,2,00:00:04,4,00:00:05,0,8
2017-06-18-ccc_help_script,2017/06/18,ccc_help_script,0,0,00:00:00,0,00:00:00,0,0
2017-06-18-ccc_link_script,2017/06/18,ccc_link_script,0,0,00:00:00,0,00:00:00,0,0
2017-06-18-ccc_media_line_script,2017/06/18,ccc_media_line_script,1,1,00:00:02,2,00:00:02,0,2
2017-06-18-ccc_priority_script,2017/06/18,ccc_priority_script,27,24,00:00:06,6,00:00:13,3,144
2017-06-18-ccc_tax_script,2017/06/18,ccc_tax_script,0,0,00:00:00,0,00:00:00,0,0
2017-06-18-ccc_waste_recycling_script,2017/06/18,ccc_waste_recycling_script,0,0,00:00:00,0,00:00:00,0,0
2017-06-19-ccc_311_calgary_script,2017/06/19,ccc_311_calgary_script,4606,4064,00:02:00,120,00:06:51,543,487680
2017-06-20-ccc_311_calgary_script,2017/06/20,ccc_311_calgary_script,4483,4180,00:00:52,52,00:13:02,303,217360
2017-06-20-ccc_311_lobby_ph_script,2017/06/20,ccc_311_lobby_ph_script,3,3,00:00:09,9,00:00:21,0,27
2017-06-20-ccc_aserv_info_script,2017/06/20,ccc_aserv_info_script,0,0,00:00:00,0,00:00:00,0,0
2017-06-20-ccc_bylaw_script,2017/06/20,ccc_bylaw_script,0,0,00:00:00,0,00:00:00,0,0
2017-06-20-ccc_city_script,2017/06/20,ccc_city_script,34,33,00:00:18,18,00:02:45,1,594
2017-06-20-ccc_cty_online_script,2017/06/20,ccc_cty_online_script,0,0,00:00:00,0,00:00:00,0,0
2017-06-20-ccc_feedback_script,2017/06/20,ccc_feedback_script,0,0,00:00:00,0,00:00:00,0,0
2017-06-20-ccc_fpb_script,2017/06/20,ccc_fpb_script,5,4,00:00:47,47,00:02:52,1,188
2017-06-20-ccc_help_script,2017/06/20,ccc_help_script,23,22,00:00:14,14,00:01:32,1,308
2017-06-21-ccc_link_script,2017/06/21,ccc_link_script,0,0,00:00:00,0,00:00:00,0,0
2017-06-21-ccc_media_line_script,2017/06/21,ccc_media_line_script,1,1,00:00:12,12,00:00:12,0,12
2017-06-21-ccc_priority_script,2017/06/21,ccc_priority_script,37,36,00:00:07,7,00:00:16,1,252
2017-06-21-ccc_tax_script,2017/06/21,ccc_tax_script,19,18,00:01:10,70,00:08:44,1,1260
2017-06-21-ccc_waste_recycling_script,2017/06/21,ccc_waste_recycling_script,0,0,00:00:00,0,00:00:00,0,0
2017-06-22-ccc_311_calgary_script,2017/06/22,ccc_311_calgary_script,4091,3933,00:00:26,26,00:05:44,158,102258
2017-06-22-ccc_311_lobby_ph_script,2017/06/22,ccc_311_lobby_ph_script,3,3,00:00:07,7,00:00:14,0,21
2017-06-23-ccc_311_lobby_ph_script,2017/06/23,ccc_311_lobby_ph_script,1,1,00:00:30,30,00:00:30,0,30
2017-06-23-ccc_bylaw_script,2017/06/23,ccc_bylaw_script,0,0,00:00:00,0,00:00:00,0,0
2017-06-23-ccc_cty_online_script,2017/06/23,ccc_cty_online_script,0,0,00:00:00,0,00:00:00,0,0
2017-06-23-ccc_feedback_script,2017/06/23,ccc_feedback_script,0,0,00:00:00,0,00:00:00,0,0
2017-06-23-ccc_fpb_script,2017/06/23,ccc_fpb_script,4,4,00:00:11,11,00:00:22,0,44
2017-06-23-ccc_help_script,2017/06/23,ccc_help_script,15,14,00:00:17,17,00:01:01,1,238
2017-06-23-ccc_link_script,2017/06/23,ccc_link_script,0,0,00:00:00,0,00:00:00,0,0
2017-06-24-ccc_link_script,2017/06/24,ccc_link_script,0,0,00:00:00,0,00:00:00,0,0
2017-06-24-ccc_media_line_script,2017/06/24,ccc_media_line_script,0,0,00:00:00,0,00:00:00,0,0
2017-06-24-ccc_priority_script,2017/06/24,ccc_priority_script,35,33,00:00:08,8,00:00:19,2,264
2017-06-24-ccc_tax_script,2017/06/24,ccc_tax_script,2,2,00:00:46,46,00:01:24,0,92
2017-06-24-ccc_waste_recycling_script,2017/06/24,ccc_waste_recycling_script,0,0,00:00:00,0,00:00:00,0,0
2017-06-25-ccc_311_calgary_script,2017/06/25,ccc_311_calgary_script,1211,1159,00:00:28,28,00:08:22,52,32452
2017-06-25-ccc_311_lobby_ph_script,2017/06/25,ccc_311_lobby_ph_script,0,0,00:00:00,0,00:00:00,0,0
2017-06-25-ccc_aserv_info_script,2017/06/25,ccc_aserv_info_script,0,0,00:00:00,0,00:00:00,0,0
2017-06-25-ccc_bylaw_script,2017/06/25,ccc_bylaw_script,0,0,00:00:00,0,00:00:00,0,0
2017-06-25-ccc_tax_script,2017/06/25,ccc_tax_script,1,1,00:00:02,2,00:00:02,0,2
2017-06-25-ccc_waste_recycling_script,2017/06/25,ccc_waste_recycling_script,0,0,00:00:00,0,00:00:00,0,0
2017-06-26-ccc_311_calgary_script,2017/06/26,ccc_311_calgary_script,4976,4309,00:02:20,140,00:10:23,667,603260
2017-06-26-ccc_311_lobby_ph_script,2017/06/26,ccc_311_lobby_ph_script,5,5,00:00:13,13,00:00:24,0,65
2017-06-26-ccc_aserv_info_script,2017/06/26,ccc_aserv_info_script,0,0,00:00:00,0,00:00:00,0,0
2017-06-26-ccc_bylaw_script,2017/06/26,ccc_bylaw_script,0,0,00:00:00,0,00:00:00,0,0
2017-06-26-ccc_city_script,2017/06/26,ccc_city_script,9,9,00:00:25,25,00:02:13,0,225
2017-06-26-ccc_cty_online_script,2017/06/26,ccc_cty_online_script,0,0,00:00:00,0,00:00:00,0,0
2017-06-26-ccc_feedback_script,2017/06/26,ccc_feedback_script,0,0,00:00:00,0,00:00:00,0,0
2017-06-26-ccc_fpb_script,2017/06/26,ccc_fpb_script,4,2,00:03:00,180,00:05:56,2,360
2017-06-26-ccc_help_script,2017/06/26,ccc_help_script,10,10,00:00:21,21,00:01:10,0,210
2017-06-26-ccc_link_script,2017/06/26,ccc_link_script,0,0,00:00:00,0,00:00:00,0,0
2017-06-26-ccc_media_line_script,2017/06/26,ccc_media_line_script,1,1,00:00:22,22,00:00:22,0,22
2017-06-26-ccc_tax_script,2017/06/26,ccc_tax_script,16,15,00:01:11,71,00:05:09,1,1065
2017-06-27-ccc_bylaw_script,2017/06/27,ccc_bylaw_script,0,0,00:00:00,0,00:00:00,0,0
2017-06-27-ccc_city_script,2017/06/27,ccc_city_script,9,9,00:00:16,16,00:00:33,0,144
2017-06-27-ccc_cty_online_script,2017/06/27,ccc_cty_online_script,0,0,00:00:00,0,00:00:00,0,0
2017-06-27-ccc_feedback_script,2017/06/27,ccc_feedback_script,0,0,00:00:00,0,00:00:00,0,0
2017-06-27-ccc_fpb_script,2017/06/27,ccc_fpb_script,6,4,00:00:27,27,00:01:22,2,108
2017-06-27-ccc_help_script,2017/06/27,ccc_help_script,17,17,00:00:14,14,00:01:18,0,238
2017-06-27-ccc_link_script,2017/06/27,ccc_link_script,0,0,00:00:00,0,00:00:00,0,0
2017-06-27-ccc_media_line_script,2017/06/27,ccc_media_line_script,0,0,00:00:00,0,00:00:00,0,0
2017-06-27-ccc_priority_script,2017/06/27,ccc_priority_script,36,36,00:00:07,7,00:00:24,0,252
2017-06-27-ccc_tax_script,2017/06/27,ccc_tax_script,26,20,00:01:51,111,00:04:59,6,2220
2017-06-27-ccc_waste_recycling_script,2017/06/27,ccc_waste_recycling_script,0,0,00:00:00,0,00:00:00,0,0
2017-06-28-ccc_311_calgary_script,2017/06/28,ccc_311_calgary_script,4523,4077,00:01:38,98,00:06:49,446,399546
2017-06-28-ccc_311_lobby_ph_script,2017/06/28,ccc_311_lobby_ph_script,3,1,00:00:04,4,00:00:04,2,4
2017-06-28-ccc_aserv_info_script,2017/06/28,ccc_aserv_info_script,0,0,00:00:00,0,00:00:00,0,0
2017-06-28-ccc_bylaw_script,2017/06/28,ccc_bylaw_script,0,0,00:00:00,0,00:00:00,0,0
2017-06-28-ccc_city_script,2017/06/28,ccc_city_script,11,11,00:00:23,23,00:01:55,0,253
2017-06-28-ccc_cty_online_script,2017/06/28,ccc_cty_online_script,0,0,00:00:00,0,00:00:00,0,0
2017-06-28-ccc_feedback_script,2017/06/28,ccc_feedback_script,0,0,00:00:00,0,00:00:00,0,0
2017-06-28-ccc_fpb_script,2017/06/28,ccc_fpb_script,0,0,00:00:00,0,00:00:00,0,0
2017-06-28-ccc_help_script,2017/06/28,ccc_help_script,16,15,00:00:09,9,00:00:37,1,135
2017-06-28-ccc_link_script,2017/06/28,ccc_link_script,0,0,00:00:00,0,00:00:00,0,0
2017-06-28-ccc_media_line_script,2017/06/28,ccc_media_line_script,2,2,00:00:03,3,00:00:03,0,6
2017-06-28-ccc_priority_script,2017/06/28,ccc_priority_script,30,30,00:00:08,8,00:00:30,0,240
2017-06-28-ccc_tax_script,2017/06/28,ccc_tax_script,22,21,00:01:57,117,00:05:10,1,2457
2017-06-28-ccc_waste_recycling_script,2017/06/28,ccc_waste_recycling_script,0,0,00:00:00,0,00:00:00,0,0
2017-06-29-ccc_311_calgary_script,2017/06/29,ccc_311_calgary_script,4426,4170,00:00:50,50,00:05:08,256,208500
2017-06-29-ccc_311_lobby_ph_script,2017/06/29,ccc_311_lobby_ph_script,3,3,00:00:04,4,00:00:07,0,12
2017-06-29-ccc_aserv_info_script,2017/06/29,ccc_aserv_info_script,0,0,00:00:00,0,00:00:00,0,0
2017-06-29-ccc_bylaw_script,2017/06/29,ccc_bylaw_script,0,0,00:00:00,0,00:00:00,0,0
2017-06-29-ccc_city_script,2017/06/29,ccc_city_script,13,12,00:00:29,29,00:02:08,1,348
2017-06-30-ccc_city_script,2017/06/30,ccc_city_script,13,13,00:00:21,21,00:02:39,0,273
2017-06-30-ccc_cty_online_script,2017/06/30,ccc_cty_online_script,0,0,00:00:00,0,00:00:00,0,0
2017-06-30-ccc_feedback_script,2017/06/30,ccc_feedback_script,1,0,00:00:00,0,00:00:00,1,0
2017-06-30-ccc_fpb_script,2017/06/30,ccc_fpb_script,3,1,00:01:01,61,00:01:01,2,61
2017-06-30-ccc_help_script,2017/06/30,ccc_help_script,12,12,00:00:12,12,00:00:52,0,144
2017-06-30-ccc_media_line_script,2017/06/30,ccc_media_line_script,0,0,00:00:00,0,00:00:00,0,0
2017-06-30-ccc_priority_script,2017/06/30,ccc_priority_script,23,22,00:00:09,9,00:00:56,1,198
2017-06-30-ccc_tax_script,2017/06/30,ccc_tax_script,17,15,00:00:14,14,00:00:38,2,210
2017-07-01-ccc_tax_script,2017/07/01,ccc_tax_script,0,0,00:00:00,0,00:00:00,0,0
2017-07-01-ccc_waste_recycling_script,2017/07/01,ccc_waste_recycling_script,0,0,00:00:00,0,00:00:00,0,0
2017-07-02-ccc_311_calgary_script,2017/07/02,ccc_311_calgary_script,1247,1196,00:00:30,30,00:10:54,51,35880
2017-07-02-ccc_311_lobby_ph_script,2017/07/02,ccc_311_lobby_ph_script,0,0,00:00:00,0,00:00:00,0,0
2017-07-02-ccc_aserv_info_script,2017/07/02,ccc_aserv_info_script,0,0,00:00:00,0,00:00:00,0,0
2017-07-02-ccc_bylaw_script,2017/07/02,ccc_bylaw_script,0,0,00:00:00,0,00:00:00,0,0
2017-07-02-ccc_city_script,2017/07/02,ccc_city_script,0,0,00:00:00,0,00:00:00,0,0
2017-07-02-ccc_cty_online_script,2017/07/02,ccc_cty_online_script,0,0,00:00:00,0,00:00:00,0,0
2017-07-02-ccc_feedback_script,2017/07/02,ccc_feedback_script,0,0,00:00:00,0,00:00:00,0,0
2017-07-03-ccc_fpb_script,2017/07/03,ccc_fpb_script,1,1,00:00:09,9,00:00:09,0,9
2017-07-03-ccc_help_script,2017/07/03,ccc_help_script,13,13,00:00:07,7,00:00:14,0,91
2017-07-03-ccc_link_script,2017/07/03,ccc_link_script,0,0,00:00:00,0,00:00:00,0,0
2017-07-03-ccc_media_line_script,2017/07/03,ccc_media_line_script,1,1,00:00:26,26,00:00:26,0,26
2017-07-03-ccc_priority_script,2017/07/03,ccc_priority_script,34,34,00:00:07,7,00:00:22,0,238
2017-07-03-ccc_tax_script,2017/07/03,ccc_tax_script,0,0,00:00:00,0,00:00:00,0,0
2017-07-03-ccc_waste_recycling_script,2017/07/03,ccc_waste_recycling_script,0,0,00:00:00,0,00:00:00,0,0
2017-07-04-ccc_waste_recycling_script,2017/07/04,ccc_waste_recycling_script,0,0,00:00:00,0,00:00:00,0,0
2017-07-05-ccc_311_calgary_script,2017/07/05,ccc_311_calgary_script,4160,3534,00:02:29,149,00:09:44,626,526566
2017-07-05-ccc_311_lobby_ph_script,2017/07/05,ccc_311_lobby_ph_script,4,4,00:00:10,10,00:00:18,0,40
2017-07-05-ccc_aserv_info_script,2017/07/05,ccc_aserv_info_script,0,0,00:00:00,0,00:00:00,0,0
2017-07-05-ccc_bylaw_script,2017/07/05,ccc_bylaw_script,0,0,00:00:00,0,00:00:00,0,0
2017-07-05-ccc_city_script,2017/07/05,ccc_city_script,19,19,00:00:58,58,00:06:35,0,1102
2017-07-05-ccc_cty_online_script,2017/07/05,ccc_cty_online_script,0,0,00:00:00,0,00:00:00,0,0
2017-07-05-ccc_feedback_script,2017/07/05,ccc_feedback_script,0,0,00:00:00,0,00:00:00,0,0
2017-07-05-ccc_fpb_script,2017/07/05,ccc_fpb_script,8,6,00:01:43,103,00:03:32,2,618
2017-07-05-ccc_help_script,2017/07/05,ccc_help_script,11,11,00:00:13,13,00:00:36,0,143
2017-07-05-ccc_link_script,2017/07/05,ccc_link_script,0,0,00:00:00,0,00:00:00,0,0
2017-07-05-ccc_media_line_script,2017/07/05,ccc_media_line_script,1,1,00:00:10,10,00:00:10,0,10
2017-07-05-ccc_priority_script,2017/07/05,ccc_priority_script,47,47,00:00:09,9,00:00:33,0,423
2017-07-05-ccc_tax_script,2017/07/05,ccc_tax_script,25,21,00:02:41,161,00:06:11,4,3381
2017-07-05-ccc_waste_recycling_script,2017/07/05,ccc_waste_recycling_script,0,0,00:00:00,0,00:00:00,0,0
2017-07-06-ccc_311_calgary_script,2017/07/06,ccc_311_calgary_script,4019,3619,00:01:34,94,00:06:55,400,340186
2017-07-06-ccc_311_lobby_ph_script,2017/07/06,ccc_311_lobby_ph_script,3,3,00:00:06,6,00:00:12,0,18
2017-07-06-ccc_aserv_info_script,2017/07/06,ccc_aserv_info_script,0,0,00:00:00,0,00:00:00,0,0
2017-07-06-ccc_bylaw_script,2017/07/06,ccc_bylaw_script,0,0,00:00:00,0,00:00:00,0,0
2017-07-06-ccc_city_script,2017/07/06,ccc_city_script,14,12,00:00:16,16,00:01:11,2,192
2017-07-06-ccc_cty_online_script,2017/07/06,ccc_cty_online_script,0,0,00:00:00,0,00:00:00,0,0
2017-07-06-ccc_feedback_script,2017/07/06,ccc_feedback_script,0,0,00:00:00,0,00:00:00,0,0
2017-07-06-ccc_fpb_script,2017/07/06,ccc_fpb_script,3,3,00:01:55,115,00:04:38,0,345
2017-07-06-ccc_help_script,2017/07/06,ccc_help_script,15,14,00:00:08,8,00:00:24,1,112
2017-07-06-ccc_link_script,2017/07/06,ccc_link_script,0,0,00:00:00,0,00:00:00,0,0
2017-07-06-ccc_media_line_script,2017/07/06,ccc_media_line_script,1,1,00:00:32,32,00:00:32,0,32
2017-07-06-ccc_priority_script,2017/07/06,ccc_priority_script,29,28,00:00:13,13,00:00:48,1,364
2017-07-06-ccc_tax_script,2017/07/06,ccc_tax_script,33,32,00:01:30,90,00:05:46,1,2880
2017-07-06-ccc_waste_recycling_script,2017/07/06,ccc_waste_recycling_script,0,0,00:00:00,0,00:00:00,0,0
2017-07-07-ccc_311_calgary_script,2017/07/07,ccc_311_calgary_script,3341,3155,00:00:46,46,00:07:48,186,145130
2017-07-07-ccc_311_lobby_ph_script,2017/07/07,ccc_311_lobby_ph_script,0,0,00:00:00,0,00:00:00,0,0
2017-07-07-ccc_aserv_info_script,2017/07/07,ccc_aserv_info_script,0,0,00:00:00,0,00:00:00,0,0
2017-07-07-ccc_bylaw_script,2017/07/07,ccc_bylaw_script,0,0,00:00:00,0,00:00:00,0,0
2017-07-07-ccc_city_script,2017/07/07,ccc_city_script,19,19,00:00:14,14,00:00:36,0,266
2017-07-07-ccc_cty_online_script,2017/07/07,ccc_cty_online_script,0,0,00:00:00,0,00:00:00,0,0
2017-07-07-ccc_feedback_script,2017/07/07,ccc_feedback_script,1,0,00:00:00,0,00:00:00,0,0
2017-07-07-ccc_fpb_script,2017/07/07,ccc_fpb_script,2,1,00:00:09,9,00:00:09,1,9
2017-07-07-ccc_help_script,2017/07/07,ccc_help_script,16,15,00:00:16,16,00:02:25,1,240
2017-07-07-ccc_link_script,2017/07/07,ccc_link_script,0,0,00:00:00,0,00:00:00,0,0
2017-07-07-ccc_media_line_script,2017/07/07,ccc_media_line_script,1,1,00:00:01,1,00:00:01,0,1
2017-07-07-ccc_priority_script,2017/07/07,ccc_priority_script,31,29,00:00:09,9,00:00:25,2,261
2017-07-07-ccc_tax_script,2017/07/07,ccc_tax_script,15,15,00:00:50,50,00:02:49,0,750
2017-07-07-ccc_waste_recycling_script,2017/07/07,ccc_waste_recycling_script,0,0,00:00:00,0,00:00:00,0,0
2017-08-01-ccc_311_calgary_script,2017/08/01,ccc_311_calgary_script,3791,3372,00:01:52,112,00:08:52,419,377664
2017-08-01-ccc_311_lobby_ph_script,2017/08/01,ccc_311_lobby_ph_script,2,2,00:00:09,9,00:00:13,0,18
2017-08-01-ccc_aserv_info_script,2017/08/01,ccc_aserv_info_script,0,0,00:00:00,0,00:00:00,0,0
2017-08-01-ccc_bylaw_script,2017/08/01,ccc_bylaw_script,0,0,00:00:00,0,00:00:00,0,0
2017-08-01-ccc_city_script,2017/08/01,ccc_city_script,19,18,00:01:06,66,00:07:43,1,1188
2017-08-01-ccc_cty_online_script,2017/08/01,ccc_cty_online_script,0,0,00:00:00,0,00:00:00,0,0
2017-08-01-ccc_feedback_script,2017/08/01,ccc_feedback_script,0,0,00:00:00,0,00:00:00,0,0
2017-08-01-ccc_fpb_script,2017/08/01,ccc_fpb_script,5,4,00:02:33,153,00:05:28,1,612
2017-08-01-ccc_help_script,2017/08/01,ccc_help_script,20,19,00:00:14,14,00:00:33,1,266
2017-08-01-ccc_link_script,2017/08/01,ccc_link_script,0,0,00:00:00,0,00:00:00,0,0
2017-08-01-ccc_media_line_script,2017/08/01,ccc_media_line_script,2,1,00:00:03,3,00:00:03,1,3
2017-08-01-ccc_priority_script,2017/08/01,ccc_priority_script,29,28,00:00:09,9,00:00:41,1,252
2017-08-01-ccc_tax_script,2017/08/01,ccc_tax_script,16,15,00:02:10,130,00:07:27,1,1950
2017-08-01-ccc_waste_recycling_script,2017/08/01,ccc_waste_recycling_script,0,0,00:00:00,0,00:00:00,0,0
2017-08-02-ccc_311_calgary_script,2017/08/02,ccc_311_calgary_script,3723,3170,00:02:28,148,00:10:49,553,469160
2017-08-02-ccc_311_lobby_ph_script,2017/08/02,ccc_311_lobby_ph_script,2,2,00:00:18,18,00:00:19,0,36
2017-08-02-ccc_aserv_info_script,2017/08/02,ccc_aserv_info_script,0,0,00:00:00,0,00:00:00,0,0
2017-08-02-ccc_bylaw_script,2017/08/02,ccc_bylaw_script,0,0,00:00:00,0,00:00:00,0,0
2017-08-02-ccc_city_script,2017/08/02,ccc_city_script,19,19,00:00:30,30,00:03:21,0,570
2017-08-02-ccc_cty_online_script,2017/08/02,ccc_cty_online_script,0,0,00:00:00,0,00:00:00,0,0
2017-08-02-ccc_feedback_script,2017/08/02,ccc_feedback_script,0,0,00:00:00,0,00:00:00,0,0
2017-08-02-ccc_fpb_script,2017/08/02,ccc_fpb_script,7,6,00:03:34,214,00:07:26,1,1284
2017-08-02-ccc_help_script,2017/08/02,ccc_help_script,20,18,00:00:15,15,00:00:59,2,270
2017-08-02-ccc_link_script,2017/08/02,ccc_link_script,0,0,00:00:00,0,00:00:00,0,0
2017-08-02-ccc_media_line_script,2017/08/02,ccc_media_line_script,0,0,00:00:00,0,00:00:00,0,0
2017-08-02-ccc_priority_script,2017/08/02,ccc_priority_script,27,26,00:00:10,10,00:01:19,1,260
2017-08-02-ccc_tax_script,2017/08/02,ccc_tax_script,22,21,00:02:49,169,00:10:14,1,3549
2017-08-02-ccc_waste_recycling_script,2017/08/02,ccc_waste_recycling_script,0,0,00:00:00,0,00:00:00,0,0
2017-08-03-ccc_311_calgary_script,2017/08/03,ccc_311_calgary_script,3665,3164,00:02:16,136,00:08:55,501,430304
2017-08-03-ccc_311_lobby_ph_script,2017/08/03,ccc_311_lobby_ph_script,7,6,00:00:06,6,00:00:12,1,36
2017-08-03-ccc_aserv_info_script,2017/08/03,ccc_aserv_info_script,0,0,00:00:00,0,00:00:00,0,0
2017-08-03-ccc_bylaw_script,2017/08/03,ccc_bylaw_script,0,0,00:00:00,0,00:00:00,0,0
2017-08-03-ccc_city_script,2017/08/03,ccc_city_script,17,16,00:00:53,53,00:04:21,1,848
2017-08-03-ccc_cty_online_script,2017/08/03,ccc_cty_online_script,0,0,00:00:00,0,00:00:00,0,0
2017-08-03-ccc_feedback_script,2017/08/03,ccc_feedback_script,0,0,00:00:00,0,00:00:00,0,0
2017-08-03-ccc_fpb_script,2017/08/03,ccc_fpb_script,5,3,00:00:57,57,00:02:29,2,171
2017-08-03-ccc_help_script,2017/08/03,ccc_help_script,27,25,00:00:09,9,00:00:39,2,225
2017-08-03-ccc_media_line_script,2017/08/03,ccc_media_line_script,1,0,00:00:00,0,00:00:00,1,0
2017-08-03-ccc_priority_script,2017/08/03,ccc_priority_script,43,41,00:00:12,12,00:01:19,2,492
2017-08-03-ccc_tax_script,2017/08/03,ccc_tax_script,26,23,00:03:03,183,00:06:17,3,4209
2017-08-03-ccc_waste_recycling_script,2017/08/03,ccc_waste_recycling_script,0,0,00:00:00,0,00:00:00,0,0
2017-08-04-ccc_311_calgary_script,2017/08/04,ccc_311_calgary_script,3033,2905,00:00:35,35,00:05:10,128,101675
2017-08-04-ccc_311_lobby_ph_script,2017/08/04,ccc_311_lobby_ph_script,1,1,00:00:20,20,00:00:20,0,20
2017-08-04-ccc_aserv_info_script,2017/08/04,ccc_aserv_info_script,0,0,00:00:00,0,00:00:00,0,0
2017-08-04-ccc_bylaw_script,2017/08/04,ccc_bylaw_script,0,0,00:00:00,0,00:00:00,0,0
2017-08-04-ccc_city_script,2017/08/04,ccc_city_script,32,32,00:00:18,18,00:03:15,0,576
2017-08-04-ccc_cty_online_script,2017/08/04,ccc_cty_online_script,0,0,00:00:00,0,00:00:00,0,0
2017-08-04-ccc_feedback_script,2017/08/04,ccc_feedback_script,1,0,00:00:00,0,00:00:00,0,0
2017-08-04-ccc_fpb_script,2017/08/04,ccc_fpb_script,5,5,00:00:17,17,00:00:52,0,85
2017-08-04-ccc_help_script,2017/08/04,ccc_help_script,10,10,00:00:14,14,00:00:47,0,140
2017-08-04-ccc_link_script,2017/08/04,ccc_link_script,0,0,00:00:00,0,00:00:00,0,0
2017-08-04-ccc_media_line_script,2017/08/04,ccc_media_line_script,0,0,00:00:00,0,00:00:00,0,0
2017-08-04-ccc_priority_script,2017/08/04,ccc_priority_script,24,24,00:00:10,10,00:00:53,0,240
2017-08-04-ccc_tax_script,2017/08/04,ccc_tax_script,13,13,00:01:06,66,00:04:50,0,858
2017-08-04-ccc_waste_recycling_script,2017/08/04,ccc_waste_recycling_script,0,0,00:00:00,0,00:00:00,0,0
2017-08-05-ccc_311_calgary_script,2017/08/05,ccc_311_calgary_script,1263,1210,00:00:33,33,00:08:13,53,39930
2017-08-05-ccc_311_lobby_ph_script,2017/08/05,ccc_311_lobby_ph_script,0,0,00:00:00,0,00:00:00,0,0
2017-08-05-ccc_aserv_info_script,2017/08/05,ccc_aserv_info_script,0,0,00:00:00,0,00:00:00,0,0
2017-08-05-ccc_bylaw_script,2017/08/05,ccc_bylaw_script,0,0,00:00:00,0,00:00:00,0,0
2017-08-05-ccc_city_script,2017/08/05,ccc_city_script,0,0,00:00:00,0,00:00:00,0,0
2017-08-05-ccc_cty_online_script,2017/08/05,ccc_cty_online_script,0,0,00:00:00,0,00:00:00,0,0
2017-08-05-ccc_feedback_script,2017/08/05,ccc_feedback_script,0,0,00:00:00,0,00:00:00,0,0
2017-08-05-ccc_fpb_script,2017/08/05,ccc_fpb_script,3,2,00:00:03,3,00:00:04,1,6
2017-08-05-ccc_help_script,2017/08/05,ccc_help_script,14,10,00:00:16,16,00:00:37,4,160
2017-08-05-ccc_link_script,2017/08/05,ccc_link_script,0,0,00:00:00,0,00:00:00,0,0
2017-08-05-ccc_media_line_script,2017/08/05,ccc_media_line_script,3,3,00:00:27,27,00:01:11,0,81
2017-08-05-ccc_priority_script,2017/08/05,ccc_priority_script,21,20,00:00:08,8,00:00:34,1,160
2017-08-05-ccc_tax_script,2017/08/05,ccc_tax_script,0,0,00:00:00,0,00:00:00,0,0
2017-08-05-ccc_waste_recycling_script,2017/08/05,ccc_waste_recycling_script,0,0,00:00:00,0,00:00:00,0,0
2017-08-06-ccc_311_calgary_script,2017/08/06,ccc_311_calgary_script,1207,1125,00:00:36,36,00:11:28,82,40500
2017-08-06-ccc_311_lobby_ph_script,2017/08/06,ccc_311_lobby_ph_script,0,0,00:00:00,0,00:00:00,0,0
2017-08-06-ccc_aserv_info_script,2017/08/06,ccc_aserv_info_script,0,0,00:00:00,0,00:00:00,0,0
2017-08-06-ccc_bylaw_script,2017/08/06,ccc_bylaw_script,0,0,00:00:00,0,00:00:00,0,0
2017-08-06-ccc_city_script,2017/08/06,ccc_city_script,0,0,00:00:00,0,00:00:00,0,0
2017-08-06-ccc_cty_online_script,2017/08/06,ccc_cty_online_script,0,0,00:00:00,0,00:00:00,0,0
2017-08-06-ccc_feedback_script,2017/08/06,ccc_feedback_script,0,0,00:00:00,0,00:00:00,0,0
2017-08-06-ccc_fpb_script,2017/08/06,ccc_fpb_script,3,2,00:00:03,3,00:00:04,1,6
2017-08-06-ccc_help_script,2017/08/06,ccc_help_script,13,13,00:00:26,26,00:02:07,0,338
2017-08-06-ccc_link_script,2017/08/06,ccc_link_script,0,0,00:00:00,0,00:00:00,0,0
2017-08-06-ccc_media_line_script,2017/08/06,ccc_media_line_script,2,2,00:00:07,7,00:00:10,0,14
2017-08-06-ccc_priority_script,2017/08/06,ccc_priority_script,21,20,00:00:10,10,00:01:24,1,200
2017-08-06-ccc_tax_script,2017/08/06,ccc_tax_script,1,1,00:00:03,3,00:00:03,0,3
2017-08-06-ccc_waste_recycling_script,2017/08/06,ccc_waste_recycling_script,0,0,00:00:00,0,00:00:00,0,0
2017-08-07-ccc_311_calgary_script,2017/08/07,ccc_311_calgary_script,1301,1273,00:00:14,14,00:05:57,28,17822
2017-08-07-ccc_311_lobby_ph_script,2017/08/07,ccc_311_lobby_ph_script,0,0,00:00:00,0,00:00:00,0,0
2017-08-07-ccc_aserv_info_script,2017/08/07,ccc_aserv_info_script,0,0,00:00:00,0,00:00:00,0,0
2017-08-07-ccc_bylaw_script,2017/08/07,ccc_bylaw_script,0,0,00:00:00,0,00:00:00,0,0
2017-08-07-ccc_city_script,2017/08/07,ccc_city_script,0,0,00:00:00,0,00:00:00,0,0
2017-08-07-ccc_cty_online_script,2017/08/07,ccc_cty_online_script,0,0,00:00:00,0,00:00:00,0,0
2017-08-07-ccc_feedback_script,2017/08/07,ccc_feedback_script,0,0,00:00:00,0,00:00:00,0,0
2017-08-07-ccc_fpb_script,2017/08/07,ccc_fpb_script,0,0,00:00:00,0,00:00:00,0,0
2017-08-07-ccc_help_script,2017/08/07,ccc_help_script,5,5,00:00:20,20,00:01:02,0,100
2017-08-07-ccc_link_script,2017/08/07,ccc_link_script,0,0,00:00:00,0,00:00:00,0,0
2017-08-07-ccc_media_line_script,2017/08/07,ccc_media_line_script,0,0,00:00:00,0,00:00:00,0,0
2017-08-07-ccc_priority_script,2017/08/07,ccc_priority_script,14,14,00:00:06,6,00:00:13,0,84
2017-08-07-ccc_tax_script,2017/08/07,ccc_tax_script,0,0,00:00:00,0,00:00:00,0,0
2017-08-07-ccc_waste_recycling_script,2017/08/07,ccc_waste_recycling_script,0,0,00:00:00,0,00:00:00,0,0
2017-08-09-ccc_311_calgary_script,2017/08/09,ccc_311_calgary_script,3865,3265,00:02:33,153,00:12:00,600,499545
2017-08-09-ccc_311_lobby_ph_script,2017/08/09,ccc_311_lobby_ph_script,1,1,00:00:05,5,00:00:05,0,5
2017-08-09-ccc_aserv_info_script,2017/08/09,ccc_aserv_info_script,0,0,00:00:00,0,00:00:00,0,0
2017-08-09-ccc_bylaw_script,2017/08/09,ccc_bylaw_script,0,0,00:00:00,0,00:00:00,0,0
2017-08-09-ccc_city_script,2017/08/09,ccc_city_script,15,14,00:01:02,62,00:05:15,1,868
2017-08-09-ccc_cty_online_script,2017/08/09,ccc_cty_online_script,0,0,00:00:00,0,00:00:00,0,0
2017-08-09-ccc_feedback_script,2017/08/09,ccc_feedback_script,0,0,00:00:00,0,00:00:00,0,0
2017-08-10-ccc_fpb_script,2017/08/10,ccc_fpb_script,9,6,00:01:23,83,00:05:56,3,498
2017-08-10-ccc_help_script,2017/08/10,ccc_help_script,21,21,00:00:17,17,00:01:04,0,357
2017-08-10-ccc_link_script,2017/08/10,ccc_link_script,0,0,00:00:00,0,00:00:00,0,0
2017-08-10-ccc_media_line_script,2017/08/10,ccc_media_line_script,0,0,00:00:00,0,00:00:00,0,0
2017-08-10-ccc_priority_script,2017/08/10,ccc_priority_script,21,21,00:00:09,9,00:00:30,0,189
2017-08-10-ccc_tax_script,2017/08/10,ccc_tax_script,15,12,00:00:49,49,00:01:54,3,588
2017-08-10-ccc_waste_recycling_script,2017/08/10,ccc_waste_recycling_script,0,0,00:00:00,0,00:00:00,0,0
2017-08-11-ccc_waste_recycling_script,2017/08/11,ccc_waste_recycling_script,0,0,00:00:00,0,00:00:00,0,0
2017-08-12-ccc_311_calgary_script,2017/08/12,ccc_311_calgary_script,1427,1271,00:01:22,82,00:16:43,156,104222
2017-08-12-ccc_311_lobby_ph_script,2017/08/12,ccc_311_lobby_ph_script,0,0,00:00:00,0,00:00:00,0,0
2017-08-12-ccc_aserv_info_script,2017/08/12,ccc_aserv_info_script,0,0,00:00:00,0,00:00:00,0,0
2017-08-12-ccc_bylaw_script,2017/08/12,ccc_bylaw_script,0,0,00:00:00,0,00:00:00,0,0
2017-08-12-ccc_city_script,2017/08/12,ccc_city_script,0,0,00:00:00,0,00:00:00,0,0
2017-08-12-ccc_cty_online_script,2017/08/12,ccc_cty_online_script,0,0,00:00:00,0,00:00:00,0,0
2017-08-12-ccc_feedback_script,2017/08/12,ccc_feedback_script,0,0,00:00:00,0,00:00:00,0,0
2017-08-12-ccc_fpb_script,2017/08/12,ccc_fpb_script,2,2,00:00:10,10,00:00:15,0,20
2017-08-13-ccc_help_script,2017/08/13,ccc_help_script,15,9,00:00:37,37,00:01:47,6,333
2017-08-13-ccc_link_script,2017/08/13,ccc_link_script,0,0,00:00:00,0,00:00:00,0,0
2017-08-13-ccc_media_line_script,2017/08/13,ccc_media_line_script,1,1,00:00:13,13,00:00:13,0,13
2017-08-13-ccc_priority_script,2017/08/13,ccc_priority_script,28,27,00:00:06,6,00:00:33,1,162
2017-08-13-ccc_tax_script,2017/08/13,ccc_tax_script,0,0,00:00:00,0,00:00:00,0,0
2017-08-13-ccc_waste_recycling_script,2017/08/13,ccc_waste_recycling_script,0,0,00:00:00,0,00:00:00,0,0
2017-08-14-ccc_311_calgary_script,2017/08/14,ccc_311_calgary_script,3599,3446,00:00:31,31,00:06:41,153,106826
2017-08-14-ccc_311_lobby_ph_script,2017/08/14,ccc_311_lobby_ph_script,2,1,00:00:12,12,00:00:12,1,12
2017-08-14-ccc_aserv_info_script,2017/08/14,ccc_aserv_info_script,0,0,00:00:00,0,00:00:00,0,0
2017-08-14-ccc_bylaw_script,2017/08/14,ccc_bylaw_script,0,0,00:00:00,0,00:00:00,0,0
2017-08-14-ccc_city_script,2017/08/14,ccc_city_script,24,23,00:00:18,18,00:01:25,1,414
2017-08-14-ccc_cty_online_script,2017/08/14,ccc_cty_online_script,0,0,00:00:00,0,00:00:00,0,0
2017-08-14-ccc_feedback_script,2017/08/14,ccc_feedback_script,0,0,00:00:00,0,00:00:00,0,0
2017-08-14-ccc_fpb_script,2017/08/14,ccc_fpb_script,3,3,00:00:03,3,00:00:04,0,9
2017-08-14-ccc_help_script,2017/08/14,ccc_help_script,9,9,00:00:13,13,00:00:33,0,117
2017-08-14-ccc_link_script,2017/08/14,ccc_link_script,0,0,00:00:00,0,00:00:00,0,0
2017-08-14-ccc_media_line_script,2017/08/14,ccc_media_line_script,1,1,00:00:07,7,00:00:07,0,7
2017-08-14-ccc_priority_script,2017/08/14,ccc_priority_script,30,29,00:00:07,7,00:00:44,1,203
2017-08-14-ccc_tax_script,2017/08/14,ccc_tax_script,30,29,00:00:38,38,00:02:37,1,1102
2017-08-14-ccc_waste_recycling_script,2017/08/14,ccc_waste_recycling_script,0,0,00:00:00,0,00:00:00,0,0
2017-08-15-ccc_311_calgary_script,2017/08/15,ccc_311_calgary_script,4483,3619,00:03:08,188,00:16:30,864,680372
2017-08-15-ccc_311_lobby_ph_script,2017/08/15,ccc_311_lobby_ph_script,2,1,00:00:04,4,00:00:04,1,4
2017-08-15-ccc_aserv_info_script,2017/08/15,ccc_aserv_info_script,0,0,00:00:00,0,00:00:00,0,0
2017-08-15-ccc_bylaw_script,2017/08/15,ccc_bylaw_script,0,0,00:00:00,0,00:00:00,0,0
2017-08-21-ccc_311_calgary_script,2017/08/21,ccc_311_calgary_script,3669,3526,00:00:37,37,00:05:04,143,130462
2017-08-21-ccc_311_lobby_ph_script,2017/08/21,ccc_311_lobby_ph_script,2,2,00:00:34,34,00:00:35,0,68
2017-08-21-ccc_aserv_info_script,2017/08/21,ccc_aserv_info_script,0,0,00:00:00,0,00:00:00,0,0
2017-08-21-ccc_bylaw_script,2017/08/21,ccc_bylaw_script,0,0,00:00:00,0,00:00:00,0,0
2017-08-21-ccc_city_script,2017/08/21,ccc_city_script,17,17,00:00:12,12,00:00:33,0,204
2017-08-21-ccc_cty_online_script,2017/08/21,ccc_cty_online_script,0,0,00:00:00,0,00:00:00,0,0
2017-08-21-ccc_feedback_script,2017/08/21,ccc_feedback_script,0,0,00:00:00,0,00:00:00,0,0
2017-08-21-ccc_fpb_script,2017/08/21,ccc_fpb_script,6,6,00:00:20,20,00:01:24,0,120
2017-08-21-ccc_help_script,2017/08/21,ccc_help_script,22,20,00:00:07,7,00:00:22,2,140
2017-08-21-ccc_link_script,2017/08/21,ccc_link_script,0,0,00:00:00,0,00:00:00,0,0
2017-08-21-ccc_media_line_script,2017/08/21,ccc_media_line_script,0,0,00:00:00,0,00:00:00,0,0
2017-08-21-ccc_priority_script,2017/08/21,ccc_priority_script,30,30,00:00:08,8,00:01:08,0,240
2017-08-21-ccc_tax_script,2017/08/21,ccc_tax_script,18,18,00:00:51,51,00:03:51,0,918
2017-08-21-ccc_waste_recycling_script,2017/08/21,ccc_waste_recycling_script,0,0,00:00:00,0,00:00:00,0,0
2017-08-15-ccc_city_script,2017/08/15,ccc_city_script,28,28,00:00:38,38,00:03:40,0,1064
2017-08-15-ccc_cty_online_script,2017/08/15,ccc_cty_online_script,0,0,00:00:00,0,00:00:00,0,0
2017-08-15-ccc_feedback_script,2017/08/15,ccc_feedback_script,0,0,00:00:00,0,00:00:00,0,0
2017-08-15-ccc_fpb_script,2017/08/15,ccc_fpb_script,7,4,00:06:55,415,00:13:18,3,1660
2017-08-15-ccc_help_script,2017/08/15,ccc_help_script,28,22,00:00:08,8,00:00:33,6,176
2017-08-15-ccc_link_script,2017/08/15,ccc_link_script,0,0,00:00:00,0,00:00:00,0,0
2017-08-15-ccc_media_line_script,2017/08/15,ccc_media_line_script,3,3,00:00:08,8,00:00:10,0,24
2017-08-15-ccc_priority_script,2017/08/15,ccc_priority_script,38,37,00:00:12,12,00:00:46,1,444
2017-08-15-ccc_tax_script,2017/08/15,ccc_tax_script,33,31,00:01:24,84,00:04:53,2,2604
2017-08-15-ccc_waste_recycling_script,2017/08/15,ccc_waste_recycling_script,0,0,00:00:00,0,00:00:00,0,0
2017-08-16-ccc_311_calgary_script,2017/08/16,ccc_311_calgary_script,4125,3395,00:03:11,191,00:17:24,730,648445
2017-08-16-ccc_311_lobby_ph_script,2017/08/16,ccc_311_lobby_ph_script,2,1,00:00:13,13,00:00:13,1,13
2017-08-16-ccc_aserv_info_script,2017/08/16,ccc_aserv_info_script,0,0,00:00:00,0,00:00:00,0,0
2017-08-16-ccc_bylaw_script,2017/08/16,ccc_bylaw_script,0,0,00:00:00,0,00:00:00,0,0
2017-08-16-ccc_city_script,2017/08/16,ccc_city_script,14,13,00:01:08,68,00:06:32,1,884
2017-08-16-ccc_cty_online_script,2017/08/16,ccc_cty_online_script,0,0,00:00:00,0,00:00:00,0,0
2017-08-16-ccc_feedback_script,2017/08/16,ccc_feedback_script,0,0,00:00:00,0,00:00:00,0,0
2017-08-16-ccc_fpb_script,2017/08/16,ccc_fpb_script,1,0,00:00:00,0,00:00:00,1,0
2017-08-16-ccc_help_script,2017/08/16,ccc_help_script,21,18,00:00:17,17,00:02:08,3,306
2017-08-16-ccc_link_script,2017/08/16,ccc_link_script,0,0,00:00:00,0,00:00:00,0,0
2017-08-16-ccc_media_line_script,2017/08/16,ccc_media_line_script,1,1,00:00:20,20,00:00:20,0,20
2017-08-16-ccc_priority_script,2017/08/16,ccc_priority_script,38,38,00:00:18,18,00:01:19,0,684
2017-08-16-ccc_tax_script,2017/08/16,ccc_tax_script,20,19,00:03:02,182,00:07:26,1,3458
2017-08-16-ccc_waste_recycling_script,2017/08/16,ccc_waste_recycling_script,0,0,00:00:00,0,00:00:00,0,0
2017-08-17-ccc_311_calgary_script,2017/08/17,ccc_311_calgary_script,3803,3473,00:01:18,78,00:12:33,330,270894
2017-08-17-ccc_311_lobby_ph_script,2017/08/17,ccc_311_lobby_ph_script,0,0,00:00:00,0,00:00:00,0,0
2017-08-17-ccc_aserv_info_script,2017/08/17,ccc_aserv_info_script,0,0,00:00:00,0,00:00:00,0,0
2017-08-17-ccc_bylaw_script,2017/08/17,ccc_bylaw_script,0,0,00:00:00,0,00:00:00,0,0
2017-08-17-ccc_city_script,2017/08/17,ccc_city_script,15,15,00:00:32,32,00:02:32,0,480
2017-08-17-ccc_cty_online_script,2017/08/17,ccc_cty_online_script,0,0,00:00:00,0,00:00:00,0,0
2017-08-17-ccc_feedback_script,2017/08/17,ccc_feedback_script,0,0,00:00:00,0,00:00:00,0,0
2017-08-17-ccc_fpb_script,2017/08/17,ccc_fpb_script,3,3,00:02:18,138,00:06:05,0,414
2017-08-17-ccc_help_script,2017/08/17,ccc_help_script,27,27,00:00:09,9,00:00:37,0,243
2017-08-17-ccc_link_script,2017/08/17,ccc_link_script,0,0,00:00:00,0,00:00:00,0,0
2017-08-17-ccc_media_line_script,2017/08/17,ccc_media_line_script,0,0,00:00:00,0,00:00:00,0,0
2017-08-17-ccc_priority_script,2017/08/17,ccc_priority_script,35,34,00:00:08,8,00:00:23,1,272
2017-08-17-ccc_tax_script,2017/08/17,ccc_tax_script,10,9,00:00:48,48,00:01:40,1,432
2017-08-17-ccc_waste_recycling_script,2017/08/17,ccc_waste_recycling_script,0,0,00:00:00,0,00:00:00,0,0
2017-08-18-ccc_311_calgary_script,2017/08/18,ccc_311_calgary_script,3635,3267,00:01:49,109,00:07:10,368,356103
2017-08-18-ccc_311_lobby_ph_script,2017/08/18,ccc_311_lobby_ph_script,0,0,00:00:00,0,00:00:00,0,0
2017-08-18-ccc_aserv_info_script,2017/08/18,ccc_aserv_info_script,0,0,00:00:00,0,00:00:00,0,0
2017-08-18-ccc_bylaw_script,2017/08/18,ccc_bylaw_script,0,0,00:00:00,0,00:00:00,0,0
2017-08-18-ccc_city_script,2017/08/18,ccc_city_script,20,19,00:01:01,61,00:05:02,1,1159
2017-08-18-ccc_cty_online_script,2017/08/18,ccc_cty_online_script,0,0,00:00:00,0,00:00:00,0,0
2017-08-18-ccc_feedback_script,2017/08/18,ccc_feedback_script,0,0,00:00:00,0,00:00:00,0,0
2017-08-18-ccc_fpb_script,2017/08/18,ccc_fpb_script,0,0,00:00:00,0,00:00:00,0,0
2017-08-18-ccc_help_script,2017/08/18,ccc_help_script,18,17,00:00:10,10,00:00:54,1,170
2017-08-18-ccc_link_script,2017/08/18,ccc_link_script,0,0,00:00:00,0,00:00:00,0,0
2017-08-18-ccc_media_line_script,2017/08/18,ccc_media_line_script,1,1,00:00:15,15,00:00:15,0,15
2017-08-18-ccc_priority_script,2017/08/18,ccc_priority_script,31,31,00:00:12,12,00:01:10,0,372
2017-08-18-ccc_tax_script,2017/08/18,ccc_tax_script,21,17,00:03:06,186,00:06:17,4,3162
2017-08-18-ccc_waste_recycling_script,2017/08/18,ccc_waste_recycling_script,0,0,00:00:00,0,00:00:00,0,0
2017-08-19-ccc_311_calgary_script,2017/08/19,ccc_311_calgary_script,1396,1324,00:00:36,36,00:05:45,72,47664
2017-08-19-ccc_311_lobby_ph_script,2017/08/19,ccc_311_lobby_ph_script,0,0,00:00:00,0,00:00:00,0,0
2017-08-19-ccc_tax_script,2017/08/19,ccc_tax_script,0,0,00:00:00,0,00:00:00,0,0
2017-08-19-ccc_waste_recycling_script,2017/08/19,ccc_waste_recycling_script,0,0,00:00:00,0,00:00:00,0,0
2017-08-20-ccc_311_calgary_script,2017/08/20,ccc_311_calgary_script,1033,1003,00:00:13,13,00:02:42,30,13039
2017-08-20-ccc_311_lobby_ph_script,2017/08/20,ccc_311_lobby_ph_script,0,0,00:00:00,0,00:00:00,0,0
2017-08-20-ccc_aserv_info_script,2017/08/20,ccc_aserv_info_script,0,0,00:00:00,0,00:00:00,0,0
2017-08-20-ccc_bylaw_script,2017/08/20,ccc_bylaw_script,0,0,00:00:00,0,00:00:00,0,0
2017-08-20-ccc_city_script,2017/08/20,ccc_city_script,0,0,00:00:00,0,00:00:00,0,0
2017-08-20-ccc_cty_online_script,2017/08/20,ccc_cty_online_script,0,0,00:00:00,0,00:00:00,0,0
2017-08-20-ccc_feedback_script,2017/08/20,ccc_feedback_script,0,0,00:00:00,0,00:00:00,0,0
2017-08-20-ccc_fpb_script,2017/08/20,ccc_fpb_script,1,1,00:00:14,14,00:00:14,0,14
2017-08-20-ccc_help_script,2017/08/20,ccc_help_script,10,9,00:00:06,6,00:00:10,1,54
2017-08-20-ccc_link_script,2017/08/20,ccc_link_script,0,0,00:00:00,0,00:00:00,0,0
2017-08-20-ccc_media_line_script,2017/08/20,ccc_media_line_script,1,1,00:00:05,5,00:00:05,0,5
2017-08-20-ccc_priority_script,2017/08/20,ccc_priority_script,16,16,00:00:09,9,00:00:48,0,144
2017-08-20-ccc_tax_script,2017/08/20,ccc_tax_script,0,0,00:00:00,0,00:00:00,0,0
2017-08-20-ccc_waste_recycling_script,2017/08/20,ccc_waste_recycling_script,0,0,00:00:00,0,00:00:00,0,0
2017-08-22-ccc_city_script,2017/08/22,ccc_city_script,17,17,00:00:13,13,00:00:30,0,221
2017-08-22-ccc_cty_online_script,2017/08/22,ccc_cty_online_script,0,0,00:00:00,0,00:00:00,0,0
2017-08-22-ccc_feedback_script,2017/08/22,ccc_feedback_script,0,0,00:00:00,0,00:00:00,0,0
2017-08-22-ccc_fpb_script,2017/08/22,ccc_fpb_script,4,3,00:01:23,83,00:03:52,1,249
2017-08-22-ccc_help_script,2017/08/22,ccc_help_script,17,16,00:00:12,12,00:00:26,1,192
2017-08-22-ccc_link_script,2017/08/22,ccc_link_script,0,0,00:00:00,0,00:00:00,0,0
2017-08-22-ccc_media_line_script,2017/08/22,ccc_media_line_script,0,0,00:00:00,0,00:00:00,0,0
2017-08-22-ccc_priority_script,2017/08/22,ccc_priority_script,31,29,00:00:08,8,00:00:36,2,232
2017-08-22-ccc_tax_script,2017/08/22,ccc_tax_script,18,18,00:01:03,63,00:06:06,0,1134
2017-08-22-ccc_waste_recycling_script,2017/08/22,ccc_waste_recycling_script,0,0,00:00:00,0,00:00:00,0,0
2017-08-23-ccc_311_calgary_script,2017/08/23,ccc_311_calgary_script,3911,3650,00:00:58,58,00:05:47,261,211700
2017-08-23-ccc_311_lobby_ph_script,2017/08/23,ccc_311_lobby_ph_script,2,2,00:00:12,12,00:00:16,0,24
2017-08-23-ccc_aserv_info_script,2017/08/23,ccc_aserv_info_script,0,0,00:00:00,0,00:00:00,0,0
2017-08-23-ccc_bylaw_script,2017/08/23,ccc_bylaw_script,0,0,00:00:00,0,00:00:00,0,0
2017-08-23-ccc_city_script,2017/08/23,ccc_city_script,24,23,00:00:19,19,00:01:30,1,437
2017-08-23-ccc_cty_online_script,2017/08/23,ccc_cty_online_script,0,0,00:00:00,0,00:00:00,0,0
2017-08-23-ccc_feedback_script,2017/08/23,ccc_feedback_script,0,0,00:00:00,0,00:00:00,0,0
2017-08-23-ccc_fpb_script,2017/08/23,ccc_fpb_script,6,4,00:00:27,27,00:01:27,2,108
2017-08-23-ccc_help_script,2017/08/23,ccc_help_script,16,15,00:00:19,19,00:01:42,1,285
2017-08-23-ccc_link_script,2017/08/23,ccc_link_script,0,0,00:00:00,0,00:00:00,0,0
2017-08-23-ccc_media_line_script,2017/08/23,ccc_media_line_script,0,0,00:00:00,0,00:00:00,0,0
2017-08-23-ccc_priority_script,2017/08/23,ccc_priority_script,42,42,00:00:12,12,00:01:53,0,504
2017-08-23-ccc_tax_script,2017/08/23,ccc_tax_script,23,21,00:00:56,56,00:03:57,2,1176
2017-08-23-ccc_waste_recycling_script,2017/08/23,ccc_waste_recycling_script,0,0,00:00:00,0,00:00:00,0,0
2017-08-24-ccc_311_calgary_script,2017/08/24,ccc_311_calgary_script,3847,3018,00:03:42,222,00:14:21,828,669996
2017-08-24-ccc_311_lobby_ph_script,2017/08/24,ccc_311_lobby_ph_script,3,2,00:00:05,5,00:00:05,1,10
2017-08-24-ccc_aserv_info_script,2017/08/24,ccc_aserv_info_script,0,0,00:00:00,0,00:00:00,0,0
2017-08-24-ccc_bylaw_script,2017/08/24,ccc_bylaw_script,0,0,00:00:00,0,00:00:00,0,0
2017-08-24-ccc_city_script,2017/08/24,ccc_city_script,11,10,00:00:24,24,00:01:13,1,240
2017-08-24-ccc_cty_online_script,2017/08/24,ccc_cty_online_script,0,0,00:00:00,0,00:00:00,0,0
2017-08-24-ccc_feedback_script,2017/08/24,ccc_feedback_script,0,0,00:00:00,0,00:00:00,0,0
2017-08-24-ccc_fpb_script,2017/08/24,ccc_fpb_script,8,3,00:00:59,59,00:02:33,5,177
2017-08-24-ccc_help_script,2017/08/24,ccc_help_script,12,12,00:00:15,15,00:01:25,0,180
2017-08-24-ccc_link_script,2017/08/24,ccc_link_script,0,0,00:00:00,0,00:00:00,0,0
2017-08-24-ccc_media_line_script,2017/08/24,ccc_media_line_script,0,0,00:00:00,0,00:00:00,0,0
2017-08-24-ccc_priority_script,2017/08/24,ccc_priority_script,37,35,00:00:16,16,00:01:18,2,560
2017-08-24-ccc_tax_script,2017/08/24,ccc_tax_script,12,11,00:03:18,198,00:06:15,1,2178
2017-08-24-ccc_waste_recycling_script,2017/08/24,ccc_waste_recycling_script,0,0,00:00:00,0,00:00:00,0,0
